name	taxonomy_id	taxonomy_lvl	kraken_assigned_reads	added_reads	new_est_reads	fraction_total_reads
Ralstonia solanacearum	305	S	770	97	867	0.0617037933
Cutibacterium acnes	1747	S	416	34	450	0.0320261903
Klebsiella pneumoniae	573	S	81	338	419	0.0298199416
Stenotrophomonas maltophilia	40324	S	209	56	265	0.0188598676
Bacillus thuringiensis	1428	S	22	205	227	0.0161554338
Pseudomonas sp. CMR12a	658629	S	171	42	213	0.0151590634
Pseudomonas fluorescens	294	S	146	30	176	0.0125257989
Dermacoccus nishinomiyaensis	1274	S	155	20	175	0.0124546296
Pasteurella multocida	747	S	132	29	161	0.0114582592
Pseudomonas aeruginosa	287	S	25	123	148	0.0105330581
Proteus virus Isfahan	2560650	S	144	0	144	0.0102483809
Pseudomonas oryzihabitans	47885	S	124	7	131	0.0093231798
Anabaena sp. YBS01	2490939	S	10	108	118	0.0083979788
Salmonella sp. SJTUF14178	2745895	S	1	92	93	0.0066187460
Phocaeicola vulgatus	821	S	38	28	66	0.0046971746
Streptomyces lividans	1916	S	4	51	55	0.0039143121
Candidatus Planktophila sulfonica	1884904	S	49	4	53	0.0037719735
Pseudomonas koreensis	198620	S	46	6	52	0.0037008042
Variovorax paradoxus	34073	S	42	9	51	0.0036296349
Staphylococcus aureus	1280	S	27	23	50	0.0035584656
Pseudomonas sp. S150	2559074	S	30	18	48	0.0034161270
Diaphorobacter sp. JS3051	2792224	S	3	44	47	0.0033449577
Methylobacterium sp. XJLW	739141	S	5	40	45	0.0032026190
Pseudomonas palleroniana	191390	S	42	2	44	0.0031314497
Kocuria rhizophila	72000	S	35	9	44	0.0031314497
Lactococcus lactis	1358	S	5	39	44	0.0031314497
Duganella sp. AF9R3	2728021	S	36	6	42	0.0029891111
Acinetobacter baumannii	470	S	16	26	42	0.0029891111
Methylobacterium radiotolerans	31998	S	14	27	41	0.0029179418
Leptothrix cholodnii	34029	S	31	7	38	0.0027044338
Methylobacterium sp. C1	1479019	S	10	28	38	0.0027044338
Polynucleobacter necessarius	576610	S	35	2	37	0.0026332645
Polaromonas naphthalenivorans	216465	S	35	2	37	0.0026332645
Faecalibacterium prausnitzii	853	S	30	7	37	0.0026332645
Limnoglobus roseus	2598579	S	35	1	36	0.0025620952
Limnohabitans sp. 103DPR2	1678129	S	34	1	35	0.0024909259
Acidovorax sp. T1	1858609	S	13	21	34	0.0024197566
Diaphorobacter sp. JS3050	2735554	S	2	31	33	0.0023485873
Vitreoscilla filiformis	63	S	31	2	33	0.0023485873
Acidovorax sp. JS42	232721	S	2	30	32	0.0022774180
Sphaerotilus natans	34103	S	26	6	32	0.0022774180
Pseudomonas syringae	317	S	12	20	32	0.0022774180
Rhodococcus erythropolis	1833	S	13	19	32	0.0022774180
Rhizobacter sp. AJA081-3	2753607	S	26	5	31	0.0022062487
Pseudomonas putida	303	S	23	8	31	0.0022062487
Escherichia coli	562	S	6	23	29	0.0020639100
Bradyrhizobium diazoefficiens	1355477	S	17	12	29	0.0020639100
Methylobacterium aquaticum	270351	S	24	4	28	0.0019927407
Acidovorax carolinensis	553814	S	19	8	27	0.0019215714
Limnohabitans sp. 63ED37-2	1678128	S	26	1	27	0.0019215714
Curvibacter sp. AEP1-3	1844971	S	27	0	27	0.0019215714
Sorangium cellulosum	56	S	24	3	27	0.0019215714
Rhodoferax sediminis	2509614	S	25	1	26	0.0018504021
Comamonas testosteroni	285	S	17	9	26	0.0018504021
Pseudomonas veronii	76761	S	12	14	26	0.0018504021
Halomonas sp. JS92-SW72	2306583	S	21	5	26	0.0018504021
Parabacteroides distasonis	823	S	19	7	26	0.0018504021
Methylobacterium mesophilicum	39956	S	24	1	25	0.0017792328
Sphingomonas sp. PAMC26645	2565555	S	20	5	25	0.0017792328
Blautia sp. SC05B48	2479767	S	15	8	23	0.0016368942
Frigoriglobus tundricola	2774151	S	20	3	23	0.0016368942
Acinetobacter johnsonii	40214	S	17	5	22	0.0015657249
Aliarcobacter cryaerophilus	28198	S	22	0	22	0.0015657249
Micrococcus luteus	1270	S	7	14	21	0.0014945555
Clostridium botulinum	1491	S	16	5	21	0.0014945555
Urbifossiella limnaea	2528023	S	20	1	21	0.0014945555
Cupriavidus taiwanensis	164546	S	10	10	20	0.0014233862
Rhodopseudomonas palustris	1076	S	17	3	20	0.0014233862
Propionibacterium sp. oral taxon 193	671223	S	17	3	20	0.0014233862
Flavobacterium johnsoniae	986	S	17	3	20	0.0014233862
Blattabacterium cuenoti	1653831	S	18	2	20	0.0014233862
Opitutus sp. GAS368	1882749	S	19	1	20	0.0014233862
Rhodoferax ferrireducens	192843	S	19	0	19	0.0013522169
Rhodoferax saidenbachensis	1484693	S	18	1	19	0.0013522169
Xanthomonas oryzae	347	S	18	1	19	0.0013522169
Citrobacter freundii	546	S	6	13	19	0.0013522169
Microbacterium sp. PM5	2014534	S	18	1	19	0.0013522169
Microbacterium paraoxydans	199592	S	3	16	19	0.0013522169
Anaerostipes hadrus	649756	S	15	4	19	0.0013522169
Lacunisphaera limnophila	1838286	S	18	1	19	0.0013522169
Polynucleobacter duraquae	1835254	S	17	1	18	0.0012810476
Paraburkholderia sp. SOS3	1926494	S	18	0	18	0.0012810476
Acidovorax sp. KKS102	358220	S	14	4	18	0.0012810476
Hydrogenophaga sp. PBL-H3	434010	S	12	6	18	0.0012810476
Alicycliphilus denitrificans	179636	S	7	11	18	0.0012810476
Aquaspirillum sp. LM1	1938604	S	18	0	18	0.0012810476
Fluviibacter phosphoraccumulans	1751046	S	17	1	18	0.0012810476
Bradyrhizobium elkanii	29448	S	1	17	18	0.0012810476
Sphingobium yanoikuyae	13690	S	10	8	18	0.0012810476
Blautia obeum	40520	S	13	5	18	0.0012810476
Bacteroides uniformis	820	S	10	8	18	0.0012810476
Polynucleobacter asymbioticus	576611	S	15	2	17	0.0012098783
Acidovorax monticola	1926868	S	15	2	17	0.0012098783
Massilia umbonata	864828	S	12	5	17	0.0012098783
Aquabacterium olei	1296669	S	15	2	17	0.0012098783
Mesorhizobium sp. Pch-S	2082387	S	17	0	17	0.0012098783
Curtobacterium flaccumfaciens	2035	S	15	2	17	0.0012098783
Rhodococcus qingshengii	334542	S	6	11	17	0.0012098783
Flavobacterium sp. 140616W15	2478552	S	15	2	17	0.0012098783
Variovorax sp. WDL1	207745	S	8	8	16	0.0011387090
Acidovorax sp. 1608163	2478662	S	15	1	16	0.0011387090
Acidovorax sp. RAC01	1842533	S	13	3	16	0.0011387090
Rhodoferax sp. AJA081-3	2752316	S	16	0	16	0.0011387090
Polaromonas sp. JS666	296591	S	15	1	16	0.0011387090
Delftia acidovorans	80866	S	5	11	16	0.0011387090
Schlegelella thermodepolymerans	215580	S	14	2	16	0.0011387090
Undibacterium sp. KW1	2058624	S	11	5	16	0.0011387090
Pseudomonas sp.	306	S	4	12	16	0.0011387090
Enterobacter asburiae	61645	S	5	11	16	0.0011387090
Candidatus Planktophila lacus	1884913	S	16	0	16	0.0011387090
Roseburia intestinalis	166486	S	11	5	16	0.0011387090
Borrelia crocidurae	29520	S	16	0	16	0.0011387090
Variovorax sp. PBL-H6	434009	S	6	9	15	0.0010675397
Ottowia oryzae	2109914	S	15	0	15	0.0010675397
Mesorhizobium huakuii	28104	S	6	9	15	0.0010675397
Sphingorhabdus lacus	392610	S	15	0	15	0.0010675397
Actinoplanes derwentensis	113562	S	15	0	15	0.0010675397
Nostoc carneum	374162	S	5	10	15	0.0010675397
Microcystis aeruginosa	1126	S	13	2	15	0.0010675397
Flavobacterium sp. Sr18	935222	S	14	1	15	0.0010675397
Bacteroides thetaiotaomicron	818	S	14	1	15	0.0010675397
Gemmata massiliana	1210884	S	12	3	15	0.0010675397
Massilia flava	871742	S	12	2	14	0.0009963704
Pseudomonas fragi	296	S	10	4	14	0.0009963704
Moraxella osloensis	34062	S	14	0	14	0.0009963704
Xanthomonas campestris	339	S	4	10	14	0.0009963704
Methylobacterium brachiatum	269660	S	12	2	14	0.0009963704
Prochlorococcus marinus	1219	S	13	1	14	0.0009963704
Flavobacterium psychrophilum	96345	S	8	6	14	0.0009963704
Haliscomenobacter hydrossis	2350	S	14	0	14	0.0009963704
Human alphaherpesvirus 2	10310	S	14	0	14	0.0009963704
Rhodoferax koreense	1842727	S	10	3	13	0.0009252011
Kinneretia sp. DAIF2	2714952	S	12	1	13	0.0009252011
Massilia sp. LPB0304	2769491	S	5	8	13	0.0009252011
Massilia violaceinigra	2045208	S	10	3	13	0.0009252011
Rubrivivax gelatinosus	28068	S	11	2	13	0.0009252011
Buchnera aphidicola	9	S	14	-1	13	0.0009252011
Sphingobium sp. YG1	2082188	S	10	3	13	0.0009252011
Corynebacterium sp. L2-79-05	373068	S	1	12	13	0.0009252011
Corynebacterium glutamicum	1718	S	2	11	13	0.0009252011
Staphylococcus capitis	29388	S	12	1	13	0.0009252011
Longibaculum sp. KGMB06250	2584943	S	5	8	13	0.0009252011
Flavobacterium sp. LPB0248	2614441	S	10	3	13	0.0009252011
Bacteroides fragilis	817	S	7	6	13	0.0009252011
Bacteroides ovatus	28116	S	7	6	13	0.0009252011
Variovorax sp. HW608	1034889	S	12	0	12	0.0008540317
Variovorax boronicumulans	436515	S	8	4	12	0.0008540317
Rhodoferax sp. BAB1	2741720	S	11	1	12	0.0008540317
Diaphorobacter aerolatus	1288495	S	8	4	12	0.0008540317
Massilia sp. WG5	1707785	S	6	6	12	0.0008540317
Massilia oculi	945844	S	10	2	12	0.0008540317
Achromobacter spanius	217203	S	11	1	12	0.0008540317
Achromobacter xylosoxidans	85698	S	8	4	12	0.0008540317
Lysobacter enzymogenes	69	S	12	0	12	0.0008540317
Aeromonas media	651	S	8	4	12	0.0008540317
Methylobacterium phyllosphaerae	418223	S	4	8	12	0.0008540317
Methylorubrum extorquens	408	S	8	4	12	0.0008540317
Bradyrhizobium erythrophlei	1437360	S	12	0	12	0.0008540317
Bifidobacterium longum	216816	S	10	2	12	0.0008540317
Collinsella aerofaciens	74426	S	8	4	12	0.0008540317
Flavobacterium sp. M31R6	2739062	S	11	1	12	0.0008540317
Flavobacterium sp. KBS0721	1179672	S	9	3	12	0.0008540317
Capnocytophaga sp. FDAARGOS_737	2545799	S	4	8	12	0.0008540317
Phocaeicola dorei	357276	S	11	1	12	0.0008540317
Verrucomicrobium sp. GAS474	1882831	S	12	0	12	0.0008540317
Luteolibacter luteus	2728835	S	12	0	12	0.0008540317
Rhodoferax antarcticus	81479	S	11	0	11	0.0007828624
Hydrogenophaga sp. BPS33	2651974	S	8	3	11	0.0007828624
Massilia sp. NR 4-1	1678028	S	8	3	11	0.0007828624
Massilia sp. CCM 8941	2765360	S	7	4	11	0.0007828624
Inhella inkyongensis	392593	S	10	1	11	0.0007828624
Pseudomonas allokribbensis	2774460	S	10	1	11	0.0007828624
Stenotrophomonas sp. 169	2770322	S	11	0	11	0.0007828624
Bradyrhizobium sp. CCBAU 051011	858422	S	10	1	11	0.0007828624
Sphingomonas melonis	152682	S	4	7	11	0.0007828624
Brevundimonas naejangsanensis	588932	S	9	2	11	0.0007828624
Candidatus Planktophila versatilis	1884905	S	11	0	11	0.0007828624
Saccharopolyspora pogona	333966	S	2	9	11	0.0007828624
Bacillus sp. M4U3P1	2592382	S	11	0	11	0.0007828624
Anaerobutyricum hallii	39488	S	9	2	11	0.0007828624
Clostridioides difficile	1496	S	10	1	11	0.0007828624
Variovorax sp. 38R	2774875	S	6	4	10	0.0007116931
Hydrogenophaga pseudoflava	47421	S	5	5	10	0.0007116931
Comamonas koreensis	160825	S	9	1	10	0.0007116931
Simplicispira suum	2109915	S	9	1	10	0.0007116931
Massilia armeniaca	2072590	S	6	4	10	0.0007116931
Janthinobacterium sp. 1_2014MBL_MicDiv	1644131	S	7	3	10	0.0007116931
Janthinobacterium svalbardensis	368607	S	5	5	10	0.0007116931
Rhizobacter gummiphilus	946333	S	9	1	10	0.0007116931
Methylibium sp. Pch-M	2082386	S	5	5	10	0.0007116931
Mitsuaria sp. 7	1658665	S	9	1	10	0.0007116931
Pseudomonas stutzeri	316	S	9	1	10	0.0007116931
Klebsiella grimontii	2058152	S	5	5	10	0.0007116931
Halomonas sp. THAF5a	2587844	S	9	1	10	0.0007116931
Methylobacterium indicum	1775910	S	9	1	10	0.0007116931
Pseudolabrys taiwanensis	331696	S	10	0	10	0.0007116931
Pyruvatibacter mobilis	1712261	S	10	0	10	0.0007116931
Sphingomonas sp. NIC1	1961362	S	4	6	10	0.0007116931
Paracoccus sanguinis	1545044	S	9	1	10	0.0007116931
Terricaulis silvestris	2686094	S	10	0	10	0.0007116931
Rhodoluna lacicola	529884	S	10	0	10	0.0007116931
Candidatus Planktophila dulcis	1884914	S	10	0	10	0.0007116931
Actinomarinicola tropica	2789776	S	10	0	10	0.0007116931
Geminocystis sp. NIES-3708	1615909	S	8	2	10	0.0007116931
Oscillatoria nigro-viridis	482564	S	10	0	10	0.0007116931
Flavobacterium sp. CLA17	2724135	S	9	1	10	0.0007116931
Flavobacterium sp. MDT1-60	1979344	S	9	1	10	0.0007116931
Flavobacterium sp. SLB02	2665645	S	8	2	10	0.0007116931
Verrucomicrobium spinosum	2736	S	8	2	10	0.0007116931
Paramecium bursaria Chlorella virus A1	381899	S	10	0	10	0.0007116931
Burkholderia multivorans	87883	S	8	1	9	0.0006405238
Variovorax sp. PBL-E5	434014	S	2	7	9	0.0006405238
Acidovorax sp. JMULE5	2518343	S	8	1	9	0.0006405238
Acidovorax antarcticus	2743470	S	8	1	9	0.0006405238
Acidovorax citrulli	80869	S	6	3	9	0.0006405238
Hydrogenophaga sp. NH-16	2184519	S	4	5	9	0.0006405238
Comamonas aquatica	225991	S	8	1	9	0.0006405238
Ottowia sp. 27C	2816950	S	9	0	9	0.0006405238
Hylemonella gracilis	80880	S	9	0	9	0.0006405238
Candidatus Methylopumilus universalis	2588536	S	7	2	9	0.0006405238
Pseudomonas sp. DTU12.3	2073078	S	9	0	9	0.0006405238
Pseudomonas chlororaphis	587753	S	8	1	9	0.0006405238
Bradyrhizobium sp.	376	S	6	3	9	0.0006405238
Sphingobium sp. RSMS	520734	S	3	6	9	0.0006405238
Cereibacter sphaeroides	1063	S	9	0	9	0.0006405238
Azospirillum oryzae	286727	S	4	5	9	0.0006405238
Plantibacter sp. PA-3-X8	2480625	S	7	2	9	0.0006405238
Cutibacterium avidum	33010	S	9	0	9	0.0006405238
Nocardia arthritidis	228602	S	9	0	9	0.0006405238
Amycolatopsis keratiniphila	129921	S	5	4	9	0.0006405238
Actinoplanes sp. N902-109	649831	S	8	1	9	0.0006405238
Staphylococcus epidermidis	1282	S	8	1	9	0.0006405238
[Ruminococcus] torques	33039	S	7	2	9	0.0006405238
Flavobacterium sp. CJ74	2294119	S	9	0	9	0.0006405238
Flavobacterium sangjuense	2518177	S	9	0	9	0.0006405238
Flavobacterium crocinum	2183896	S	8	1	9	0.0006405238
Chryseobacterium indoltheticum	254	S	8	1	9	0.0006405238
Prevotella copri	165179	S	8	1	9	0.0006405238
Variovorax sp. SRS16	282217	S	2	6	8	0.0005693545
Rhodoferax sp. PAMC29310	2822760	S	8	0	8	0.0005693545
Polaromonas sp. H8N	1840297	S	1	7	8	0.0005693545
Hydrogenophaga sp. RAC07	1842537	S	7	1	8	0.0005693545
Diaphorobacter sp. HDW4B	2714925	S	8	0	8	0.0005693545
Ramlibacter tataouinensis	94132	S	8	0	8	0.0005693545
Janthinobacterium tructae	2590869	S	4	4	8	0.0005693545
Xylophilus rhododendri	2697032	S	7	1	8	0.0005693545
Usitatibacter rugosus	2732067	S	8	0	8	0.0005693545
Pseudomonas psychrotolerans	237610	S	8	0	8	0.0005693545
Pseudomonas granadensis	1421430	S	7	1	8	0.0005693545
Thermomonas sp. XSG	2771436	S	7	1	8	0.0005693545
Pseudoxanthomonas suwonensis	314722	S	8	0	8	0.0005693545
Kluyvera intermedia	61648	S	8	0	8	0.0005693545
Serratia marcescens	615	S	4	4	8	0.0005693545
Shewanella putrefaciens	24	S	3	5	8	0.0005693545
Rheinheimera sp. LHK132	2498451	S	8	0	8	0.0005693545
Thiothrix sp.	1032	S	8	0	8	0.0005693545
Methylobacterium sp. WL1	2603276	S	8	0	8	0.0005693545
Bradyrhizobium guangzhouense	1325095	S	6	2	8	0.0005693545
Aminobacter sp. MSH1	374606	S	5	3	8	0.0005693545
Rhizobium lusitanum	293958	S	8	0	8	0.0005693545
Rhizobium leguminosarum	384	S	7	1	8	0.0005693545
Sphingomonas sp. MM-1	745310	S	4	4	8	0.0005693545
Sphingopyxis sp. EG6	1874061	S	7	1	8	0.0005693545
Novosphingobium aromaticivorans	48935	S	7	1	8	0.0005693545
Paracoccus mutanolyticus	1499308	S	4	4	8	0.0005693545
Caulobacter henricii	69395	S	7	1	8	0.0005693545
Caulobacter vibrioides	155892	S	6	2	8	0.0005693545
Roseomonas mucosa	207340	S	3	5	8	0.0005693545
Labilithrix luteola	1391654	S	8	0	8	0.0005693545
Helicobacter pylori	210	S	8	0	8	0.0005693545
Rathayibacter festucae	110937	S	5	3	8	0.0005693545
Agreia sp. COWG	2773266	S	8	0	8	0.0005693545
Clavibacter michiganensis	28447	S	3	5	8	0.0005693545
Herbiconiux sp. SALV-R1	2735133	S	8	0	8	0.0005693545
Kocuria palustris	71999	S	7	1	8	0.0005693545
Streptomyces sp. S1A1-7	2594459	S	1	7	8	0.0005693545
Streptomyces venezuelae	54571	S	8	0	8	0.0005693545
Streptomyces hundungensis	1077946	S	8	0	8	0.0005693545
Bifidobacterium adolescentis	1680	S	8	0	8	0.0005693545
Lysinibacillus sphaericus	1421	S	2	6	8	0.0005693545
Coprococcus catus	116085	S	7	1	8	0.0005693545
Meiothermus silvanus	52022	S	8	0	8	0.0005693545
Flavobacterium branchiophilum	55197	S	8	0	8	0.0005693545
Epilithonimonas vandammei	2487072	S	4	4	8	0.0005693545
Bacteroides cellulosilyticus	246787	S	8	0	8	0.0005693545
Sphingobacterium sp. ML3W	1538644	S	5	3	8	0.0005693545
Lacibacter sp. S13-6-6	2760713	S	8	0	8	0.0005693545
Gemmatirosa kalamazoonesis	861299	S	8	0	8	0.0005693545
Symmachiella dynata	2527995	S	8	0	8	0.0005693545
Singulisphaera acidiphila	466153	S	6	2	8	0.0005693545
Burkholderia ambifaria	152480	S	5	2	7	0.0004981852
Burkholderia sp. IDO3	1705310	S	4	3	7	0.0004981852
Diaphorobacter sp. HDW4A	2714924	S	5	2	7	0.0004981852
Massilia putida	1141883	S	5	2	7	0.0004981852
Thauera aromatica	59405	S	3	4	7	0.0004981852
Dechloromonas sp. TW-R-39-2	2654218	S	6	1	7	0.0004981852
Dechloromonas aromatica	259537	S	6	1	7	0.0004981852
Pseudomonas orientalis	76758	S	7	0	7	0.0004981852
Pseudomonas furukawaii	1149133	S	7	0	7	0.0004981852
Acinetobacter wanghuae	2662362	S	7	0	7	0.0004981852
Acinetobacter indicus	756892	S	6	1	7	0.0004981852
Acinetobacter lwoffii	28090	S	3	4	7	0.0004981852
Mesorhizobium sp. M2A.F.Ca.ET.043.02.1.1	2493670	S	3	4	7	0.0004981852
Methylocella tundrae	227605	S	7	0	7	0.0004981852
Sphingomonas sp. AAP5	1523415	S	6	1	7	0.0004981852
Sphingobium sp. KCTC 72723	2733867	S	7	0	7	0.0004981852
Sphingobium hydrophobicum	1673076	S	4	3	7	0.0004981852
Sphingobium amiense	135719	S	3	4	7	0.0004981852
Sphingopyxis sp. OPL5	2486273	S	7	0	7	0.0004981852
Porphyrobacter sp. YT40	2547601	S	4	3	7	0.0004981852
Paracoccus contaminans	1945662	S	7	0	7	0.0004981852
Tabrizicola piscis	2494374	S	7	0	7	0.0004981852
Gemmobacter sp. HYN0069	2169400	S	7	0	7	0.0004981852
Brevundimonas sp. LM2	1938605	S	7	0	7	0.0004981852
Skermanella sp. TT6	2775420	S	3	4	7	0.0004981852
Cystobacter fuscus	43	S	6	1	7	0.0004981852
Microbacterium sp. WY121	2782168	S	7	0	7	0.0004981852
Microlunatus soli	630515	S	7	0	7	0.0004981852
Nocardioides sp. zg-579	2663857	S	5	2	7	0.0004981852
Mycolicibacterium sediminis	1286180	S	6	1	7	0.0004981852
Mycolicibacterium chubuense	1800	S	5	2	7	0.0004981852
Corynebacterium xerosis	1725	S	6	1	7	0.0004981852
Lawsonella clevelandensis	1528099	S	7	0	7	0.0004981852
Streptomyces sp. CdTB01	1725411	S	7	0	7	0.0004981852
Amycolatopsis sp. Hca4	2742131	S	6	1	7	0.0004981852
Bacillus cereus	1396	S	4	3	7	0.0004981852
Nostoc edaphicum	264686	S	6	1	7	0.0004981852
Calothrix brevissima	938406	S	5	2	7	0.0004981852
Alistipes onderdonkii	328813	S	6	1	7	0.0004981852
Aquirufa nivalisilvae	2516557	S	7	0	7	0.0004981852
Gemmata obscuriglobus	114	S	7	0	7	0.0004981852
Opitutus terrae	107709	S	7	0	7	0.0004981852
Nibricoccus aquaticus	2576891	S	7	0	7	0.0004981852
Burkholderia cepacia	292	S	5	1	6	0.0004270159
Burkholderia cenocepacia	95486	S	3	3	6	0.0004270159
Burkholderia mallei	13373	S	2	4	6	0.0004270159
Cupriavidus necator	106590	S	5	1	6	0.0004270159
Cupriavidus gilardii	82541	S	1	5	6	0.0004270159
Pandoraea vervacti	656178	S	6	0	6	0.0004270159
Variovorax sp. PBS-H4	434008	S	5	1	6	0.0004270159
Acidovorax sp. HDW3	2714923	S	6	0	6	0.0004270159
Polaromonas vacuolata	37448	S	6	0	6	0.0004270159
Hydrogenophaga sp. PBC	795665	S	5	1	6	0.0004270159
Comamonas kerstersii	225992	S	6	0	6	0.0004270159
Janthinobacterium sp. PLB02	2808899	S	1	5	6	0.0004270159
Janthinobacterium agaricidamnosum	55508	S	6	0	6	0.0004270159
Paucibacter sp. KCTC 42545	1768242	S	6	0	6	0.0004270159
Alcaligenes faecalis	511	S	6	0	6	0.0004270159
Candidatus Methylopumilus turicensis	1581680	S	6	0	6	0.0004270159
Methylotenera versatilis	1055487	S	6	0	6	0.0004270159
Sulfuritalea hydrogenivorans	748811	S	6	0	6	0.0004270159
Candidatus Accumulibacter phosphatis	327160	S	6	0	6	0.0004270159
Pseudomonas sp. R84	1573712	S	6	0	6	0.0004270159
Pseudomonas sp. DR 5-09	1534110	S	5	1	6	0.0004270159
Pseudomonas sp. RU47	2005388	S	5	1	6	0.0004270159
Stenotrophomonas sp. CW117	2775920	S	1	5	6	0.0004270159
Luteimonas sp. MC1750	2799326	S	6	0	6	0.0004270159
Enterobacter cloacae	550	S	3	3	6	0.0004270159
Enterobacter hormaechei	158836	S	1	5	6	0.0004270159
Candidatus Thiodictyon syntrophicum	1166950	S	6	0	6	0.0004270159
Vibrio anguillarum	55601	S	4	2	6	0.0004270159
Methylobacterium sp. 17Sr1-43	2202828	S	6	0	6	0.0004270159
Methylobacterium durans	2202825	S	6	0	6	0.0004270159
Methylorubrum populi	223967	S	5	1	6	0.0004270159
Bradyrhizobium guangdongense	1325090	S	4	2	6	0.0004270159
Bosea sp. Tri-49	1867715	S	6	0	6	0.0004270159
Bosea vaviloviae	1526658	S	6	0	6	0.0004270159
Tardiphaga robiniae	943830	S	6	0	6	0.0004270159
Mesorhizobium sp. N3	675281	S	6	0	6	0.0004270159
Mesorhizobium sp. 131-2-1	2744518	S	5	1	6	0.0004270159
Agrobacterium tumefaciens	358	S	4	2	6	0.0004270159
Neorhizobium galegae	399	S	6	0	6	0.0004270159
Methylosinus trichosporium	426	S	6	0	6	0.0004270159
Brucella suis	29461	S	1	5	6	0.0004270159
Sphingomonas sp. FARSPH	2219696	S	4	2	6	0.0004270159
Sphingomonas panacisoli	1813879	S	6	0	6	0.0004270159
Sphingobium sp. YBL2	484429	S	2	4	6	0.0004270159
Sphingopyxis macrogoltabida	33050	S	5	1	6	0.0004270159
Sphingopyxis fribergensis	1515612	S	5	1	6	0.0004270159
Blastomonas fulva	1550728	S	3	3	6	0.0004270159
Rhizorhabdus dicambivorans	1850238	S	3	3	6	0.0004270159
Porphyrobacter sp. LM 6	1896196	S	5	1	6	0.0004270159
Croceicoccus marinus	450378	S	4	2	6	0.0004270159
Roseovarius indicus	540747	S	4	2	6	0.0004270159
Salipiger profundus	1229727	S	4	2	6	0.0004270159
Pontivivens sp. MT2928	2789856	S	6	0	6	0.0004270159
Brevundimonas sp. LVF1	2774189	S	5	1	6	0.0004270159
Azospirillum brasilense	192	S	3	3	6	0.0004270159
Roseomonas sp. 1318	2768161	S	6	0	6	0.0004270159
Acetobacter oryzoeni	2500548	S	4	2	6	0.0004270159
Arcobacter aquimarinus	1315211	S	4	2	6	0.0004270159
Campylobacter jejuni	197	S	3	3	6	0.0004270159
Bacteriovorax stolpii	960	S	6	0	6	0.0004270159
Microbacterium sp. ABRD_28	2268461	S	6	0	6	0.0004270159
Microbacterium foliorum	104336	S	6	0	6	0.0004270159
Agromyces aureus	453304	S	6	0	6	0.0004270159
Agrococcus jejuensis	399736	S	6	0	6	0.0004270159
Dermacoccus sp. PAMC28757	2762331	S	6	0	6	0.0004270159
Arthrobacter crystallopoietes	37928	S	6	0	6	0.0004270159
Rothia mucilaginosa	43675	S	6	0	6	0.0004270159
Cellulomonas sp. H30R-01	2704467	S	5	1	6	0.0004270159
Nocardioides sp. JS614	196162	S	5	1	6	0.0004270159
Rhodococcus sp. 008	1723645	S	2	4	6	0.0004270159
Nocardia brasiliensis	37326	S	6	0	6	0.0004270159
Gordonia bronchialis	2054	S	6	0	6	0.0004270159
Streptomyces sp. CB09001	2083284	S	5	1	6	0.0004270159
Saccharopolyspora sp. ASAGF58	2719023	S	1	5	6	0.0004270159
Latilactobacillus curvatus	28038	S	6	0	6	0.0004270159
Enterococcus faecium	1352	S	2	4	6	0.0004270159
Coprococcus comes	410072	S	5	1	6	0.0004270159
Megasphaera elsdenii	907	S	6	0	6	0.0004270159
Nostoc sp. C052	2576902	S	6	0	6	0.0004270159
Dolichospermum compactum	136073	S	3	3	6	0.0004270159
Moorea producens	1155739	S	6	0	6	0.0004270159
[Phormidium] sp. ETS-05	222819	S	6	0	6	0.0004270159
Mycoplasma crocodyli	50052	S	6	0	6	0.0004270159
Flavobacterium sp. BB8	2816357	S	6	0	6	0.0004270159
Flavobacterium sp. CS20	2775246	S	5	1	6	0.0004270159
Flavobacterium haoranii	683124	S	6	0	6	0.0004270159
Flavobacterium commune	1306519	S	6	0	6	0.0004270159
Flavobacterium nackdongense	2547394	S	6	0	6	0.0004270159
Flavobacterium anhuiense	459526	S	5	1	6	0.0004270159
Tenacibaculum mesophilum	104268	S	5	1	6	0.0004270159
Chryseobacterium indologenes	253	S	5	1	6	0.0004270159
Elizabethkingia sp. M8	2796140	S	1	5	6	0.0004270159
Spirosoma pollinicola	2057025	S	6	0	6	0.0004270159
Flammeovirga sp. MY04	1191459	S	6	0	6	0.0004270159
Stieleria neptunia	2527979	S	6	0	6	0.0004270159
Neochlamydia sp. S13	1353976	S	6	0	6	0.0004270159
Burkholderia vietnamiensis	60552	S	2	3	5	0.0003558466
Burkholderia gladioli	28095	S	5	0	5	0.0003558466
Burkholderia plantarii	41899	S	5	0	5	0.0003558466
Pandoraea sputorum	93222	S	5	0	5	0.0003558466
Caballeronia sp. M1242	2814653	S	1	4	5	0.0003558466
Variovorax sp. PAMC 28711	1795631	S	5	0	5	0.0003558466
Variovorax sp. PAMC26660	2762322	S	5	0	5	0.0003558466
Variovorax sp. RKNM96	2681552	S	4	1	5	0.0003558466
Acidovorax avenae	80867	S	4	1	5	0.0003558466
Hydrogenophaga sp. BA0156	2716225	S	4	1	5	0.0003558466
Comamonas serinivorans	1082851	S	5	0	5	0.0003558466
Verminephrobacter eiseniae	364317	S	5	0	5	0.0003558466
Massilia plicata	321984	S	4	1	5	0.0003558466
Herbaspirillum sp. meg3	2025949	S	5	0	5	0.0003558466
Herbaspirillum seropedicae	964	S	4	1	5	0.0003558466
Roseateles depolymerans	76731	S	5	0	5	0.0003558466
Achromobacter denitrificans	32002	S	4	1	5	0.0003558466
Pigmentiphaga aceris	1940612	S	5	0	5	0.0003558466
Aquitalea sp. USM4	1590041	S	5	0	5	0.0003558466
Jeongeupia sp. USM3	1906741	S	5	0	5	0.0003558466
Candidatus Nitrotoga sp. AM1P	2559597	S	5	0	5	0.0003558466
Azoarcus sp. DD4	2027405	S	3	2	5	0.0003558466
Azoarcus communis	41977	S	4	1	5	0.0003558466
Azoarcus olearius	418699	S	4	1	5	0.0003558466
Pseudomonas sp. S34	1573718	S	5	0	5	0.0003558466
Pseudomonas sp. UW4	1207075	S	4	1	5	0.0003558466
Pseudomonas protegens	380021	S	5	0	5	0.0003558466
Pseudomonas azotoformans	47878	S	5	0	5	0.0003558466
Pseudomonas mendocina	300	S	5	0	5	0.0003558466
Pseudomonas amygdali	47877	S	2	3	5	0.0003558466
Pseudomonas lurida	244566	S	5	0	5	0.0003558466
Pseudomonas vancouverensis	95300	S	5	0	5	0.0003558466
Pseudomonas moraviensis	321662	S	5	0	5	0.0003558466
Pseudomonas brassicacearum	930166	S	3	2	5	0.0003558466
Stenotrophomonas sp. WZN-1	2005046	S	4	1	5	0.0003558466
Aerosticca soli	2010829	S	4	1	5	0.0003558466
Escherichia marmotae	1499973	S	5	0	5	0.0003558466
Serratia grimesii	82995	S	5	0	5	0.0003558466
Providencia rettgeri	587	S	1	4	5	0.0003558466
Shewanella sp. Arc9-LZ	2698686	S	3	2	5	0.0003558466
Pseudoalteromonas spongiae	298657	S	5	0	5	0.0003558466
Aeromonas veronii	654	S	4	1	5	0.0003558466
Methylomicrobium album	39775	S	5	0	5	0.0003558466
Solimonas sp. K1W22B-7	2303331	S	5	0	5	0.0003558466
Methylobacterium sp. 4-46	426117	S	5	0	5	0.0003558466
Methylobacterium nodulans	114616	S	5	0	5	0.0003558466
Bradyrhizobium sp. CCGE-LA001	1223566	S	5	0	5	0.0003558466
Bradyrhizobium ottawaense	931866	S	1	4	5	0.0003558466
Mesorhizobium japonicum	2066070	S	3	2	5	0.0003558466
Oricola thermophila	2742145	S	5	0	5	0.0003558466
Rhizobium indicum	2583231	S	4	1	5	0.0003558466
Rhizobium phaseoli	396	S	3	2	5	0.0003558466
Methyloceanibacter sp. wino2	2170729	S	3	2	5	0.0003558466
Parvibaculum lavamentivorans	256618	S	4	1	5	0.0003558466
Pseudorhodoplanes sinuspersici	1235591	S	5	0	5	0.0003558466
Novosphingobium sp. THN1	1016987	S	5	0	5	0.0003558466
Novosphingobium sp. P6W	1609758	S	5	0	5	0.0003558466
Novosphingobium resinovorum	158500	S	4	1	5	0.0003558466
Novosphingopyxis sp. PB63	2762729	S	4	1	5	0.0003558466
Croceicoccus naphthovorans	1348774	S	2	3	5	0.0003558466
Tsuneonella amylolytica	2338327	S	5	0	5	0.0003558466
Rhodobaca barguzinensis	441209	S	5	0	5	0.0003558466
Confluentimicrobium sp. EMB200-NS6	1609966	S	3	2	5	0.0003558466
Brevundimonas sp. 'scallop'	2562582	S	3	2	5	0.0003558466
Caulobacter soli	2708539	S	4	1	5	0.0003558466
Magnetospirillum sp. XM-1	1663591	S	4	1	5	0.0003558466
Roseomonas sp. 546	2768162	S	5	0	5	0.0003558466
Roseococcus sp. NIBR12	2771361	S	5	0	5	0.0003558466
Corallococcus macrosporus	35	S	4	1	5	0.0003558466
Haliangium ochraceum	80816	S	5	0	5	0.0003558466
Bdellovibrio bacteriovorus	959	S	5	0	5	0.0003558466
Microbacterium sp. BH-3-3-3	1906742	S	5	0	5	0.0003558466
Microbacterium hydrocarbonoxydans	273678	S	5	0	5	0.0003558466
Plantibacter sp. M259	2583822	S	4	1	5	0.0003558466
Plantibacter flavus	150123	S	5	0	5	0.0003558466
Rathayibacter sp. VKM Ac-2804	2609257	S	2	3	5	0.0003558466
Aurantimicrobium sp. MWH-Mo1	1987356	S	5	0	5	0.0003558466
Brevibacterium sp. CS2	2575923	S	5	0	5	0.0003558466
Brevibacterium casei	33889	S	5	0	5	0.0003558466
Brevibacterium aurantiacum	273384	S	4	1	5	0.0003558466
Phycicoccus endophyticus	1690220	S	5	0	5	0.0003558466
Cutibacterium granulosum	33011	S	5	0	5	0.0003558466
Marmoricola scoriae	642780	S	5	0	5	0.0003558466
Micropruina glycogenica	75385	S	5	0	5	0.0003558466
Mycolicibacterium anyangense	1431246	S	5	0	5	0.0003558466
Mycobacterium gallinarum	39689	S	3	2	5	0.0003558466
Corynebacterium kefirresidentii	1979527	S	4	1	5	0.0003558466
Gordonia polyisoprenivorans	84595	S	5	0	5	0.0003558466
Streptomyces sp. KPB2	2305221	S	1	4	5	0.0003558466
Streptomyces chartreusis	1969	S	5	0	5	0.0003558466
Streptomyces nojiriensis	66374	S	5	0	5	0.0003558466
Streptomyces hygroscopicus	1912	S	3	2	5	0.0003558466
Streptomyces scabiei	1930	S	1	4	5	0.0003558466
Candidatus Planktophila vernalis	1884907	S	5	0	5	0.0003558466
Candidatus Nanopelagicus limnes	1884634	S	4	1	5	0.0003558466
Kibdelosporangium phytohabitans	860235	S	5	0	5	0.0003558466
Lentzea guizhouensis	1586287	S	5	0	5	0.0003558466
Phytohabitans suffuscus	624315	S	5	0	5	0.0003558466
Frankia inefficax	298654	S	5	0	5	0.0003558466
Kineococcus radiotolerans	131568	S	5	0	5	0.0003558466
Rubrobacter xylanophilus	49319	S	5	0	5	0.0003558466
Bacillus velezensis	492670	S	2	3	5	0.0003558466
Bacillus subtilis	1423	S	2	3	5	0.0003558466
Bacillus pumilus	1408	S	5	0	5	0.0003558466
Staphylococcus haemolyticus	1283	S	5	0	5	0.0003558466
Streptococcus equinus	1335	S	4	1	5	0.0003558466
Streptococcus intermedius	1338	S	2	3	5	0.0003558466
Blautia hansenii	1322	S	4	1	5	0.0003558466
Clostridium taeniosporum	394958	S	5	0	5	0.0003558466
Clostridium perfringens	1502	S	5	0	5	0.0003558466
Clostridium sporogenes	1509	S	1	4	5	0.0003558466
Ruminiclostridium herbifermentans	2488810	S	4	1	5	0.0003558466
Megamonas funiformis	437897	S	5	0	5	0.0003558466
Nostoc sp. NIES-3756	1751286	S	3	2	5	0.0003558466
Calothrix parasitica	1973486	S	5	0	5	0.0003558466
Geminocystis sp. NIES-3709	1617448	S	4	1	5	0.0003558466
Gloeocapsa sp. PCC 7428	1173026	S	5	0	5	0.0003558466
Synechococcus sp. CB0101	232348	S	5	0	5	0.0003558466
Chamaesiphon minutus	1173032	S	5	0	5	0.0003558466
Caldilinea aerophila	133453	S	5	0	5	0.0003558466
Flavobacterium sp. I3-2	2748319	S	3	2	5	0.0003558466
Flavobacterium faecale	1355330	S	5	0	5	0.0003558466
Flavobacterium crassostreae	1763534	S	5	0	5	0.0003558466
Polaribacter sp. SA4-12	1312072	S	3	2	5	0.0003558466
Polaribacter reichenbachii	996801	S	5	0	5	0.0003558466
Kordia antarctica	1218801	S	5	0	5	0.0003558466
Antarcticibacterium flavum	2058175	S	5	0	5	0.0003558466
Kaistella jeonii	266749	S	5	0	5	0.0003558466
Empedobacter falsenii	343874	S	4	1	5	0.0003558466
Spirosoma sp. KUDC1026	2745947	S	5	0	5	0.0003558466
Spirosoma radiotolerans	1379870	S	5	0	5	0.0003558466
Algoriphagus machipongonensis	388413	S	5	0	5	0.0003558466
Mucilaginibacter mali	2740462	S	5	0	5	0.0003558466
Mucilaginibacter rubeus	2027860	S	1	4	5	0.0003558466
Candidatus Cyclonatronum proteinivorum	1457365	S	5	0	5	0.0003558466
Roseimaritima ulvae	980254	S	5	0	5	0.0003558466
Caulifigura coniformis	2527983	S	5	0	5	0.0003558466
Humisphaera borealis	2807512	S	5	0	5	0.0003558466
Roseimicrobium sp. ORNL1	2711231	S	5	0	5	0.0003558466
Akkermansia muciniphila	239935	S	5	0	5	0.0003558466
Paludibaculum fermentans	1473598	S	5	0	5	0.0003558466
Methanobrevibacter smithii	2173	S	5	0	5	0.0003558466
Methanothermus fervidus	2180	S	4	1	5	0.0003558466
Candidatus Nitrosotalea okcheonensis	1903276	S	5	0	5	0.0003558466
Burkholderia contaminans	488447	S	3	1	4	0.0002846772
Burkholderia pseudomallei	28450	S	2	2	4	0.0002846772
Burkholderia glumae	337	S	4	0	4	0.0002846772
Polynucleobacter sp. LimPoW16	1743162	S	4	0	4	0.0002846772
Paraburkholderia acidiphila	2571747	S	4	0	4	0.0002846772
Paraburkholderia phymatum	148447	S	3	1	4	0.0002846772
Cupriavidus metallidurans	119219	S	3	1	4	0.0002846772
Cupriavidus pinatubonensis	248026	S	3	1	4	0.0002846772
Variovorax sp. PAMC28562	2762323	S	4	0	4	0.0002846772
Variovorax sp. RA8	662548	S	3	1	4	0.0002846772
Comamonas piscis	1562974	S	4	0	4	0.0002846772
Ottowia sp. oral taxon 894	1658672	S	4	0	4	0.0002846772
Pulveribacter suum	2116657	S	4	0	4	0.0002846772
Massilia lutea	321985	S	3	1	4	0.0002846772
Janthinobacterium lividum	29581	S	1	3	4	0.0002846772
Collimonas pratensis	279113	S	4	0	4	0.0002846772
Noviherbaspirillum sp. UKPF54	2601898	S	4	0	4	0.0002846772
Achromobacter pestifer	1353889	S	3	1	4	0.0002846772
Bordetella hinzii	103855	S	4	0	4	0.0002846772
Advenella mimigardefordensis	302406	S	4	0	4	0.0002846772
Chromobacterium sp. ATCC 53434	2059672	S	4	0	4	0.0002846772
Chromobacterium phragmitis	2202141	S	3	1	4	0.0002846772
Deefgea sp. D17	2739061	S	4	0	4	0.0002846772
Candidatus Methylopumilus rimovensis	2588535	S	4	0	4	0.0002846772
Thiobacillus denitrificans	36861	S	4	0	4	0.0002846772
Sulfuritortus calidifontis	1914471	S	4	0	4	0.0002846772
Thauera hydrothermalis	2184083	S	4	0	4	0.0002846772
Thauera sp. K11	2005884	S	3	1	4	0.0002846772
Azospira restricta	404405	S	4	0	4	0.0002846772
Azospira oryzae	146939	S	3	1	4	0.0002846772
Aromatoleum petrolei	76116	S	3	1	4	0.0002846772
Pseudomonas sp. 31-12	2201356	S	4	0	4	0.0002846772
Pseudomonas sp. K2W31S-8	2320867	S	4	0	4	0.0002846772
Pseudomonas sp. MPC6	2498848	S	4	0	4	0.0002846772
Pseudomonas sp. C27(2019)	2604941	S	4	0	4	0.0002846772
Pseudomonas sp. IzPS59	2774459	S	4	0	4	0.0002846772
Pseudomonas sp. TUM18999	2725477	S	4	0	4	0.0002846772
Pseudomonas synxantha	47883	S	4	0	4	0.0002846772
Pseudomonas monteilii	76759	S	3	1	4	0.0002846772
Pseudomonas prosekii	1148509	S	4	0	4	0.0002846772
Pseudomonas viciae	2505979	S	4	0	4	0.0002846772
Pseudomonas lalkuanensis	2604832	S	4	0	4	0.0002846772
Pseudomonas arsenicoxydans	702115	S	4	0	4	0.0002846772
Pseudomonas versuta	1788301	S	4	0	4	0.0002846772
Pseudomonas umsongensis	198618	S	4	0	4	0.0002846772
Pseudomonas yamanorum	515393	S	4	0	4	0.0002846772
Pseudomonas cerasi	1583341	S	2	2	4	0.0002846772
Acinetobacter sp. YH12138	2601122	S	4	0	4	0.0002846772
Acinetobacter wuhouensis	1879050	S	4	0	4	0.0002846772
Acinetobacter bereziniae	106648	S	4	0	4	0.0002846772
Acinetobacter soli	487316	S	4	0	4	0.0002846772
Psychrobacter sp. P11G5	1699624	S	2	2	4	0.0002846772
Stenotrophomonas acidaminiphila	128780	S	3	1	4	0.0002846772
Lysobacter capsici	435897	S	4	0	4	0.0002846772
Thermomonas carbonis	1463158	S	4	0	4	0.0002846772
Dyella sp. M7H15-1	2501295	S	4	0	4	0.0002846772
Raoultella ornithinolytica	54291	S	2	2	4	0.0002846772
Yersinia ruckeri	29486	S	4	0	4	0.0002846772
Yersinia massiliensis	419257	S	1	3	4	0.0002846772
Dickeya solani	1089444	S	2	2	4	0.0002846772
Haemophilus parainfluenzae	729	S	4	0	4	0.0002846772
Thioalkalivibrio versutus	106634	S	4	0	4	0.0002846772
Thioalkalivibrio nitratireducens	186931	S	4	0	4	0.0002846772
Photobacterium damselae	38293	S	4	0	4	0.0002846772
Photobacterium gaetbulicola	1295392	S	4	0	4	0.0002846772
Aeromonas sobria	646	S	1	3	4	0.0002846772
Aeromonas caviae	648	S	1	3	4	0.0002846772
Halioglobus maricola	2601894	S	4	0	4	0.0002846772
Zhongshania aliphaticivorans	1470434	S	4	0	4	0.0002846772
Methylomonas denitrificans	1538553	S	4	0	4	0.0002846772
Methylomonas sp. LL1	2785785	S	4	0	4	0.0002846772
Methylomonas rhizoryzae	2608981	S	4	0	4	0.0002846772
Candidatus Rickettsiella viridis	676208	S	4	0	4	0.0002846772
Bradyrhizobium sp. PSBB068	2715960	S	4	0	4	0.0002846772
Bradyrhizobium sp. CCBAU 51765	1325102	S	4	0	4	0.0002846772
Bradyrhizobium sp. TM102	2599819	S	1	3	4	0.0002846772
Bradyrhizobium icense	1274631	S	4	0	4	0.0002846772
Bradyrhizobium paxllaeri	190148	S	4	0	4	0.0002846772
Bradyrhizobium japonicum	375	S	3	1	4	0.0002846772
Bradyrhizobium betae	244734	S	3	1	4	0.0002846772
Bradyrhizobium lablabi	722472	S	2	2	4	0.0002846772
Bosea sp. ANAM02	2020412	S	4	0	4	0.0002846772
Nitratireductor sp. SY7	2599600	S	4	0	4	0.0002846772
Rhizobium rosettiformans	1368430	S	3	1	4	0.0002846772
Rhizobium pusense	648995	S	1	3	4	0.0002846772
Sinorhizobium meliloti	382	S	4	0	4	0.0002846772
Ensifer adhaerens	106592	S	3	1	4	0.0002846772
Devosia sp. A16	1736675	S	4	0	4	0.0002846772
Hyphomicrobium nitrativorans	1427356	S	4	0	4	0.0002846772
Beijerinckia indica	533	S	4	0	4	0.0002846772
Nordella sp. HKS 07	2712222	S	4	0	4	0.0002846772
Chelatococcus daeguensis	444444	S	2	2	4	0.0002846772
Chelatococcus sp. CO-6	1702325	S	2	2	4	0.0002846772
Bartonella sp. HY038	2759660	S	2	2	4	0.0002846772
Sphingomonas sp. DH-S5	2759526	S	4	0	4	0.0002846772
Sphingomonas sp. LMO-1	2681549	S	4	0	4	0.0002846772
Sphingomonas sp. NBWT7	2596913	S	4	0	4	0.0002846772
Sphingomonas sp. LK11	1390395	S	4	0	4	0.0002846772
Sphingomonas sp. C8-2	2492837	S	2	2	4	0.0002846772
Sphingomonas alpina	653931	S	4	0	4	0.0002846772
Sphingomonas sanxanigenens	397260	S	3	1	4	0.0002846772
Sphingobium sp. MI1205	407020	S	2	2	4	0.0002846772
Sphingobium fuliginis	336203	S	2	2	4	0.0002846772
Sphingopyxis sp. MG	1866325	S	1	3	4	0.0002846772
Sphingopyxis terrae	33052	S	4	0	4	0.0002846772
Sphingopyxis granuli	267128	S	1	3	4	0.0002846772
Novosphingobium sp. ES2-1	2780074	S	4	0	4	0.0002846772
Sphingorhabdus sp. SMR4y	2584094	S	4	0	4	0.0002846772
Citromicrobium sp. JL477	1634516	S	3	1	4	0.0002846772
Aurantiacibacter gangjinensis	502682	S	4	0	4	0.0002846772
Paraurantiacibacter namhicola	645517	S	4	0	4	0.0002846772
Sphingosinicella sp. BN140058	1892855	S	4	0	4	0.0002846772
Sandaracinobacter sp. M6	2759707	S	4	0	4	0.0002846772
Paracoccus sp. H4-D09	2812658	S	4	0	4	0.0002846772
Roseovarius sp. THAF9	2587847	S	3	1	4	0.0002846772
Yangia sp. CCB-MM3	1792508	S	4	0	4	0.0002846772
Phaeobacter inhibens	221822	S	3	1	4	0.0002846772
Roseivivax sp. THAF30	2587852	S	1	3	4	0.0002846772
Brevundimonas sp. CS1	2813778	S	3	1	4	0.0002846772
Brevundimonas sp. DS20	1532555	S	2	2	4	0.0002846772
Brevundimonas subvibrioides	74313	S	4	0	4	0.0002846772
Caulobacter segnis	88688	S	3	1	4	0.0002846772
Candidatus Pelagibacter sp. HIMB1321	1388755	S	4	0	4	0.0002846772
Minicystis rosea	888845	S	4	0	4	0.0002846772
Sandaracinus amylolyticus	927083	S	4	0	4	0.0002846772
Archangium violaceum	83451	S	4	0	4	0.0002846772
Corallococcus coralloides	184914	S	4	0	4	0.0002846772
Microbacterium aurum	36805	S	4	0	4	0.0002846772
Microbacterium oleivorans	273677	S	4	0	4	0.0002846772
Microbacterium hominis	162426	S	4	0	4	0.0002846772
Curtobacterium sp. Csp2	2495430	S	1	3	4	0.0002846772
Curtobacterium pusillum	69373	S	4	0	4	0.0002846772
Rhodoluna limnophila	232537	S	4	0	4	0.0002846772
Lysinimonas sp. KACC 19322	2592654	S	4	0	4	0.0002846772
Brevibacterium oceani	358099	S	4	0	4	0.0002846772
Phycicoccus sp. HDW14	2714941	S	4	0	4	0.0002846772
Brachybacterium vulturis	2017484	S	2	2	4	0.0002846772
Auraticoccus monumenti	675864	S	4	0	4	0.0002846772
Nocardioides sp. S5	2017486	S	3	1	4	0.0002846772
Nocardioides aromaticivorans	200618	S	3	1	4	0.0002846772
Kribbella flavida	182640	S	4	0	4	0.0002846772
Rhodococcus fascians	1828	S	4	0	4	0.0002846772
Rhodococcus hoagii	43767	S	4	0	4	0.0002846772
Nocardia seriolae	37332	S	4	0	4	0.0002846772
Nocardia cyriacigeorgica	135487	S	4	0	4	0.0002846772
Nocardia sp. WCH-YHL-001	2755382	S	4	0	4	0.0002846772
Mycolicibacterium helvum	1534349	S	4	0	4	0.0002846772
Mycobacterium stomatepiae	470076	S	4	0	4	0.0002846772
Tsukamurella paurometabola	2061	S	4	0	4	0.0002846772
Streptomyces sp. NA04227	2742136	S	4	0	4	0.0002846772
Streptomyces sp. M56	1495638	S	2	2	4	0.0002846772
Streptomyces aureoverticillatus	66871	S	4	0	4	0.0002846772
Streptomyces armeniacus	83291	S	4	0	4	0.0002846772
Streptomyces niveus	193462	S	4	0	4	0.0002846772
Streptomyces asterosporus	285570	S	4	0	4	0.0002846772
Streptomyces capitiformicae	2014920	S	4	0	4	0.0002846772
Streptomyces gilvosporeus	553510	S	4	0	4	0.0002846772
Streptacidiphilus bronchialis	2126346	S	4	0	4	0.0002846772
Kitasatospora aureofaciens	1894	S	1	3	4	0.0002846772
Pseudonocardia sp. CGMCC 4.1532	2761535	S	4	0	4	0.0002846772
Pseudonocardia sp. EC080610-09	1688404	S	1	3	4	0.0002846772
Actinoalloteichus sp. GBA129-24	1612551	S	1	3	4	0.0002846772
Alloactinosynnema sp. L-07	1653480	S	4	0	4	0.0002846772
Allokutzneria albata	211114	S	4	0	4	0.0002846772
Micromonospora carbonacea	47853	S	4	0	4	0.0002846772
Micromonospora aurantiaca	47850	S	2	2	4	0.0002846772
Frankia sp. QA3	710111	S	4	0	4	0.0002846772
Nakamurella multipartita	53461	S	4	0	4	0.0002846772
Nakamurella panacisegetis	1090615	S	4	0	4	0.0002846772
Catenulispora acidiphila	304895	S	4	0	4	0.0002846772
Weizmannia coagulans	1398	S	4	0	4	0.0002846772
Priestia megaterium	1404	S	3	1	4	0.0002846772
Staphylococcus lloydii	2781774	S	4	0	4	0.0002846772
Alicyclobacillus acidocaldarius	405212	S	4	0	4	0.0002846772
Ligilactobacillus salivarius	1624	S	4	0	4	0.0002846772
Streptococcus thermophilus	1308	S	4	0	4	0.0002846772
Blautia producta	33035	S	3	1	4	0.0002846772
Roseburia hominis	301301	S	3	1	4	0.0002846772
[Ruminococcus] gnavus	33038	S	4	0	4	0.0002846772
Anaerocolumna sp. CTTW	2736602	S	4	0	4	0.0002846772
Clostridium butyricum	1492	S	4	0	4	0.0002846772
Ruminococcus bicirculans	1160721	S	4	0	4	0.0002846772
Oscillibacter sp. NSJ-62	2763056	S	4	0	4	0.0002846772
Aminipila sp. CBA3637	2697030	S	4	0	4	0.0002846772
Eubacterium callanderi	53442	S	2	2	4	0.0002846772
Nostoc sp. 'Lobaria pulmonaria (5183) cyanobiont'	1618022	S	4	0	4	0.0002846772
Nostoc sp. CENA543	1869241	S	4	0	4	0.0002846772
Calothrix sp. NIES-3974	2005462	S	1	3	4	0.0002846772
Synechococcus sp. KORDI-52	585425	S	3	1	4	0.0002846772
Prochlorococcus sp. MIT 0604	1501268	S	3	1	4	0.0002846772
Leptolyngbya boryana	1184	S	4	0	4	0.0002846772
Stanieria cyanosphaera	102116	S	3	1	4	0.0002846772
Acholeplasma laidlawii	2148	S	4	0	4	0.0002846772
Flavobacterium indicum	312277	S	4	0	4	0.0002846772
Flavobacterium gilvum	1492737	S	4	0	4	0.0002846772
Flavobacterium nitrogenifigens	1617283	S	3	1	4	0.0002846772
Myroides fluvii	2572594	S	4	0	4	0.0002846772
Cellulophaga baltica	76594	S	4	0	4	0.0002846772
Psychroflexus sp. ALD_RP9	2777186	S	4	0	4	0.0002846772
Blattabacterium punctulatus	164514	S	3	1	4	0.0002846772
Bacteroides sp. CACC 737	2755405	S	1	3	4	0.0002846772
Bacteroides caccae	47678	S	4	0	4	0.0002846772
Alistipes communis	2585118	S	4	0	4	0.0002846772
Runella sp. SP2	2268026	S	4	0	4	0.0002846772
Mucilaginibacter ginsenosidivorax	862126	S	4	0	4	0.0002846772
Mucilaginibacter gossypii	551996	S	2	2	4	0.0002846772
Filimonas lacunae	477680	S	4	0	4	0.0002846772
Chloroherpeton thalassium	100716	S	4	0	4	0.0002846772
Stieleria maiorica	2795974	S	3	1	4	0.0002846772
Aureliella helgolandensis	2527968	S	4	0	4	0.0002846772
Lacipirellula limnantheis	2528024	S	4	0	4	0.0002846772
Paludisphaera borealis	1387353	S	3	1	4	0.0002846772
Treponema sp. RCC2812	2787628	S	3	1	4	0.0002846772
Sebaldella termitidis	826	S	4	0	4	0.0002846772
Candidatus Solibacter usitatus	332163	S	4	0	4	0.0002846772
Methanosarcina sp. Kolksee	1434099	S	1	3	4	0.0002846772
Methanothrix soehngenii	2223	S	4	0	4	0.0002846772
Methanobrevibacter ruminantium	83816	S	3	1	4	0.0002846772
Methanosphaera sp. BMS	1789762	S	4	0	4	0.0002846772
Candidatus Prometheoarchaeum syntrophicum	2594042	S	4	0	4	0.0002846772
Burkholderia seminalis	488731	S	3	0	3	0.0002135079
Burkholderia sp. CCGE1003	640512	S	3	0	3	0.0002135079
Burkholderia sp. BDU8	1385592	S	3	0	3	0.0002135079
Polynucleobacter sp. MWH-UH21B	1743174	S	3	0	3	0.0002135079
Polynucleobacter difficilis	556054	S	3	0	3	0.0002135079
Paraburkholderia sp. 7MH5	2547399	S	3	0	3	0.0002135079
Paraburkholderia phenoliruptrix	252970	S	2	1	3	0.0002135079
Cupriavidus pauculus	82633	S	3	0	3	0.0002135079
Pandoraea apista	93218	S	3	0	3	0.0002135079
Lautropia mirabilis	47671	S	3	0	3	0.0002135079
Hydrogenophaga sp. PAMC20947	2565558	S	3	0	3	0.0002135079
Hydrogenophaga crassostreae	1763535	S	3	0	3	0.0002135079
Diaphorobacter ruginosibacter	1715720	S	3	0	3	0.0002135079
Serpentinomonas mccroryi	1458426	S	3	0	3	0.0002135079
Massilia albidiflava	321983	S	2	1	3	0.0002135079
Janthinobacterium sp. 17J80-10	2497863	S	3	0	3	0.0002135079
Herbaspirillum rubrisubalbicans	80842	S	3	0	3	0.0002135079
Herbaspirillum huttiense	863372	S	3	0	3	0.0002135079
Undibacterium parvum	401471	S	3	0	3	0.0002135079
Collimonas fungivorans	158899	S	3	0	3	0.0002135079
Glaciimonas sp. PAMC28666	2807626	S	3	0	3	0.0002135079
Bordetella trematum	123899	S	3	0	3	0.0002135079
Bordetella pseudohinzii	1331258	S	3	0	3	0.0002135079
Bordetella genomosp. 8	1416806	S	3	0	3	0.0002135079
Bordetella sp. N	1746199	S	3	0	3	0.0002135079
Bordetella bronchiseptica	518	S	1	2	3	0.0002135079
Castellaniella defragrans	75697	S	3	0	3	0.0002135079
Chitinolyticbacter meiyuanensis	682798	S	3	0	3	0.0002135079
Chromobacterium vaccinii	1108595	S	3	0	3	0.0002135079
Sterolibacterium denitrificans	157592	S	3	0	3	0.0002135079
Sideroxydans lithotrophicus	63745	S	3	0	3	0.0002135079
Ferriphaselus amnicola	1188319	S	3	0	3	0.0002135079
Usitatibacter palustris	2732487	S	3	0	3	0.0002135079
Nitrosospira briensis	35799	S	3	0	3	0.0002135079
Sulfuricella denitrificans	649841	S	3	0	3	0.0002135079
Azospira sp. I09	1765049	S	2	1	3	0.0002135079
Aromatoleum aromaticum	551760	S	2	1	3	0.0002135079
Pseudomonas sp. HLS-6	2049589	S	3	0	3	0.0002135079
Pseudomonas sp. S09G 359	2054919	S	3	0	3	0.0002135079
Pseudomonas sp. StFLB209	1028989	S	3	0	3	0.0002135079
Pseudomonas sp. ADAK22	2730851	S	3	0	3	0.0002135079
Pseudomonas sp. R76	1573711	S	3	0	3	0.0002135079
Pseudomonas tolaasii	29442	S	3	0	3	0.0002135079
Pseudomonas corrugata	47879	S	3	0	3	0.0002135079
Pseudomonas lundensis	86185	S	3	0	3	0.0002135079
Pseudomonas litoralis	797277	S	3	0	3	0.0002135079
Pseudomonas lini	163011	S	3	0	3	0.0002135079
Pseudomonas antarctica	219572	S	3	0	3	0.0002135079
Pseudomonas entomophila	312306	S	3	0	3	0.0002135079
Pseudomonas khazarica	2502979	S	2	1	3	0.0002135079
Acinetobacter sp. CS-2	2798861	S	3	0	3	0.0002135079
Acinetobacter sp. WCHAc010034	1879049	S	3	0	3	0.0002135079
Acinetobacter tandoii	202954	S	3	0	3	0.0002135079
Acinetobacter shaoyimingii	2715164	S	3	0	3	0.0002135079
Acinetobacter lanii	2715163	S	3	0	3	0.0002135079
Acinetobacter dispersus	70348	S	3	0	3	0.0002135079
Psychrobacter sp. DAB_AL43B	1028416	S	3	0	3	0.0002135079
Aquirhabdus parva	2283318	S	3	0	3	0.0002135079
Stenotrophomonas sp. LM091	1904944	S	3	0	3	0.0002135079
Stenotrophomonas sp. NA06056	2742129	S	3	0	3	0.0002135079
Stenotrophomonas rhizophila	216778	S	3	0	3	0.0002135079
Xanthomonas fragariae	48664	S	3	0	3	0.0002135079
Xanthomonas vasicola	56459	S	3	0	3	0.0002135079
Xanthomonas citri	346	S	2	1	3	0.0002135079
Lysobacter gummosus	262324	S	3	0	3	0.0002135079
Lysobacter oculi	2698682	S	3	0	3	0.0002135079
Luteimonas chenhongjianii	2006110	S	3	0	3	0.0002135079
Pseudoxanthomonas mexicana	128785	S	3	0	3	0.0002135079
Arenimonas daejeonensis	370777	S	3	0	3	0.0002135079
Klebsiella quasipneumoniae	1463165	S	2	1	3	0.0002135079
Enterobacteriaceae endosymbiont of Neohaemonia nigricornis	2675792	S	3	0	3	0.0002135079
Enterobacteriaceae endosymbiont of Donacia versicolorea	2675788	S	3	0	3	0.0002135079
[Enterobacter] lignolyticus	1334193	S	3	0	3	0.0002135079
Buttiauxella agrestis	82977	S	3	0	3	0.0002135079
Yersinia rohdei	29485	S	3	0	3	0.0002135079
Yersinia canariae	2607663	S	3	0	3	0.0002135079
Pantoea agglomerans	549	S	3	0	3	0.0002135079
Plesiomonas shigelloides	703	S	3	0	3	0.0002135079
Marinobacter sp. LPB0319	2769486	S	1	2	3	0.0002135079
Marinobacter salinus	1874317	S	3	0	3	0.0002135079
Marinobacter fonticola	2603215	S	3	0	3	0.0002135079
Alcanivorax dieselolei	285091	S	2	1	3	0.0002135079
Gynuella sunshinyii	1445505	S	3	0	3	0.0002135079
Wenzhouxiangella marina	1579979	S	3	0	3	0.0002135079
Vibrio cidicii	1763883	S	2	1	3	0.0002135079
Aeromonas jandaei	650	S	2	1	3	0.0002135079
Aeromonas salmonicida	645	S	1	2	3	0.0002135079
Zobellella denitrificans	347534	S	3	0	3	0.0002135079
Cellvibrio sp. KY-GH-1	2303332	S	2	1	3	0.0002135079
Methylomonas methanica	421	S	3	0	3	0.0002135079
Methylocaldum marinum	1432792	S	3	0	3	0.0002135079
Sedimenticola thiotaurini	1543721	S	3	0	3	0.0002135079
Sinimarinibacterium sp. NLF-5-8	2698684	S	3	0	3	0.0002135079
Microvirga sp. 17 mud 1-3	2082949	S	3	0	3	0.0002135079
Microvirga thermotolerans	2651334	S	3	0	3	0.0002135079
Bradyrhizobium sp. ORS 285	115808	S	3	0	3	0.0002135079
Bradyrhizobium sp. 1(2017)	1404888	S	3	0	3	0.0002135079
Bradyrhizobium canariense	255045	S	3	0	3	0.0002135079
Bradyrhizobium oligotrophicum	44255	S	3	0	3	0.0002135079
Bradyrhizobium zhanjiangense	1325107	S	3	0	3	0.0002135079
Bosea sp. F3-2	2599640	S	3	0	3	0.0002135079
Mesorhizobium sp. M1A.F.Ca.IN.022.06.1.1	2493680	S	3	0	3	0.0002135079
Mesorhizobium sp. 113-3-9	2744517	S	2	1	3	0.0002135079
Mesorhizobium sp. 113-1-2	2744515	S	1	2	3	0.0002135079
Rhizobium favelukesii	348824	S	3	0	3	0.0002135079
Rhizobium gallicum	56730	S	3	0	3	0.0002135079
Agrobacterium larrymoorei	160699	S	3	0	3	0.0002135079
Devosia sp. I507	2083786	S	3	0	3	0.0002135079
Devosia sp. LEGU1	2774137	S	3	0	3	0.0002135079
Hyphomicrobium denitrificans	53399	S	3	0	3	0.0002135079
Rhodomicrobium vannielii	1069	S	3	0	3	0.0002135079
Aquabacter sp. L1I39	2820278	S	3	0	3	0.0002135079
Methylocystis heyeri	391905	S	3	0	3	0.0002135079
Pannonibacter phragmitetus	121719	S	2	1	3	0.0002135079
Aureimonas sp. LMG 31693	2758041	S	3	0	3	0.0002135079
Aureimonas sp. OT7	2816454	S	2	1	3	0.0002135079
Sphingomonas sp. CL5.1	2653203	S	3	0	3	0.0002135079
Sphingomonas sp. LM7	1938607	S	3	0	3	0.0002135079
Sphingomonas ginsengisoli An et al. 2013	363835	S	3	0	3	0.0002135079
Sphingomonas panacis	1560345	S	3	0	3	0.0002135079
Sphingobium sp. RAC03	1843368	S	3	0	3	0.0002135079
Sphingopyxis sp. PAMC25046	2565556	S	3	0	3	0.0002135079
Sphingopyxis alaskensis	117207	S	3	0	3	0.0002135079
Novosphingobium sp. PP1Y	702113	S	3	0	3	0.0002135079
Sphingosinithalassobacter sp. CS137	2762748	S	3	0	3	0.0002135079
Erythrobacter sp. KY5	2011159	S	3	0	3	0.0002135079
Erythrobacter litoralis	39960	S	2	1	3	0.0002135079
Altererythrobacter sp. TH136	2067415	S	3	0	3	0.0002135079
Paracoccus sp. MC1862	2760307	S	3	0	3	0.0002135079
Paracoccus yeei	147645	S	2	1	3	0.0002135079
Sulfitobacter sp. SK011	1389004	S	3	0	3	0.0002135079
Sulfitobacter sp. D7	1968541	S	3	0	3	0.0002135079
Rhodobacter blasticus	1075	S	3	0	3	0.0002135079
Celeribacter indicus	1208324	S	2	1	3	0.0002135079
Oceanicola sp. D3	2587163	S	3	0	3	0.0002135079
Paraoceanicella profunda	2579971	S	3	0	3	0.0002135079
Sagittula sp. P11	2009329	S	2	1	3	0.0002135079
Brevundimonas sp. LVF2	2774190	S	3	0	3	0.0002135079
Brevundimonas sp. GW460-12-10-14-LB2	1827469	S	2	1	3	0.0002135079
Brevundimonas mediterranea	74329	S	3	0	3	0.0002135079
Azospirillum sp. TSH100	652764	S	2	1	3	0.0002135079
Wolbachia endosymbiont of Diaphorina citri	116598	S	1	2	3	0.0002135079
Phreatobacter sp. NMCR1094	2570229	S	3	0	3	0.0002135079
Chondromyces crocatus	52	S	3	0	3	0.0002135079
Stigmatella aurantiaca	41	S	3	0	3	0.0002135079
Anaeromyxobacter sp. K	447217	S	1	2	3	0.0002135079
Geobacter sp. Jerry-YX	2815309	S	2	1	3	0.0002135079
Aliarcobacter cibarius	255507	S	3	0	3	0.0002135079
[Arcobacter] porcinus	1935204	S	3	0	3	0.0002135079
Arcobacter suis	1278212	S	3	0	3	0.0002135079
Campylobacter lanienae	75658	S	3	0	3	0.0002135079
Microbacterium sp. A18JL241	2782166	S	3	0	3	0.0002135079
Microbacterium oxydans	82380	S	3	0	3	0.0002135079
Microbacterium testaceum	2033	S	3	0	3	0.0002135079
Agromyces sp. LHK192	2498704	S	3	0	3	0.0002135079
Agromyces sp. G127AT	2781962	S	3	0	3	0.0002135079
Leifsonia shinshuensis	150026	S	3	0	3	0.0002135079
Salinibacterium sp. UTAS2018	2508880	S	3	0	3	0.0002135079
Frondihabitans sp. 762G35	1446794	S	3	0	3	0.0002135079
Frondihabitans sp. PAMC 28766	1795630	S	3	0	3	0.0002135079
Humibacter sp. WJ7-1	2599293	S	3	0	3	0.0002135079
Microcella alkaliphila	279828	S	3	0	3	0.0002135079
Kocuria sp. BT304	1702043	S	2	1	3	0.0002135079
Arthrobacter sp. PAMC25564	2565366	S	3	0	3	0.0002135079
Glutamicibacter arilaitensis	256701	S	1	2	3	0.0002135079
Brachybacterium sp. SGAir0954	2571029	S	3	0	3	0.0002135079
Xylanimonas cellulosilytica	186189	S	3	0	3	0.0002135079
Xylanimonas allomyrinae	2509459	S	3	0	3	0.0002135079
Isoptericola dokdonensis	372663	S	3	0	3	0.0002135079
Ornithinimicrobium sp. HY006	2508882	S	1	2	3	0.0002135079
Serinicoccus profundi	1078471	S	3	0	3	0.0002135079
Propionibacterium freudenreichii	1744	S	3	0	3	0.0002135079
Microlunatus sp. Gsoil 973	2672569	S	2	1	3	0.0002135079
Microlunatus phosphovorus	29405	S	3	0	3	0.0002135079
Acidipropionibacterium virtanenii	2057246	S	3	0	3	0.0002135079
Nocardioides sp. JQ2195	2592334	S	3	0	3	0.0002135079
Nocardioides euryhalodurans	2518370	S	3	0	3	0.0002135079
Nocardioides daphniae	402297	S	2	1	3	0.0002135079
Aeromicrobium sp. A1-2	2107713	S	2	1	3	0.0002135079
Aeromicrobium yanjiei	2662028	S	1	2	3	0.0002135079
Rhodococcus coprophilus	38310	S	3	0	3	0.0002135079
Rhodococcus koreensis	99653	S	3	0	3	0.0002135079
Nocardia mangyaensis	2213200	S	3	0	3	0.0002135079
Mycolicibacterium mucogenicum	56689	S	2	1	3	0.0002135079
Mycolicibacterium gilvum	1804	S	1	2	3	0.0002135079
Mycobacterium simiae	1784	S	3	0	3	0.0002135079
Mycobacterium dioxanotrophicus	482462	S	3	0	3	0.0002135079
Mycobacterium grossiae	1552759	S	3	0	3	0.0002135079
Mycolicibacter hiberniae	29314	S	3	0	3	0.0002135079
Corynebacterium sp. zg-320	2768834	S	3	0	3	0.0002135079
Corynebacterium sp. LMM-1652	2487892	S	3	0	3	0.0002135079
Corynebacterium imitans	156978	S	3	0	3	0.0002135079
Corynebacterium maris	575200	S	3	0	3	0.0002135079
Corynebacterium tuberculostearicum	38304	S	3	0	3	0.0002135079
Corynebacterium timonense	441500	S	3	0	3	0.0002135079
Corynebacterium propinquum	43769	S	3	0	3	0.0002135079
Corynebacterium genitalium	38288	S	3	0	3	0.0002135079
Corynebacterium segmentosum	43990	S	3	0	3	0.0002135079
Corynebacterium singulare	161899	S	3	0	3	0.0002135079
Corynebacterium testudinoris	136857	S	3	0	3	0.0002135079
Corynebacterium callunae	1721	S	3	0	3	0.0002135079
Corynebacterium riegelii	156976	S	3	0	3	0.0002135079
Gordonia sp. JH63	2698900	S	1	2	3	0.0002135079
Dietzia sp. oral taxon 368	712270	S	1	2	3	0.0002135079
Streptomyces sp. QMT-12	2717324	S	3	0	3	0.0002135079
Streptomyces sp. C8S0	2585716	S	3	0	3	0.0002135079
Streptomyces sp. SCUT-3	2684469	S	3	0	3	0.0002135079
Streptomyces sp. NEAU-sy36	2751189	S	3	0	3	0.0002135079
Streptomyces sp. Tu6071	355249	S	1	2	3	0.0002135079
Streptomyces formicae	1616117	S	3	0	3	0.0002135079
Streptomyces alboniger	132473	S	3	0	3	0.0002135079
Streptomyces lincolnensis	1915	S	3	0	3	0.0002135079
Streptomyces glomeroaurantiacus	68210	S	3	0	3	0.0002135079
Amycolatopsis sp. FDAARGOS 1241	2778070	S	3	0	3	0.0002135079
Amycolatopsis mediterranei	33910	S	3	0	3	0.0002135079
Saccharomonospora xinjiangensis	75294	S	3	0	3	0.0002135079
Saccharothrix sp. 6-C	2781735	S	3	0	3	0.0002135079
Prauserella marina	530584	S	3	0	3	0.0002135079
Micromonospora echinospora	1877	S	3	0	3	0.0002135079
Bifidobacterium thermophilum	33905	S	3	0	3	0.0002135079
Bifidobacterium pseudocatenulatum	28026	S	3	0	3	0.0002135079
Bifidobacterium catenulatum	1686	S	3	0	3	0.0002135079
Bifidobacterium animalis	28025	S	3	0	3	0.0002135079
Gardnerella vaginalis	2702	S	3	0	3	0.0002135079
Actinomyces sp. oral taxon 169	712116	S	3	0	3	0.0002135079
Actinomyces sp. Z16	2079536	S	3	0	3	0.0002135079
Schaalia odontolytica	1660	S	3	0	3	0.0002135079
Streptosporangium sp. 'caverna'	2202249	S	3	0	3	0.0002135079
Actinomadura verrucosospora	46165	S	3	0	3	0.0002135079
Frankia sp. EAN1pec	298653	S	3	0	3	0.0002135079
Epidermidibacterium keratini	1891644	S	3	0	3	0.0002135079
Baekduia soli	496014	S	3	0	3	0.0002135079
Conexibacter woesei	191495	S	3	0	3	0.0002135079
Conexibacter sp. SYSU D00693	2812560	S	3	0	3	0.0002135079
Geobacillus subterraneus	129338	S	1	2	3	0.0002135079
Staphylococcus lugdunensis	28035	S	3	0	3	0.0002135079
Paenibacillus sp. JNUCC-31	2777983	S	3	0	3	0.0002135079
Paenibacillus polymyxa	1406	S	2	1	3	0.0002135079
Sporosarcina ureae	1571	S	3	0	3	0.0002135079
Leuconostoc lactis	1246	S	1	2	3	0.0002135079
Lactiplantibacillus plantarum	1590	S	1	2	3	0.0002135079
Streptococcus mitis	28037	S	3	0	3	0.0002135079
Streptococcus lutetiensis	150055	S	1	2	3	0.0002135079
Enterococcus faecalis	1351	S	3	0	3	0.0002135079
Jeotgalibaca porci	1868793	S	3	0	3	0.0002135079
Butyrivibrio fibrisolvens	831	S	3	0	3	0.0002135079
Enterocloster clostridioformis	1531	S	1	2	3	0.0002135079
Clostridium saccharobutylicum	169679	S	3	0	3	0.0002135079
Clostridium intestinale	36845	S	3	0	3	0.0002135079
Oscillibacter sp. PEA192	2109687	S	1	2	3	0.0002135079
Dysosmobacter welbionis	2093857	S	1	2	3	0.0002135079
Aminipila sp. JN-18	2507160	S	3	0	3	0.0002135079
Desulfosporosinus meridiei	79209	S	3	0	3	0.0002135079
Desulfotomaculum reducens	59610	S	3	0	3	0.0002135079
Biomaibacter acetigenes	2316383	S	3	0	3	0.0002135079
Anabaenopsis circularis	109266	S	2	1	3	0.0002135079
Fischerella sp. NIES-3754	1752063	S	2	1	3	0.0002135079
Scytonema sp. NIES-4073	2005464	S	1	2	3	0.0002135079
Cyanobacterium aponinum	379064	S	3	0	3	0.0002135079
Trichodesmium erythraeum	1206	S	3	0	3	0.0002135079
Planktothrix rubescens	59512	S	3	0	3	0.0002135079
Deinococcus geothermalis	68909	S	3	0	3	0.0002135079
Deinococcus wulumuqiensis	980427	S	3	0	3	0.0002135079
Thermus thermophilus	274	S	3	0	3	0.0002135079
Thermus scotoductus	37636	S	3	0	3	0.0002135079
Candidatus Promineofilum breve	1806508	S	3	0	3	0.0002135079
Flavobacterium sp. HYN0086	2249356	S	3	0	3	0.0002135079
Flavobacterium columnare	996	S	3	0	3	0.0002135079
Flavobacterium pallidum	2172098	S	3	0	3	0.0002135079
Capnocytophaga stomatis	1848904	S	3	0	3	0.0002135079
Capnocytophaga endodontalis	2708117	S	2	1	3	0.0002135079
Polaribacter sp. MED152	313598	S	3	0	3	0.0002135079
Tenacibaculum todarodis	1850252	S	3	0	3	0.0002135079
Myroides odoratus	256	S	3	0	3	0.0002135079
Lacinutrix sp. 5H-3-7-4	983544	S	2	1	3	0.0002135079
Kordia sp. SMS9	2282170	S	3	0	3	0.0002135079
Aequorivita sp. H23M31	2494375	S	3	0	3	0.0002135079
Aequorivita sp. KX20305	2803865	S	3	0	3	0.0002135079
Formosa sediminum	2594004	S	3	0	3	0.0002135079
Aquimarina sp. BL5	1714860	S	3	0	3	0.0002135079
Algibacter sp. L1A34	2686365	S	3	0	3	0.0002135079
Lutibacter profundi	1622118	S	3	0	3	0.0002135079
Gilvibacter sp. SZ-19	754429	S	3	0	3	0.0002135079
Wenyingzhuangia fucanilytica	1790137	S	3	0	3	0.0002135079
Salegentibacter sp. T436	1729720	S	2	1	3	0.0002135079
Chryseobacterium sp. T16E-39	2015076	S	3	0	3	0.0002135079
Chryseobacterium sp. NEB161	2724619	S	2	1	3	0.0002135079
Chryseobacterium piperi	558152	S	3	0	3	0.0002135079
Chryseobacterium cucumeris	1813611	S	3	0	3	0.0002135079
Chryseobacterium gleum	250	S	2	1	3	0.0002135079
Kaistella carnis	1241979	S	3	0	3	0.0002135079
Elizabethkingia bruuniana	1756149	S	1	2	3	0.0002135079
Fluviicola taffensis	191579	S	3	0	3	0.0002135079
Bacteroides sp. HF-5141	2650158	S	3	0	3	0.0002135079
Bacteroides eggerthii	28111	S	3	0	3	0.0002135079
Bacteroides intestinalis	329854	S	3	0	3	0.0002135079
Bacteroides xylanisolvens	371601	S	2	1	3	0.0002135079
Prevotella sp. WR041	2801997	S	3	0	3	0.0002135079
Paraprevotella xylaniphila	454155	S	3	0	3	0.0002135079
Paludibacter propionicigenes	185300	S	3	0	3	0.0002135079
Runella slithyformis	106	S	3	0	3	0.0002135079
Dyadobacter fermentans	94254	S	3	0	3	0.0002135079
Cytophaga hutchinsonii	985	S	3	0	3	0.0002135079
Hymenobacter sp. NBH84	2596915	S	3	0	3	0.0002135079
Pontibacter russatus	2694929	S	3	0	3	0.0002135079
Algoriphagus sanaruensis	1727163	S	3	0	3	0.0002135079
Chryseolinea soli	2321403	S	3	0	3	0.0002135079
Pedobacter sp. CJ43	2605747	S	3	0	3	0.0002135079
Pedobacter suwonensis	332999	S	3	0	3	0.0002135079
Sphingobacterium sp. UDSM-2020	2795738	S	2	1	3	0.0002135079
Sphingobacterium spiritivorum	258	S	3	0	3	0.0002135079
Sphingobacterium siyangense	459529	S	1	2	3	0.0002135079
Solitalea canadensis	995	S	3	0	3	0.0002135079
Arachidicoccus ginsenosidivorans	496057	S	3	0	3	0.0002135079
Flavisolibacter tropicus	1492898	S	3	0	3	0.0002135079
Niastella koreensis	354356	S	3	0	3	0.0002135079
Flavihumibacter sp. SB-02	2676868	S	3	0	3	0.0002135079
Pseudobacter ginsenosidimutans	661488	S	3	0	3	0.0002135079
Paraflavitalea soli	2315862	S	3	0	3	0.0002135079
Gemmatimonas phototrophica	1379270	S	3	0	3	0.0002135079
Gemmatimonas sp. TET16	2732249	S	3	0	3	0.0002135079
Pirellula sp. SH-Sr6A	1632865	S	3	0	3	0.0002135079
Lignipirellula cremea	2528010	S	3	0	3	0.0002135079
Lacipirellula parvula	2650471	S	3	0	3	0.0002135079
Pirellulimonas nuda	2528009	S	3	0	3	0.0002135079
Gimesia fumaroli	2527976	S	3	0	3	0.0002135079
Gimesia chilikensis	2605989	S	2	1	3	0.0002135079
Planctomyces sp. SH-PL14	1632864	S	3	0	3	0.0002135079
Planctopirus ephydatiae	2528019	S	3	0	3	0.0002135079
Rubinisphaera brasiliensis	119	S	3	0	3	0.0002135079
Ereboglobus luteus	1796921	S	3	0	3	0.0002135079
Borreliella burgdorferi	139	S	3	0	3	0.0002135079
Turneriella parva	29510	S	3	0	3	0.0002135079
Fusobacterium hwasookii	1583098	S	1	2	3	0.0002135079
Granulicella sp. WH15	2602070	S	3	0	3	0.0002135079
Fervidobacterium pennivorans	93466	S	2	1	3	0.0002135079
Nitrospira moscoviensis	42253	S	2	1	3	0.0002135079
Nitrospira japonica	1325564	S	2	1	3	0.0002135079
Haloarcula sp. JP-L23	2716717	S	3	0	3	0.0002135079
Halarchaeum sp. CBA1220	1853682	S	3	0	3	0.0002135079
Haloterrigena longa	370324	S	3	0	3	0.0002135079
Methanohalophilus portucalensis	39664	S	3	0	3	0.0002135079
Methanobacterium lacus	877455	S	3	0	3	0.0002135079
Ralstonia pickettii	329	S	2	0	2	0.0001423386
Ralstonia mannitolilytica	105219	S	2	0	2	0.0001423386
Burkholderia anthina	179879	S	2	0	2	0.0001423386
Burkholderia sp. DHOD12	2571746	S	2	0	2	0.0001423386
Polynucleobacter paneuropaeus	2527775	S	2	0	2	0.0001423386
Paraburkholderia atlantica	2654982	S	2	0	2	0.0001423386
Paraburkholderia tropica	92647	S	2	0	2	0.0001423386
Paraburkholderia fungorum	134537	S	2	0	2	0.0001423386
Paraburkholderia aromaticivorans	2026199	S	2	0	2	0.0001423386
Paraburkholderia ginsengisoli	311231	S	2	0	2	0.0001423386
Paraburkholderia xenovorans	36873	S	1	1	2	0.0001423386
Cupriavidus oxalaticus	96344	S	2	0	2	0.0001423386
Pandoraea pnomenusa	93220	S	2	0	2	0.0001423386
Pandoraea oxalativorans	573737	S	2	0	2	0.0001423386
Pandoraea faecigallinarum	656179	S	2	0	2	0.0001423386
Ephemeroptericola cinctiostellae	2268024	S	2	0	2	0.0001423386
Acidovorax cattleyae	80868	S	2	0	2	0.0001423386
Hydrogenophaga sp. YM1	2806262	S	2	0	2	0.0001423386
Comamonas sp. NLF-7-7	2597701	S	2	0	2	0.0001423386
Serpentinomonas raichei	1458425	S	2	0	2	0.0001423386
Melaminivora sp. SC2-9	2109913	S	2	0	2	0.0001423386
Massilia sp. YMA4	1593482	S	1	1	2	0.0001423386
Janthinobacterium sp. LM6	1938606	S	1	1	2	0.0001423386
Duganella sp. GN2-R2	2728020	S	2	0	2	0.0001423386
Herbaspirillum frisingense	92645	S	2	0	2	0.0001423386
Herbaspirillum robiniae	2014887	S	2	0	2	0.0001423386
Collimonas arenae	279058	S	2	0	2	0.0001423386
Oxalobacter formigenes	847	S	2	0	2	0.0001423386
Thiomonas intermedia	926	S	2	0	2	0.0001423386
Achromobacter sp. AONIH1	1758194	S	2	0	2	0.0001423386
Bordetella avium	521	S	2	0	2	0.0001423386
Bordetella holmesii	35814	S	2	0	2	0.0001423386
Bordetella genomosp. 13	463040	S	2	0	2	0.0001423386
Orrella dioscoreae	1851544	S	2	0	2	0.0001423386
Neisseria sp. ZJ785	2709396	S	2	0	2	0.0001423386
Eikenella exigua	2528037	S	1	1	2	0.0001423386
Alysiella filiformis	194196	S	2	0	2	0.0001423386
Iodobacter fluviatilis	537	S	2	0	2	0.0001423386
Candidatus Methylopumilus planktonicus	1581557	S	2	0	2	0.0001423386
Methylobacillus flagellatus	405	S	2	0	2	0.0001423386
Denitratisoma oestradiolicum	311182	S	2	0	2	0.0001423386
Denitratisoma sp. DHT3	1981880	S	2	0	2	0.0001423386
Methyloversatilis sp. RAC08	1842540	S	2	0	2	0.0001423386
Nitrosomonas sp. Is79A3	261292	S	2	0	2	0.0001423386
Sulfuriferula plumbiphila	171865	S	2	0	2	0.0001423386
Sulfuriferula sp. AH1	1985873	S	2	0	2	0.0001423386
Azoarcus sp. M9-3-2	2016596	S	2	0	2	0.0001423386
Azoarcus pumilus	2067960	S	2	0	2	0.0001423386
Niveibacterium sp. HC41	2811415	S	2	0	2	0.0001423386
Dechloromonas sp. HYN0024	2231055	S	2	0	2	0.0001423386
Pseudomonas sp. PDNC002	2811422	S	2	0	2	0.0001423386
Pseudomonas sp. SCB32	2653853	S	2	0	2	0.0001423386
Pseudomonas sp. B11D7D	2735906	S	2	0	2	0.0001423386
Pseudomonas sp. R32	1573704	S	2	0	2	0.0001423386
Pseudomonas sp. R5-89-07	658644	S	2	0	2	0.0001423386
Pseudomonas sp. CC6-YY-74	1930532	S	2	0	2	0.0001423386
Pseudomonas sp. TCU-HL1	1856685	S	2	0	2	0.0001423386
Pseudomonas sp. TMW 2.1634	1886807	S	1	1	2	0.0001423386
Pseudomonas sp. OST1909	2777367	S	1	1	2	0.0001423386
Pseudomonas trivialis	200450	S	2	0	2	0.0001423386
Pseudomonas brenneri	129817	S	2	0	2	0.0001423386
Pseudomonas mandelii	75612	S	1	1	2	0.0001423386
Pseudomonas taetrolens	47884	S	2	0	2	0.0001423386
Pseudomonas reinekei	395598	S	2	0	2	0.0001423386
Pseudomonas sihuiensis	1274359	S	2	0	2	0.0001423386
Pseudomonas oryzae	1392877	S	2	0	2	0.0001423386
Pseudomonas knackmussii	65741	S	2	0	2	0.0001423386
Pseudomonas frederiksbergensis	104087	S	2	0	2	0.0001423386
Acinetobacter sp. TTH0-4	1646498	S	2	0	2	0.0001423386
Acinetobacter sp. NEB149	2725684	S	1	1	2	0.0001423386
Acinetobacter haemolyticus	29430	S	2	0	2	0.0001423386
Acinetobacter ursingii	108980	S	2	0	2	0.0001423386
Acinetobacter radioresistens	40216	S	2	0	2	0.0001423386
Acinetobacter piscicola	2006115	S	2	0	2	0.0001423386
Acinetobacter oleivorans	1148157	S	2	0	2	0.0001423386
Moraxella catarrhalis	480	S	2	0	2	0.0001423386
Lysobacter sp. TY2-98	2290922	S	2	0	2	0.0001423386
Lysobacter sp. HDW10	2714936	S	2	0	2	0.0001423386
Lysobacter sp. CW239	2762611	S	1	1	2	0.0001423386
Lysobacter antibioticus	84531	S	2	0	2	0.0001423386
Lysobacter maris	1605891	S	2	0	2	0.0001423386
Xylella fastidiosa	2371	S	2	0	2	0.0001423386
Dyella sp. G9	2763498	S	2	0	2	0.0001423386
Dyella thiooxydans	445710	S	2	0	2	0.0001423386
Rhodanobacter sp. FDAARGOS 1247	2778082	S	2	0	2	0.0001423386
Dokdonella koreensis	323415	S	2	0	2	0.0001423386
Klebsiella huaxiensis	2153354	S	2	0	2	0.0001423386
Enterobacter roggenkampii	1812935	S	1	1	2	0.0001423386
Cronobacter malonaticus	413503	S	2	0	2	0.0001423386
Cronobacter condimenti	1163710	S	2	0	2	0.0001423386
Pluralibacter gergoviae	61647	S	2	0	2	0.0001423386
Salmonella enterica	28901	S	2	0	2	0.0001423386
Kosakonia sacchari	1158459	S	2	0	2	0.0001423386
Jejubacter calystegiae	2579935	S	2	0	2	0.0001423386
Yersinia enterocolitica	630	S	1	1	2	0.0001423386
Chania multitudinisentens	1639108	S	2	0	2	0.0001423386
Pantoea ananatis	553	S	2	0	2	0.0001423386
Erwinia gerundensis	1619313	S	2	0	2	0.0001423386
Wigglesworthia glossinidia	51229	S	2	0	2	0.0001423386
Xenorhabdus bovienii	40576	S	2	0	2	0.0001423386
Arsenophonus nasoniae	638	S	1	1	2	0.0001423386
Jinshanibacter zhutongyuii	2498113	S	2	0	2	0.0001423386
Haemophilus haemolyticus	726	S	2	0	2	0.0001423386
Actinobacillus sp. GY-402	2774188	S	2	0	2	0.0001423386
Basfia succiniciproducens	653940	S	2	0	2	0.0001423386
Shewanella woodyi	60961	S	2	0	2	0.0001423386
Marinobacter salarius	1420917	S	2	0	2	0.0001423386
Alteromonas sp. BL110	1714845	S	1	1	2	0.0001423386
Salinimonas sediminis	2303538	S	2	0	2	0.0001423386
Paraglaciecola psychrophila	326544	S	2	0	2	0.0001423386
Paraglaciecola sp. L3A3	2686358	S	2	0	2	0.0001423386
Pseudoalteromonas sp. SM1988	2744479	S	2	0	2	0.0001423386
Pseudoalteromonas sp. SM9913	234831	S	1	1	2	0.0001423386
Pseudoalteromonas tunicata	314281	S	2	0	2	0.0001423386
Colwellia sp. Arc7-635	2497879	S	2	0	2	0.0001423386
Thalassotalea sp. HSM 43	2552945	S	2	0	2	0.0001423386
Halomonas huangheensis	1178482	S	2	0	2	0.0001423386
Halomonas socia	1081866	S	2	0	2	0.0001423386
Halomonas hydrothermalis	115561	S	1	1	2	0.0001423386
Candidatus Portiera aleyrodidarum	91844	S	2	0	2	0.0001423386
Salinicola tamaricis	1771309	S	2	0	2	0.0001423386
Cobetia sp. cqz5-12	2609415	S	1	1	2	0.0001423386
Thalassolituus oleivorans	187493	S	2	0	2	0.0001423386
Nitrosococcus oceani	1229	S	1	1	2	0.0001423386
Nitrosococcus watsonii	473531	S	1	1	2	0.0001423386
Thiocystis violascens	73141	S	2	0	2	0.0001423386
Thioflavicoccus mobilis	80679	S	2	0	2	0.0001423386
Acidihalobacter ferrooxydans	1765967	S	2	0	2	0.0001423386
Acidihalobacter yilgarnenesis	2819280	S	2	0	2	0.0001423386
Sulfurivermis fontis	1972068	S	2	0	2	0.0001423386
Vibrio parahaemolyticus	670	S	2	0	2	0.0001423386
Vibrio diabolicus	50719	S	1	1	2	0.0001423386
Vibrio sp. SM1977	2662262	S	2	0	2	0.0001423386
Vibrio vulnificus	672	S	2	0	2	0.0001423386
Vibrio spartinae	1918945	S	2	0	2	0.0001423386
Vibrio astriarenae	1481923	S	2	0	2	0.0001423386
Vibrio kanaloae	170673	S	2	0	2	0.0001423386
Aliivibrio fischeri	668	S	2	0	2	0.0001423386
Grimontia hollisae	673	S	2	0	2	0.0001423386
Aeromonas hydrophila	644	S	1	1	2	0.0001423386
Oceanimonas sp. GK1	511062	S	2	0	2	0.0001423386
Succinivibrio dextrinosolvens	83771	S	2	0	2	0.0001423386
Cellvibrio sp. PSBB023	1945512	S	2	0	2	0.0001423386
Cellvibrio sp. KY-YJ-3	454662	S	1	1	2	0.0001423386
Cellvibrio japonicus	155077	S	2	0	2	0.0001423386
Teredinibacter turnerae	2426	S	2	0	2	0.0001423386
Teredinibacter purpureus	2731756	S	2	0	2	0.0001423386
Kineobactrum salinum	2708301	S	2	0	2	0.0001423386
Legionella sp. TUM19329	2708020	S	2	0	2	0.0001423386
Legionella pneumophila	446	S	2	0	2	0.0001423386
Legionella fallonii	96230	S	2	0	2	0.0001423386
Coxiella endosymbiont of Amblyomma sculptum	2487929	S	2	0	2	0.0001423386
Thiosulfatimonas sediminis	2675054	S	2	0	2	0.0001423386
Francisella persica	954	S	1	1	2	0.0001423386
Immundisolibacter cernigliae	1810504	S	2	0	2	0.0001423386
Methylobacterium sp. 17Sr1-1	2202826	S	2	0	2	0.0001423386
Methylobacterium terrae	2202827	S	2	0	2	0.0001423386
Microvirga ossetica	1882682	S	2	0	2	0.0001423386
Bradyrhizobium sp. ORS 278	114615	S	2	0	2	0.0001423386
Bradyrhizobium sp. CCBAU 53351	1325114	S	2	0	2	0.0001423386
Bradyrhizobium sp. CCBAU 53338	1325111	S	2	0	2	0.0001423386
Bradyrhizobium sp. CCBAU 51753	1325100	S	2	0	2	0.0001423386
Bradyrhizobium genosp. B	83627	S	2	0	2	0.0001423386
Bradyrhizobium cosmicum	1404864	S	2	0	2	0.0001423386
Bosea sp. PAMC 26642	1792307	S	2	0	2	0.0001423386
Bosea sp. RAC05	1842539	S	2	0	2	0.0001423386
Variibacter gotjawalensis	1333996	S	2	0	2	0.0001423386
Mesorhizobium sp. NBSH29	2654249	S	2	0	2	0.0001423386
Mesorhizobium sp. INR15	2654248	S	2	0	2	0.0001423386
Mesorhizobium sp. M1D.F.Ca.ET.043.01.1.1	2493669	S	2	0	2	0.0001423386
Mesorhizobium sp. NZP2298	2483403	S	2	0	2	0.0001423386
Mesorhizobium sp. DCY119	2108445	S	2	0	2	0.0001423386
Mesorhizobium opportunistum	593909	S	2	0	2	0.0001423386
Mesorhizobium oceanicum	1670800	S	2	0	2	0.0001423386
Phyllobacterium zundukense	1867719	S	2	0	2	0.0001423386
Lentilitoribacter sp. Alg239-R112	2305987	S	2	0	2	0.0001423386
Rhizobium sp. ACO-34A	1571470	S	2	0	2	0.0001423386
Rhizobium sp. WL3	2603277	S	2	0	2	0.0001423386
Rhizobium jaguaris	1312183	S	2	0	2	0.0001423386
Rhizobium tropici	398	S	2	0	2	0.0001423386
Rhizobium pseudoryzae	379684	S	2	0	2	0.0001423386
Agrobacterium fabrum	1176649	S	1	1	2	0.0001423386
Sinorhizobium medicae	110321	S	2	0	2	0.0001423386
Sinorhizobium americanum	194963	S	2	0	2	0.0001423386
Sinorhizobium fredii	380	S	1	1	2	0.0001423386
Ensifer mexicanus	375549	S	2	0	2	0.0001423386
Devosia ginsengisoli	400770	S	2	0	2	0.0001423386
Blastochloris tepida	2233851	S	2	0	2	0.0001423386
Rhodoplanes sp. Z2-YC6860	674703	S	2	0	2	0.0001423386
Candidatus Filomicrobium marinum	1608628	S	2	0	2	0.0001423386
Caenibius tardaugens	169176	S	1	1	2	0.0001423386
Pseudolabrys sp. FHR47	2562284	S	2	0	2	0.0001423386
Ancylobacter pratisalsi	1745854	S	2	0	2	0.0001423386
Starkeya novella	921	S	2	0	2	0.0001423386
Labrys sp. KNU-23	2789216	S	2	0	2	0.0001423386
Methylocystis parvus	134	S	2	0	2	0.0001423386
Methylocystis rosea	173366	S	2	0	2	0.0001423386
Methylovirgula ligni	569860	S	2	0	2	0.0001423386
Labrenzia sp. VG12	2021862	S	1	1	2	0.0001423386
Labrenzia sp. PHM005	2590016	S	1	1	2	0.0001423386
Martelella mediterranea	293089	S	2	0	2	0.0001423386
Bartonella bacilliformis	774	S	1	1	2	0.0001423386
Cohaesibacter sp. ES.047	1798205	S	2	0	2	0.0001423386
Lichenihabitans psoromatis	2528642	S	2	0	2	0.0001423386
Sphingomonas sp. sand1-3	2764186	S	2	0	2	0.0001423386
Sphingomonas sp. HDW15A	2714942	S	2	0	2	0.0001423386
Sphingomonas sp. C33	2698679	S	2	0	2	0.0001423386
Sphingomonas insulae	424800	S	2	0	2	0.0001423386
Sphingobium sp. SYK-6	627192	S	2	0	2	0.0001423386
Sphingobium sp. TKS	1315974	S	1	1	2	0.0001423386
Sphingobium chlorophenolicum	46429	S	2	0	2	0.0001423386
Sphingobium cloacae	120107	S	1	1	2	0.0001423386
Sphingobium baderi	1332080	S	1	1	2	0.0001423386
Sphingopyxis sp. FD7	1914525	S	2	0	2	0.0001423386
Novosphingobium sp. ABRDHK2	2571749	S	2	0	2	0.0001423386
Zymomonas mobilis	542	S	1	1	2	0.0001423386
Porphyrobacter sp. CACIAM 03H1	2003315	S	2	0	2	0.0001423386
Erythrobacter neustonensis	1112	S	2	0	2	0.0001423386
Erythrobacter aureus	2182384	S	2	0	2	0.0001423386
Pelagerythrobacter marensis	543877	S	2	0	2	0.0001423386
Sphingosinicella sp. UDD2	2771430	S	2	0	2	0.0001423386
Sphingosinicella microcystinivorans	335406	S	2	0	2	0.0001423386
Paracoccus sp. BM15	1529068	S	2	0	2	0.0001423386
Paracoccus sp. Arc7-R13	2500532	S	2	0	2	0.0001423386
Paracoccus pantotrophus	82367	S	2	0	2	0.0001423386
Sulfitobacter sp. AM1-D1	1917485	S	1	1	2	0.0001423386
Sulfitobacter pseudonitzschiae	1402135	S	2	0	2	0.0001423386
Roseovarius sp. THAF8	2587846	S	1	1	2	0.0001423386
Roseovarius faecimaris	2494550	S	2	0	2	0.0001423386
Salipiger pacificus	311180	S	2	0	2	0.0001423386
Rhodobacter capsulatus	1061	S	2	0	2	0.0001423386
Celeribacter marinus	1397108	S	2	0	2	0.0001423386
Ruegeria pomeroyi	89184	S	2	0	2	0.0001423386
Leisingera aquaemixtae	1396826	S	2	0	2	0.0001423386
Pseudorhodobacter turbinis	2500533	S	2	0	2	0.0001423386
Rhodovulum sp. MB263	308754	S	2	0	2	0.0001423386
Marinovum algicola	42444	S	2	0	2	0.0001423386
Mameliella alba	561184	S	2	0	2	0.0001423386
Ketogulonicigenium vulgare	92945	S	2	0	2	0.0001423386
Brevundimonas sp. SGAir0440	2579977	S	2	0	2	0.0001423386
Brevundimonas sp. M20	2591463	S	2	0	2	0.0001423386
Brevundimonas sp. AJA228-03	2752515	S	2	0	2	0.0001423386
Brevundimonas sp. Bb-A	2560058	S	1	1	2	0.0001423386
Brevundimonas diminuta	293	S	1	1	2	0.0001423386
Caulobacter flavus	1679497	S	2	0	2	0.0001423386
Caulobacter rhizosphaerae	2010972	S	2	0	2	0.0001423386
Phenylobacterium zucineum	284016	S	2	0	2	0.0001423386
Azospirillum sp. TSA2s	709810	S	1	1	2	0.0001423386
Azospirillum thiophilum	528244	S	2	0	2	0.0001423386
Magnetospirillum magneticum	84159	S	2	0	2	0.0001423386
Skermanella pratensis	2233999	S	1	1	2	0.0001423386
Ferrovibrio terrae	2594003	S	2	0	2	0.0001423386
Niveispirillum cyanobacteriorum	1612173	S	2	0	2	0.0001423386
Indioceanicola profundi	2220096	S	2	0	2	0.0001423386
Hypericibacter terrae	2602015	S	2	0	2	0.0001423386
Gluconobacter sphaericus	574987	S	1	1	2	0.0001423386
Acidibrevibacterium fodinaquatile	1969806	S	2	0	2	0.0001423386
Kozakia baliensis	153496	S	2	0	2	0.0001423386
Ehrlichia canis	944	S	1	1	2	0.0001423386
Rickettsia rhipicephali	33992	S	1	1	2	0.0001423386
Kordiimonas pumila	2161677	S	2	0	2	0.0001423386
Hyphobacterium sp. CCMP332	2749086	S	2	0	2	0.0001423386
Melittangium boletus	83453	S	2	0	2	0.0001423386
Myxococcus xanthus	34	S	2	0	2	0.0001423386
Myxococcus stipitatus	83455	S	1	1	2	0.0001423386
Vulgatibacter incomptus	1391653	S	2	0	2	0.0001423386
Desulfovibrio desulfuricans	876	S	2	0	2	0.0001423386
Pseudodesulfovibrio aespoeensis	182210	S	2	0	2	0.0001423386
Desulfocurvibacter africanus	873	S	2	0	2	0.0001423386
Geobacter uraniireducens	351604	S	2	0	2	0.0001423386
Geoalkalibacter subterraneus	483547	S	2	0	2	0.0001423386
Syntrophotalea carbinolica	19	S	2	0	2	0.0001423386
Desulfarculus baarsii	453230	S	2	0	2	0.0001423386
Bradymonas sediminis	1548548	S	2	0	2	0.0001423386
Aliarcobacter butzleri	28197	S	2	0	2	0.0001423386
Arcobacter venerupis	1054033	S	2	0	2	0.0001423386
Pseudoarcobacter acticola	1849015	S	2	0	2	0.0001423386
Poseidonibacter lekithochrous	1904463	S	2	0	2	0.0001423386
Campylobacter blaseri	2042961	S	2	0	2	0.0001423386
Campylobacter showae	204	S	2	0	2	0.0001423386
Sulfurospirillum sp. JPD-1	220622	S	1	1	2	0.0001423386
Sulfurospirillum cavolei	366522	S	2	0	2	0.0001423386
Helicobacter cholecystus	45498	S	2	0	2	0.0001423386
Sulfurimonas denitrificans	39766	S	2	0	2	0.0001423386
Nautilia sp. PV-1	2579250	S	2	0	2	0.0001423386
Bdellovibrio sp. NC01	2220073	S	2	0	2	0.0001423386
Silvanigrella aquatica	1915309	S	2	0	2	0.0001423386
Microbacterium sp. 10M-3C3	2483401	S	2	0	2	0.0001423386
Microbacterium sp. NY27	2782169	S	2	0	2	0.0001423386
Microbacterium sp. A18JL200	2782167	S	2	0	2	0.0001423386
Microbacterium sp. CBA3102	2603598	S	2	0	2	0.0001423386
Microbacterium sp. 4R-513	2567934	S	2	0	2	0.0001423386
Microbacterium sp. Y-01	2048898	S	2	0	2	0.0001423386
Microbacterium pygmaeum	370764	S	2	0	2	0.0001423386
Agromyces flavus	589382	S	2	0	2	0.0001423386
Agromyces badenianii	2080742	S	2	0	2	0.0001423386
Rathayibacter sp. VKM Ac-2760	2609253	S	1	1	2	0.0001423386
Leucobacter muris	1935379	S	2	0	2	0.0001423386
Leucobacter sp. CX169	2813744	S	2	0	2	0.0001423386
Cryobacterium sp. LW097	1978566	S	2	0	2	0.0001423386
Cryobacterium arcticum	670052	S	2	0	2	0.0001423386
Microterricola viridarii	412690	S	2	0	2	0.0001423386
Gryllotalpicola protaetiae	2419771	S	2	0	2	0.0001423386
Chryseoglobus sp. 28M-23	2772253	S	1	1	2	0.0001423386
Frigoribacterium sp. NBH87	2596916	S	2	0	2	0.0001423386
Arthrobacter sp. UKPF54-2	2600159	S	2	0	2	0.0001423386
Arthrobacter sp. ERGS1:01	1704044	S	2	0	2	0.0001423386
Rothia dentocariosa	2047	S	2	0	2	0.0001423386
Glutamicibacter protophormiae	37930	S	1	1	2	0.0001423386
Pseudarthrobacter sp. YJ56	2697569	S	2	0	2	0.0001423386
Paenarthrobacter sp. YJN-D	2735317	S	2	0	2	0.0001423386
Brevibacterium linens	1703	S	2	0	2	0.0001423386
Cellulomonas sp. Y8	2591145	S	2	0	2	0.0001423386
Cellulomonas fimi	1708	S	2	0	2	0.0001423386
Cellulomonas flavigena	1711	S	2	0	2	0.0001423386
Janibacter melonis	262209	S	2	0	2	0.0001423386
Janibacter indicus	857417	S	2	0	2	0.0001423386
Cellulosimicrobium cellulans	1710	S	1	1	2	0.0001423386
Ornithinimicrobium flavum	1288636	S	1	1	2	0.0001423386
Kytococcus sedentarius	1276	S	2	0	2	0.0001423386
Sanguibacter keddieii	60920	S	2	0	2	0.0001423386
Haloactinobacterium sp. RN3S43	2779775	S	2	0	2	0.0001423386
Propionibacterium australiense	119981	S	2	0	2	0.0001423386
Propionibacterium acidifaciens	556499	S	2	0	2	0.0001423386
Microlunatus sagamiharensis	546874	S	2	0	2	0.0001423386
Tessaracoccus flavescens	399497	S	1	1	2	0.0001423386
Propionimicrobium sp. Marseille-P3275	1871034	S	2	0	2	0.0001423386
Brevilactibacter sp. MC1595	2819349	S	2	0	2	0.0001423386
Pseudopropionibacterium propionicum	1750	S	2	0	2	0.0001423386
Nocardioides sp. 603	2483798	S	2	0	2	0.0001423386
Nocardioides sp. CF8	110319	S	2	0	2	0.0001423386
Nocardioides sp. ZJ1313	2685869	S	1	1	2	0.0001423386
Nocardioides mesophilus	433659	S	2	0	2	0.0001423386
Nocardioides humi	449461	S	2	0	2	0.0001423386
Nocardioides ungokensis	1643322	S	2	0	2	0.0001423386
Nocardioides cynanchi	2558918	S	2	0	2	0.0001423386
Friedmanniella luteola	546871	S	2	0	2	0.0001423386
Actinopolymorpha singaporensis	117157	S	2	0	2	0.0001423386
Rhodococcus sp. P1Y	1302308	S	2	0	2	0.0001423386
Rhodococcus sp. B7740	1564114	S	2	0	2	0.0001423386
Rhodococcus sp. AQ5-07	2054902	S	1	1	2	0.0001423386
Rhodococcus sp. YL-1	1045808	S	1	1	2	0.0001423386
Rhodococcus sp. DMU1	2722825	S	1	1	2	0.0001423386
Rhodococcus rhodochrous	1829	S	2	0	2	0.0001423386
Rhodococcus triatomae	300028	S	2	0	2	0.0001423386
Rhodococcus pyridinivorans	103816	S	1	1	2	0.0001423386
Nocardia asteroides	1824	S	2	0	2	0.0001423386
Mycolicibacterium goodii	134601	S	2	0	2	0.0001423386
Mycolicibacterium insubricum	444597	S	2	0	2	0.0001423386
Mycolicibacterium litorale	758802	S	2	0	2	0.0001423386
Mycolicibacterium fluoranthenivorans	258505	S	2	0	2	0.0001423386
Mycolicibacterium madagascariense	212765	S	2	0	2	0.0001423386
Mycolicibacterium aurum	1791	S	2	0	2	0.0001423386
Mycobacterium heidelbergense	53376	S	2	0	2	0.0001423386
Mycobacterium florentinum	292462	S	2	0	2	0.0001423386
Mycobacterium sp. PYR15	2051552	S	1	1	2	0.0001423386
Mycobacterium avium	1764	S	1	1	2	0.0001423386
Mycobacterium xenopi	1789	S	2	0	2	0.0001423386
Mycobacterium conspicuum	44010	S	2	0	2	0.0001423386
Mycobacterium riyadhense	486698	S	2	0	2	0.0001423386
Mycobacteroides immunogenum	83262	S	1	1	2	0.0001423386
Corynebacterium glaucum	187491	S	2	0	2	0.0001423386
Corynebacterium resistens	258224	S	2	0	2	0.0001423386
Corynebacterium matruchotii	43768	S	2	0	2	0.0001423386
Corynebacterium ureicelerivorans	401472	S	2	0	2	0.0001423386
Corynebacterium efficiens	152794	S	2	0	2	0.0001423386
Corynebacterium kroppenstedtii	161879	S	2	0	2	0.0001423386
Corynebacterium glucuronolyticum	39791	S	2	0	2	0.0001423386
Corynebacterium minutissimum	38301	S	2	0	2	0.0001423386
Corynebacterium uterequi	1072256	S	2	0	2	0.0001423386
Corynebacterium bovis	36808	S	2	0	2	0.0001423386
Corynebacterium sanguinis	2594913	S	2	0	2	0.0001423386
Corynebacterium deserti	1408191	S	2	0	2	0.0001423386
Corynebacterium endometrii	2488819	S	2	0	2	0.0001423386
Tsukamurella tyrosinosolvens	57704	S	2	0	2	0.0001423386
Streptomyces sp. ADI95-16	1522758	S	2	0	2	0.0001423386
Streptomyces sp. CCM_MD2014	1561022	S	2	0	2	0.0001423386
Streptomyces sp. SN-593	659352	S	2	0	2	0.0001423386
Streptomyces sp. MBT27	1488356	S	2	0	2	0.0001423386
Streptomyces sp. Z423-1	2730915	S	2	0	2	0.0001423386
Streptomyces sp. SAT1	1849967	S	2	0	2	0.0001423386
Streptomyces sp. RPA4-2	2721244	S	2	0	2	0.0001423386
Streptomyces globisporus	1908	S	2	0	2	0.0001423386
Streptomyces xiamenensis	408015	S	2	0	2	0.0001423386
Streptomyces albulus	68570	S	2	0	2	0.0001423386
Streptomyces seoulensis	73044	S	2	0	2	0.0001423386
Streptomyces olivoreticuli	68246	S	2	0	2	0.0001423386
Streptomyces griseochromogenes	68214	S	2	0	2	0.0001423386
Streptomyces lydicus	47763	S	2	0	2	0.0001423386
Streptomyces collinus	42684	S	2	0	2	0.0001423386
Streptomyces tsukubensis	83656	S	2	0	2	0.0001423386
Streptomyces koyangensis	188770	S	2	0	2	0.0001423386
Streptomyces davaonensis	348043	S	2	0	2	0.0001423386
Streptomyces buecherae	2763006	S	2	0	2	0.0001423386
Streptomyces tirandamycinicus	2174846	S	2	0	2	0.0001423386
Streptomyces cadmiisoli	2184053	S	2	0	2	0.0001423386
Streptomyces cyaneochromogenes	2496836	S	2	0	2	0.0001423386
Streptomyces aquilus	2548456	S	2	0	2	0.0001423386
Streptomyces qinzhouensis	2599401	S	2	0	2	0.0001423386
Streptomyces phaeolivaceus	2653200	S	2	0	2	0.0001423386
Streptomyces broussonetiae	2686304	S	2	0	2	0.0001423386
Streptomyces actuosus	1885	S	2	0	2	0.0001423386
Streptomyces albus	1888	S	2	0	2	0.0001423386
Streptomyces vinaceus	1960	S	2	0	2	0.0001423386
Streptomyces pristinaespiralis	38300	S	2	0	2	0.0001423386
Streptomyces mobaraensis	35621	S	2	0	2	0.0001423386
Streptomyces rimosus	1927	S	2	0	2	0.0001423386
Streptomyces fungicidicus	68203	S	1	1	2	0.0001423386
Streptacidiphilus sp. P02-A3a	2704468	S	2	0	2	0.0001423386
Streptacidiphilus sp. PB12-B1b	2705012	S	2	0	2	0.0001423386
Kitasatospora sp. MMS16-BH015	2018025	S	2	0	2	0.0001423386
Candidatus Nanopelagicus abundans	1884916	S	2	0	2	0.0001423386
Amycolatopsis methanolica	1814	S	2	0	2	0.0001423386
Amycolatopsis albispora	1804986	S	2	0	2	0.0001423386
Pseudonocardia autotrophica	2074	S	2	0	2	0.0001423386
Pseudonocardia broussonetiae	2736640	S	2	0	2	0.0001423386
Actinoplanes teichomyceticus	1867	S	2	0	2	0.0001423386
Actinoplanes friuliensis	196914	S	2	0	2	0.0001423386
Micromonospora sp. HM134	2583243	S	2	0	2	0.0001423386
Micromonospora auratinigra	261654	S	2	0	2	0.0001423386
Phytohabitans flavus	1076124	S	2	0	2	0.0001423386
Plantactinospora sp. KBS50	2024580	S	1	1	2	0.0001423386
Actinomyces sp. oral taxon 414	712122	S	2	0	2	0.0001423386
Schaalia sp. JY-X169	2758572	S	2	0	2	0.0001423386
Flaviflexus sp. dk850	2758573	S	2	0	2	0.0001423386
Boudabousia tangfeifanii	1912795	S	2	0	2	0.0001423386
Streptosporangium roseum	2001	S	2	0	2	0.0001423386
Nonomuraea sp. ATCC 55076	1909395	S	1	1	2	0.0001423386
Nonomuraea nitratireducens	2656914	S	1	1	2	0.0001423386
Actinomadura sp. WMMB 499	1219491	S	2	0	2	0.0001423386
Actinomadura sp. WMMA1423	2591108	S	2	0	2	0.0001423386
Nocardiopsis gilva	280236	S	2	0	2	0.0001423386
Candidatus Frankia datiscae	2716812	S	2	0	2	0.0001423386
Jiangella alkaliphila	419479	S	2	0	2	0.0001423386
Jiangella sp. DSM 45060	1798224	S	2	0	2	0.0001423386
Geodermatophilus obscurus	1861	S	2	0	2	0.0001423386
Jatrophihabitans sp. GAS493	1907575	S	2	0	2	0.0001423386
Olsenella timonensis	1805478	S	2	0	2	0.0001423386
Berryella intestinalis	1531429	S	1	1	2	0.0001423386
Ilumatobacter coccineus	467094	S	2	0	2	0.0001423386
Bacillus mycoides	1405	S	2	0	2	0.0001423386
Bacillus sp. X1(2014)	1565991	S	2	0	2	0.0001423386
Bacillus gobiensis	1441095	S	2	0	2	0.0001423386
Bacillus glycinifermentans	1664069	S	2	0	2	0.0001423386
Bacillus safensis	561879	S	2	0	2	0.0001423386
Bacillus circulans	1397	S	2	0	2	0.0001423386
Bacillus infantis	324767	S	2	0	2	0.0001423386
Bacillus marisflavi	189381	S	2	0	2	0.0001423386
Lysinibacillus sp. SGAir0095	2070463	S	2	0	2	0.0001423386
Metabacillus sp. KUDC1714	2745198	S	2	0	2	0.0001423386
Mesobacillus foraminis	279826	S	2	0	2	0.0001423386
Oceanobacillus kimchii	746691	S	2	0	2	0.0001423386
Radiobacillus deserti	2594883	S	2	0	2	0.0001423386
Staphylococcus xylosus	1288	S	2	0	2	0.0001423386
Staphylococcus pettenkoferi	170573	S	2	0	2	0.0001423386
Staphylococcus lutrae	155085	S	2	0	2	0.0001423386
Staphylococcus arlettae	29378	S	2	0	2	0.0001423386
Staphylococcus auricularis	29379	S	2	0	2	0.0001423386
Mammaliicoccus sciuri	1296	S	2	0	2	0.0001423386
Paenibacillus ihbetae	1870820	S	2	0	2	0.0001423386
Sporosarcina ureilytica	298596	S	2	0	2	0.0001423386
Laceyella sacchari	37482	S	2	0	2	0.0001423386
Novibacillus thermophilus	1471761	S	2	0	2	0.0001423386
Gemella sanguinis	84135	S	2	0	2	0.0001423386
Lactobacillus delbrueckii	1584	S	2	0	2	0.0001423386
Lactobacillus kefiranofaciens	267818	S	2	0	2	0.0001423386
Lactobacillus amylovorus	1604	S	2	0	2	0.0001423386
Ligilactobacillus saerimneri	228229	S	2	0	2	0.0001423386
Secundilactobacillus paracollinoides	240427	S	2	0	2	0.0001423386
Paucilactobacillus oligofermentans	293371	S	2	0	2	0.0001423386
Streptococcus sp. NPS 308	1902136	S	2	0	2	0.0001423386
Streptococcus sp. CNU 77-61	2684658	S	1	1	2	0.0001423386
Streptococcus suis	1307	S	2	0	2	0.0001423386
Aerococcus urinaeequi	51665	S	2	0	2	0.0001423386
Coprococcus sp. ART55/1	751585	S	2	0	2	0.0001423386
Anaerocolumna sedimenticola	2696063	S	2	0	2	0.0001423386
Lachnoclostridium phytofermentans	66219	S	2	0	2	0.0001423386
Lachnoclostridium phocaeense	1871021	S	2	0	2	0.0001423386
Lacrimispora saccharolytica	84030	S	2	0	2	0.0001423386
Cellulosilyticum lentocellum	29360	S	2	0	2	0.0001423386
Pseudobutyrivibrio xylanivorans	185007	S	2	0	2	0.0001423386
Lachnospira eligens	39485	S	2	0	2	0.0001423386
Clostridium sp. DL-VIII	641107	S	2	0	2	0.0001423386
Clostridium septicum	1504	S	2	0	2	0.0001423386
Clostridium estertheticum	238834	S	2	0	2	0.0001423386
Clostridium gasigenes	94869	S	2	0	2	0.0001423386
Clostridium bornimense	1216932	S	2	0	2	0.0001423386
Clostridium formicaceticum	1497	S	2	0	2	0.0001423386
Clostridium baratii	1561	S	2	0	2	0.0001423386
Clostridium fermenticellae	2068654	S	2	0	2	0.0001423386
Clostridium kluyveri	1534	S	2	0	2	0.0001423386
Clostridium tetani	1513	S	2	0	2	0.0001423386
Hungatella hathewayi	154046	S	2	0	2	0.0001423386
Crassaminicella sp. SY095	2599308	S	2	0	2	0.0001423386
Ruminococcus albus	1264	S	2	0	2	0.0001423386
Ruminococcus sp. JE7A12	2564099	S	2	0	2	0.0001423386
Ruthenibacterium lactatiformans	1550024	S	2	0	2	0.0001423386
Acutalibacter muris	1796620	S	2	0	2	0.0001423386
Acetoanaerobium sticklandii	1511	S	2	0	2	0.0001423386
Peptoclostridium acidaminophilum	1731	S	2	0	2	0.0001423386
Paeniclostridium sordellii	1505	S	2	0	2	0.0001423386
Desulfosporosinus youngiae	339862	S	2	0	2	0.0001423386
[Eubacterium] cellulosolvens	29322	S	2	0	2	0.0001423386
Acetobacterium sp. KB-1	2184575	S	2	0	2	0.0001423386
Petrocella atlantisensis	2173034	S	2	0	2	0.0001423386
Thermoanaerobacterium aotearoense	47490	S	2	0	2	0.0001423386
Pectinatus frisingensis	865	S	2	0	2	0.0001423386
Acidaminococcus fermentans	905	S	2	0	2	0.0001423386
Erysipelothrix sp. HDW6A	2714928	S	1	1	2	0.0001423386
Intestinibaculum porci	2487118	S	2	0	2	0.0001423386
Finegoldia magna	1260	S	2	0	2	0.0001423386
Gottschalkia acidurici	1556	S	2	0	2	0.0001423386
Nostoc sp. PCC 7524	28072	S	2	0	2	0.0001423386
Anabaena cylindrica	1165	S	2	0	2	0.0001423386
Cylindrospermum stagnale	142864	S	2	0	2	0.0001423386
Fischerella sp. NIES-4106	2005456	S	2	0	2	0.0001423386
Chondrocystis sp. NIES-4102	2005460	S	2	0	2	0.0001423386
Oscillatoria acuminata	118323	S	2	0	2	0.0001423386
Synechococcus sp. PCC 7502	1173263	S	2	0	2	0.0001423386
Synechococcus sp. LTW-R	2751170	S	2	0	2	0.0001423386
Synechococcus sp. KORDI-49	585423	S	1	1	2	0.0001423386
Prochlorococcus sp. MIT 0801	1501269	S	2	0	2	0.0001423386
cyanobacterium endosymbiont of Rhopalodia gibberula	1763363	S	2	0	2	0.0001423386
Mycoplasma sp. Phocoena C-264-GEN	754517	S	2	0	2	0.0001423386
Mycoplasma mycoides	2102	S	2	0	2	0.0001423386
Mycoplasma tullyi	1612150	S	2	0	2	0.0001423386
Mycoplasma putrefaciens	2123	S	2	0	2	0.0001423386
Mycoplasma bovis	28903	S	2	0	2	0.0001423386
Spiroplasma diminutum	216936	S	2	0	2	0.0001423386
Spiroplasma turonicum	216946	S	2	0	2	0.0001423386
Spiroplasma phoeniceum	47835	S	2	0	2	0.0001423386
Acholeplasma palmae	38986	S	2	0	2	0.0001423386
Deinococcus maricopensis	309887	S	2	0	2	0.0001423386
Deinococcus ficus	317577	S	2	0	2	0.0001423386
Deinococcus peraridilitoris	432329	S	2	0	2	0.0001423386
Tepidiforma bonchosmolovskayae	2601677	S	2	0	2	0.0001423386
Flavobacterium kingsejongi	1678728	S	2	0	2	0.0001423386
Flavobacterium alkalisoli	2602769	S	2	0	2	0.0001423386
Polaribacter sp. KT25b	1855336	S	2	0	2	0.0001423386
Polaribacter vadi	1774273	S	2	0	2	0.0001423386
Tenacibaculum jejuense	584609	S	2	0	2	0.0001423386
Myroides profundi	480520	S	2	0	2	0.0001423386
Myroides phaeus	702745	S	2	0	2	0.0001423386
Lacinutrix sp. WUR7	2653681	S	2	0	2	0.0001423386
Lacinutrix venerupis	1486034	S	2	0	2	0.0001423386
Winogradskyella forsetii	2686077	S	2	0	2	0.0001423386
Formosa sp. Hel1_33_131	1336794	S	1	1	2	0.0001423386
Aquimarina sp. TRL1	2736252	S	2	0	2	0.0001423386
Nonlabens ponticola	2496866	S	2	0	2	0.0001423386
Algibacter sp. L3A6	2686366	S	2	0	2	0.0001423386
Maribacter sp. HTCC2170	313603	S	2	0	2	0.0001423386
Flavivirga eckloniae	1803846	S	2	0	2	0.0001423386
Gillisia sp. Hel1_33_143	1336796	S	2	0	2	0.0001423386
Oceanihabitans sp. IOP_32	2529032	S	2	0	2	0.0001423386
Psychroserpens sp. NJDZ02	2570561	S	1	1	2	0.0001423386
Olleya sp. Bg11-27	2058135	S	1	1	2	0.0001423386
Chryseobacterium sp. POL2	2713414	S	2	0	2	0.0001423386
Chryseobacterium aureum	2497456	S	2	0	2	0.0001423386
Chryseobacterium carnipullorum	1124835	S	2	0	2	0.0001423386
Chryseobacterium balustinum	246	S	2	0	2	0.0001423386
Chryseobacterium glaciei	1685010	S	2	0	2	0.0001423386
Chryseobacterium bernardetii	1241978	S	1	1	2	0.0001423386
Chryseobacterium nakagawai	1241982	S	1	1	2	0.0001423386
Elizabethkingia anophelis	1117645	S	1	1	2	0.0001423386
Empedobacter stercoris	1628248	S	2	0	2	0.0001423386
Cloacibacterium normanense	237258	S	2	0	2	0.0001423386
Blattabacterium sp. (Cryptocercus kyebangensis)	298656	S	2	0	2	0.0001423386
Bacteroides sp. CBA7301	2715212	S	2	0	2	0.0001423386
Phocaeicola salanitronis	376805	S	2	0	2	0.0001423386
Phocaeicola coprophilus	387090	S	2	0	2	0.0001423386
Prevotella melaninogenica	28132	S	2	0	2	0.0001423386
Alistipes finegoldii	214856	S	2	0	2	0.0001423386
Odoribacter splanchnicus	28118	S	2	0	2	0.0001423386
Salinivirga cyanobacteriivorans	1307839	S	2	0	2	0.0001423386
Muribaculum intestinale	1796646	S	2	0	2	0.0001423386
Spirosoma sp. PL0136	2710596	S	2	0	2	0.0001423386
Runella sp. HYN0085	2259595	S	2	0	2	0.0001423386
Hymenobacter sp. APR13	1356852	S	2	0	2	0.0001423386
Hymenobacter sedentarius	1411621	S	2	0	2	0.0001423386
Hymenobacter russus	2724192	S	2	0	2	0.0001423386
Pontibacter akesuensis	388950	S	2	0	2	0.0001423386
Pontibacter korlensis	400092	S	2	0	2	0.0001423386
Adhaeribacter swui	2086471	S	2	0	2	0.0001423386
Adhaeribacter radiodurans	2745197	S	2	0	2	0.0001423386
Cyclobacterium amurskyense	320787	S	2	0	2	0.0001423386
Flammeovirga pectinis	2494373	S	2	0	2	0.0001423386
Candidatus Amoebophilus asiaticus	281120	S	2	0	2	0.0001423386
Marivirga tractuosa	1006	S	2	0	2	0.0001423386
Mucilaginibacter mallensis	652787	S	2	0	2	0.0001423386
Mucilaginibacter xinganensis	1234841	S	2	0	2	0.0001423386
Mucilaginibacter ginkgonis	2682091	S	2	0	2	0.0001423386
Pedobacter sp. PACM 27299	1727164	S	2	0	2	0.0001423386
Pedobacter sp. eg	2201271	S	2	0	2	0.0001423386
Pedobacter sp. G11	2482728	S	2	0	2	0.0001423386
Pedobacter sp. HDW13	2714940	S	2	0	2	0.0001423386
Pedobacter sp. SW-16	2766984	S	2	0	2	0.0001423386
Pedobacter heparinus	984	S	2	0	2	0.0001423386
Pedobacter roseus	336820	S	2	0	2	0.0001423386
Sphingobacterium multivorum	28454	S	1	1	2	0.0001423386
Chitinophaga sp. XS-30	2604421	S	2	0	2	0.0001423386
Arachidicoccus soli	2341117	S	2	0	2	0.0001423386
Panacibacter ginsenosidivorans	1813871	S	2	0	2	0.0001423386
Salinibacter ruber	146919	S	2	0	2	0.0001423386
Chlorobaculum tepidum	1097	S	2	0	2	0.0001423386
Fibrobacter succinogenes	833	S	2	0	2	0.0001423386
Candidatus Cloacimonas acidaminovorans	456827	S	2	0	2	0.0001423386
Gemmata sp. SH-PL17	1630693	S	2	0	2	0.0001423386
Tuwongella immobilis	692036	S	2	0	2	0.0001423386
Pirellula staleyi	125	S	2	0	2	0.0001423386
Anatilimnocola aggregata	2528021	S	2	0	2	0.0001423386
Gimesia aquarii	2527964	S	2	0	2	0.0001423386
Polystyrenella longa	2528007	S	2	0	2	0.0001423386
Isosphaera pallida	128	S	2	0	2	0.0001423386
Coraliomargarita akajimensis	395922	S	2	0	2	0.0001423386
Leptospira interrogans	173	S	2	0	2	0.0001423386
Leptospira weilii	28184	S	1	1	2	0.0001423386
Brachyspira murdochii	84378	S	2	0	2	0.0001423386
Fusobacterium sp. NSJ-57	2764326	S	2	0	2	0.0001423386
Fusobacterium mortiferum	850	S	2	0	2	0.0001423386
Fusobacterium varium	856	S	2	0	2	0.0001423386
Pseudoleptotrichia goodfellowii	157692	S	2	0	2	0.0001423386
Terriglobus saanensis	870903	S	2	0	2	0.0001423386
Chloracidobacterium thermophilum	458033	S	2	0	2	0.0001423386
Luteitalea pratensis	1855912	S	2	0	2	0.0001423386
Thermosipho africanus	2421	S	2	0	2	0.0001423386
Tepiditoga spiralis	2108365	S	1	1	2	0.0001423386
Aquifex aeolicus	63363	S	2	0	2	0.0001423386
Candidatus Saccharimonas aalborgensis	1332188	S	2	0	2	0.0001423386
Haloarcula taiwanensis	1932004	S	2	0	2	0.0001423386
Natrialba magadii	13769	S	2	0	2	0.0001423386
Halobiforma lacisalsi	229731	S	2	0	2	0.0001423386
Salinigranum rubrum	755307	S	2	0	2	0.0001423386
Methanoregula formicica	882104	S	2	0	2	0.0001423386
Methanosphaerula palustris	475088	S	2	0	2	0.0001423386
Methanothermobacter thermautotrophicus	145262	S	2	0	2	0.0001423386
Methanofervidicoccus sp. A16	2607662	S	2	0	2	0.0001423386
Methanocaldococcus jannaschii	2190	S	2	0	2	0.0001423386
Candidatus Nitrosocosmicus franklandus	1798806	S	2	0	2	0.0001423386
Candidatus Nitrosocosmicus hydrocola	1826872	S	2	0	2	0.0001423386
Nitrosarchaeum sp. AC2	2259673	S	2	0	2	0.0001423386
Sulfolobus acidocaldarius	2285	S	2	0	2	0.0001423386
Agrobacterium virus Atuph07	2560286	S	2	0	2	0.0001423386
Streptomyces phage Immanuel3	2053813	S	2	0	2	0.0001423386
Acanthocystis turfacea chlorella virus 1	322019	S	2	0	2	0.0001423386
Orpheovirus IHUMI-LCC2	2023057	S	2	0	2	0.0001423386
Ralstonia insidiosa	190721	S	1	0	1	0.0000711693
Burkholderia stabilis	95485	S	1	0	1	0.0000711693
Burkholderia ubonensis	101571	S	1	0	1	0.0000711693
Burkholderia metallica	488729	S	1	0	1	0.0000711693
Burkholderia sp. MS389	2811789	S	1	0	1	0.0000711693
Burkholderia sp. KK1	1855726	S	1	0	1	0.0000711693
Burkholderia sp. Bp7605	1740163	S	1	0	1	0.0000711693
Burkholderia sp. THE68	758782	S	1	0	1	0.0000711693
Burkholderia oklahomensis	342113	S	1	0	1	0.0000711693
Polynucleobacter wuianus	1743168	S	1	0	1	0.0000711693
Paraburkholderia acidophila	265293	S	1	0	1	0.0000711693
Paraburkholderia dokdonella	2211211	S	1	0	1	0.0000711693
Paraburkholderia caffeinilytica	1761016	S	1	0	1	0.0000711693
Paraburkholderia sprentiae	948107	S	1	0	1	0.0000711693
Paraburkholderia megapolitana	420953	S	1	0	1	0.0000711693
Cupriavidus basilensis	68895	S	1	0	1	0.0000711693
Pandoraea thiooxydans	445709	S	1	0	1	0.0000711693
Pandoraea fibrosis	1891094	S	1	0	1	0.0000711693
Caballeronia insecticola	758793	S	1	0	1	0.0000711693
Limnobacter sp. SAORIC-580	2732163	S	1	0	1	0.0000711693
Chitinimonas arctica	2594795	S	1	0	1	0.0000711693
Mycetohabitans rhizoxinica	412963	S	1	0	1	0.0000711693
Polaromonas sp. H6N	1840293	S	1	0	1	0.0000711693
Comamonas thiooxydans	363952	S	1	0	1	0.0000711693
Candidatus Symbiobacter mobilis	1436290	S	1	0	1	0.0000711693
Janthinobacterium sp. B9-8	1236179	S	1	0	1	0.0000711693
Herminiimonas arsenitoxidans	1809410	S	1	0	1	0.0000711693
Methylibium petroleiphilum	105560	S	1	0	1	0.0000711693
Thiomonas arsenitoxydans	426114	S	1	0	1	0.0000711693
Alcaligenes sp. SORT26	2813780	S	1	0	1	0.0000711693
Alcaligenes aquatilis	323284	S	1	0	1	0.0000711693
Pigmentiphaga sp. H8	2488560	S	1	0	1	0.0000711693
Taylorella equigenitalis	29575	S	1	0	1	0.0000711693
Pusillimonas sp. DMV24BSW_D	2716226	S	1	0	1	0.0000711693
Algicoccus marinus	2163011	S	1	0	1	0.0000711693
Sutterella wadsworthensis	40545	S	1	0	1	0.0000711693
Vitreoscilla sp. C1	96942	S	1	0	1	0.0000711693
Neisseria chenwenguii	1853278	S	1	0	1	0.0000711693
Neisseria musculi	1815583	S	1	0	1	0.0000711693
Neisseria zalophi	640030	S	1	0	1	0.0000711693
Neisseria polysaccharea	489	S	1	0	1	0.0000711693
Neisseria animaloris	326522	S	1	0	1	0.0000711693
Neisseria weaveri	28091	S	1	0	1	0.0000711693
Neisseria subflava	28449	S	1	0	1	0.0000711693
Neisseria dentiae	194197	S	1	0	1	0.0000711693
Simonsiella muelleri	72	S	1	0	1	0.0000711693
Kingella kingae	504	S	1	0	1	0.0000711693
Conchiformibius steedae	153493	S	1	0	1	0.0000711693
Crenobacter cavernae	2290923	S	1	0	1	0.0000711693
Chromobacterium violaceum	536	S	1	0	1	0.0000711693
Aquitalea magnusonii	332411	S	1	0	1	0.0000711693
Aquitalea denitrificans	519081	S	1	0	1	0.0000711693
Jeongeupia sp. HS-3	1009682	S	1	0	1	0.0000711693
Microvirgula aerodenitrificans	57480	S	1	0	1	0.0000711693
Vogesella sp. LIG4	1192162	S	1	0	1	0.0000711693
Chitinibacter sp. 2T18	2739434	S	1	0	1	0.0000711693
Pseudogulbenkiania sp. NH8B	748280	S	1	0	1	0.0000711693
Methylotenera mobilis	359408	S	1	0	1	0.0000711693
Methylophilus sp. TWE2	1662285	S	1	0	1	0.0000711693
Gallionella capsiferriformans	370405	S	1	0	1	0.0000711693
Nitrosomonas sp. AL212	153948	S	1	0	1	0.0000711693
Nitrosomonas europaea	915	S	1	0	1	0.0000711693
Nitrosomonas stercoris	1444684	S	1	0	1	0.0000711693
Sulfuriferula nivalis	2675298	S	1	0	1	0.0000711693
Azoarcus sp. DN11	356837	S	1	0	1	0.0000711693
Thauera sp. MZ1T	85643	S	1	0	1	0.0000711693
Thauera humireducens	1134435	S	1	0	1	0.0000711693
Aromatoleum bremense	76115	S	1	0	1	0.0000711693
Oryzomicrobium terrae	1735038	S	1	0	1	0.0000711693
Rugosibacter aromaticivorans	1565605	S	1	0	1	0.0000711693
Casimicrobium huifangae	2591109	S	1	0	1	0.0000711693
Pseudomonas sp. 15A4	2804761	S	1	0	1	0.0000711693
Pseudomonas sp. DY-1	1755504	S	1	0	1	0.0000711693
Pseudomonas sp. A214	1855331	S	1	0	1	0.0000711693
Pseudomonas sp. Z003-0.4C(8344-21)	1855380	S	1	0	1	0.0000711693
Pseudomonas sp. Leaf58	1736226	S	1	0	1	0.0000711693
Pseudomonas sp. FDAARGOS_380	2018067	S	1	0	1	0.0000711693
Pseudomonas sp. IB20	1702250	S	1	0	1	0.0000711693
Pseudomonas sp. Tri1	2823875	S	1	0	1	0.0000711693
Pseudomonas sp. GR 6-02	1659194	S	1	0	1	0.0000711693
Pseudomonas sp. CCOS 191	1649877	S	1	0	1	0.0000711693
Pseudomonas sp. LPH1	1898684	S	1	0	1	0.0000711693
Pseudomonas sp. 02C 26	2054914	S	1	0	1	0.0000711693
Pseudomonas sp. LG1D9	2083054	S	1	0	1	0.0000711693
Pseudomonas sp. S1-A32-2	2731681	S	1	0	1	0.0000711693
Pseudomonas sp. LG1E9	2219057	S	1	0	1	0.0000711693
Pseudomonas sp. DG56-2	2320270	S	1	0	1	0.0000711693
Pseudomonas sp. BIGb0427	2724470	S	1	0	1	0.0000711693
Pseudomonas sp. THAF7b	2587845	S	1	0	1	0.0000711693
Pseudomonas sp. DTU12.1	2654238	S	1	0	1	0.0000711693
Pseudomonas sp. J380	2605424	S	1	0	1	0.0000711693
Pseudomonas sp. MRSN12121	1611770	S	1	0	1	0.0000711693
Pseudomonas sp. B10	118613	S	1	0	1	0.0000711693
Pseudomonas sp. LAB-08	143813	S	1	0	1	0.0000711693
Pseudomonas sp. CMR5c	658630	S	1	0	1	0.0000711693
Pseudomonas rhodesiae	76760	S	1	0	1	0.0000711693
Pseudomonas mediterranea	183795	S	1	0	1	0.0000711693
Pseudomonas extremorientalis	169669	S	1	0	1	0.0000711693
Pseudomonas migulae	78543	S	1	0	1	0.0000711693
Pseudomonas mucidolens	46679	S	1	0	1	0.0000711693
Pseudomonas oleovorans	301	S	1	0	1	0.0000711693
Pseudomonas citronellolis	53408	S	1	0	1	0.0000711693
Pseudomonas nitroreducens	46680	S	1	0	1	0.0000711693
Pseudomonas cichorii	36746	S	1	0	1	0.0000711693
Pseudomonas coronafaciens	53409	S	1	0	1	0.0000711693
Pseudomonas xanthomarina	271420	S	1	0	1	0.0000711693
Pseudomonas pohangensis	364197	S	1	0	1	0.0000711693
Pseudomonas kribbensis	1628086	S	1	0	1	0.0000711693
Pseudomonas sediminis	1691904	S	1	0	1	0.0000711693
Pseudomonas saudiphocaensis	1499686	S	1	0	1	0.0000711693
Pseudomonas salegens	1434072	S	1	0	1	0.0000711693
Pseudomonas agarici	46677	S	1	0	1	0.0000711693
Pseudomonas guangdongensis	1245526	S	1	0	1	0.0000711693
Pseudomonas psychrophila	122355	S	1	0	1	0.0000711693
Pseudomonas parafulva	157782	S	1	0	1	0.0000711693
Pseudomonas graminis	158627	S	1	0	1	0.0000711693
Pseudomonas silesiensis	1853130	S	1	0	1	0.0000711693
Pseudomonas rhizosphaerae	216142	S	1	0	1	0.0000711693
Pseudomonas xinjiangensis	487184	S	1	0	1	0.0000711693
Pseudomonas alkylphenolica	237609	S	1	0	1	0.0000711693
Pseudomonas eucalypticola	2599595	S	1	0	1	0.0000711693
Pseudomonas atacamensis	2565368	S	1	0	1	0.0000711693
Pseudomonas simiae	321846	S	1	0	1	0.0000711693
Pseudomonas extremaustralis	359110	S	1	0	1	0.0000711693
Entomomonas sp. F2A	2785331	S	1	0	1	0.0000711693
Acinetobacter calcoaceticus	471	S	1	0	1	0.0000711693
Acinetobacter pittii	48296	S	1	0	1	0.0000711693
Acinetobacter nosocomialis	106654	S	1	0	1	0.0000711693
Acinetobacter seifertii	1530123	S	1	0	1	0.0000711693
Acinetobacter lactucae	1785128	S	1	0	1	0.0000711693
Acinetobacter sp. WCHA55	2004646	S	1	0	1	0.0000711693
Acinetobacter sp. NEB 394	2743575	S	1	0	1	0.0000711693
Acinetobacter sp. MYb10	1827285	S	1	0	1	0.0000711693
Acinetobacter sp. ACNIH2	1758189	S	1	0	1	0.0000711693
Acinetobacter schindleri	108981	S	1	0	1	0.0000711693
Acinetobacter junii	40215	S	1	0	1	0.0000711693
Acinetobacter venetianus	52133	S	1	0	1	0.0000711693
Acinetobacter defluvii	1871111	S	1	0	1	0.0000711693
Acinetobacter guillouiae	106649	S	1	0	1	0.0000711693
Acinetobacter towneri	202956	S	1	0	1	0.0000711693
Moraxella nonliquefaciens	478	S	1	0	1	0.0000711693
Psychrobacter sp. PRwf-1	349106	S	1	0	1	0.0000711693
Psychrobacter sp. YP14	2203895	S	1	0	1	0.0000711693
Psychrobacter urativorans	45610	S	1	0	1	0.0000711693
Psychrobacter arcticus	334543	S	1	0	1	0.0000711693
Stenotrophomonas sp. ZAC14D2_NAIMI4_7	2072405	S	1	0	1	0.0000711693
Stenotrophomonas sp. ZAC14A_NAIMI4_1	2072412	S	1	0	1	0.0000711693
Stenotrophomonas sp. SAU14A_NAIMI4_5	2072413	S	1	0	1	0.0000711693
Stenotrophomonas sp. Pemsol	2040586	S	1	0	1	0.0000711693
Stenotrophomonas sp. 364	2691571	S	1	0	1	0.0000711693
Xanthomonas arboricola	56448	S	1	0	1	0.0000711693
Xanthomonas cassavae	56450	S	1	0	1	0.0000711693
Lysobacter lycopersici	1324796	S	1	0	1	0.0000711693
Thermomonas sp. SY21	2202149	S	1	0	1	0.0000711693
Thermomonas brevis	215691	S	1	0	1	0.0000711693
Luteimonas sp. YGD11-2	2508168	S	1	0	1	0.0000711693
Luteimonas sp. MC1572	2799325	S	1	0	1	0.0000711693
Luteimonas granuli	1176533	S	1	0	1	0.0000711693
Pseudolysobacter antarcticus	2511995	S	1	0	1	0.0000711693
Dyella japonica	231455	S	1	0	1	0.0000711693
Rhodanobacter denitrificans	666685	S	1	0	1	0.0000711693
Frateuria aurantia	81475	S	1	0	1	0.0000711693
Luteibacter pinisoli	2589080	S	1	0	1	0.0000711693
Citrobacter tructae	2562449	S	1	0	1	0.0000711693
Escherichia sp. E4742	2044467	S	1	0	1	0.0000711693
Enterobacteriaceae endosymbiont of Macroplea appendiculata	2675790	S	1	0	1	0.0000711693
Enterobacteriaceae endosymbiont of Donacia thalassina	2675786	S	1	0	1	0.0000711693
Cronobacter sakazakii	28141	S	1	0	1	0.0000711693
Cronobacter dublinensis	413497	S	1	0	1	0.0000711693
Cronobacter universalis	535744	S	1	0	1	0.0000711693
Raoultella terrigena	577	S	1	0	1	0.0000711693
Kosakonia cowanii	208223	S	1	0	1	0.0000711693
Candidatus Gullanella endobia	1070130	S	1	0	1	0.0000711693
Lelliottia amnigena	61646	S	1	0	1	0.0000711693
Cedecea lapagei	158823	S	1	0	1	0.0000711693
Leclercia adecarboxylata	83655	S	1	0	1	0.0000711693
Atlantibacter hermannii	565	S	1	0	1	0.0000711693
Yersinia entomophaga	935293	S	1	0	1	0.0000711693
Yersinia similis	367190	S	1	0	1	0.0000711693
Serratia odorifera	618	S	1	0	1	0.0000711693
Serratia plymuthica	82996	S	1	0	1	0.0000711693
Serratia surfactantfaciens	2741499	S	1	0	1	0.0000711693
Gibbsiella quercinecans	929813	S	1	0	1	0.0000711693
Rouxiella badensis	1646377	S	1	0	1	0.0000711693
Pantoea sp. 201603H	2479547	S	1	0	1	0.0000711693
Pantoea sp. CCBC3-3-1	2490851	S	1	0	1	0.0000711693
Pantoea sp. SO10	2575375	S	1	0	1	0.0000711693
Candidatus Pantoea carbekii	1235990	S	1	0	1	0.0000711693
Candidatus Erwinia haradaeae	1922217	S	1	0	1	0.0000711693
Tatumella citrea	53336	S	1	0	1	0.0000711693
Mixta theicola	1458355	S	1	0	1	0.0000711693
Providencia alcalifaciens	126385	S	1	0	1	0.0000711693
Providencia sneebia	516075	S	1	0	1	0.0000711693
Xenorhabdus nematophila	628	S	1	0	1	0.0000711693
Xenorhabdus poinarii	40577	S	1	0	1	0.0000711693
Proteus vulgaris	585	S	1	0	1	0.0000711693
Proteus columbae	1987580	S	1	0	1	0.0000711693
Dickeya chrysanthemi	556	S	1	0	1	0.0000711693
Pectobacterium carotovorum	554	S	1	0	1	0.0000711693
Pectobacterium parmentieri	1905730	S	1	0	1	0.0000711693
Pectobacterium versatile	2488639	S	1	0	1	0.0000711693
Brenneria rubrifaciens	55213	S	1	0	1	0.0000711693
Brenneria sp. Ir50	2722756	S	1	0	1	0.0000711693
Lonsdalea britannica	1082704	S	1	0	1	0.0000711693
Hafnia paralvei	546367	S	1	0	1	0.0000711693
Sodalis endosymbiont of Henestaris halophilus	1929246	S	1	0	1	0.0000711693
Haemophilus pittmaniae	249188	S	1	0	1	0.0000711693
Actinobacillus indolicus	51049	S	1	0	1	0.0000711693
Actinobacillus succinogenes	67854	S	1	0	1	0.0000711693
Actinobacillus porcitonsillarum	189834	S	1	0	1	0.0000711693
Mannheimia haemolytica	75985	S	1	0	1	0.0000711693
Mannheimia ovis	2679994	S	1	0	1	0.0000711693
Aggregatibacter actinomycetemcomitans	714	S	1	0	1	0.0000711693
Histophilus somni	731	S	1	0	1	0.0000711693
Shewanella sp. FJAT-51800	2814294	S	1	0	1	0.0000711693
Shewanella sp. KX20019	2803864	S	1	0	1	0.0000711693
Shewanella sp. SNU WT4	2590015	S	1	0	1	0.0000711693
Shewanella algae	38313	S	1	0	1	0.0000711693
Shewanella psychrophila	225848	S	1	0	1	0.0000711693
Shewanella loihica	359303	S	1	0	1	0.0000711693
Shewanella piezotolerans	404011	S	1	0	1	0.0000711693
Shewanella aestuarii	1028752	S	1	0	1	0.0000711693
Shewanella khirikhana	1965282	S	1	0	1	0.0000711693
Shewanella frigidimarina	56812	S	1	0	1	0.0000711693
Parashewanella spongiae	342950	S	1	0	1	0.0000711693
Alteromonas macleodii	28108	S	1	0	1	0.0000711693
Alteromonas mediterranea	314275	S	1	0	1	0.0000711693
Salinimonas sp. KX18D6	2572577	S	1	0	1	0.0000711693
Salinimonas sp. G2-b	2785918	S	1	0	1	0.0000711693
Glaciecola amylolytica	2489595	S	1	0	1	0.0000711693
Pseudoalteromonas sp. Bsw20308	283699	S	1	0	1	0.0000711693
Pseudoalteromonas piratica	1348114	S	1	0	1	0.0000711693
Pseudoalteromonas aliena	247523	S	1	0	1	0.0000711693
Pseudoalteromonas carrageenovora	227	S	1	0	1	0.0000711693
Pseudoalteromonas ruthenica	151081	S	1	0	1	0.0000711693
Pseudoalteromonas piscicida	43662	S	1	0	1	0.0000711693
Pseudoalteromonas undina	43660	S	1	0	1	0.0000711693
Pseudoalteromonas luteoviolacea	43657	S	1	0	1	0.0000711693
Pseudoalteromonas xiamenensis	882626	S	1	0	1	0.0000711693
Pseudoalteromonas shioyasakiensis	1190813	S	1	0	1	0.0000711693
Psychrosphaera aestuarii	1266052	S	1	0	1	0.0000711693
Psychrosphaera sp. MTZ26	2820710	S	1	0	1	0.0000711693
Colwellia beringensis	1967665	S	1	0	1	0.0000711693
Thalassotalea sp. PS06	2594005	S	1	0	1	0.0000711693
Litorilituus sediminis	718192	S	1	0	1	0.0000711693
Moritella yayanosii	69539	S	1	0	1	0.0000711693
Moritella marina	90736	S	1	0	1	0.0000711693
Idiomarina piscisalsi	1096243	S	1	0	1	0.0000711693
Idiomarina sp. OT37-5b	2100422	S	1	0	1	0.0000711693
Psychromonas ingrahamii	357794	S	1	0	1	0.0000711693
Halomonas sp. YLGW01	2773308	S	1	0	1	0.0000711693
Halomonas sp. THAF12	2587849	S	1	0	1	0.0000711693
Halomonas aestuarii	1897729	S	1	0	1	0.0000711693
Zymobacter palmae	33074	S	1	0	1	0.0000711693
Candidatus Carsonella ruddii	114186	S	1	0	1	0.0000711693
Chromohalobacter salexigens	158080	S	1	0	1	0.0000711693
Halotalea alkalilenta	376489	S	1	0	1	0.0000711693
Kushneria marisflavi	157779	S	1	0	1	0.0000711693
Marinomonas sp. MWYL1	400668	S	1	0	1	0.0000711693
Marinobacterium aestuarii	1821621	S	1	0	1	0.0000711693
Amphritea japonica	452627	S	1	0	1	0.0000711693
Bermanella marisrubri	207949	S	1	0	1	0.0000711693
Bacterioplanes sanyensis	1249553	S	1	0	1	0.0000711693
Alcanivorax pacificus	1306787	S	1	0	1	0.0000711693
Alcanivorax sp. N3-2A	2014542	S	1	0	1	0.0000711693
Saccharospirillum mangrovi	2161747	S	1	0	1	0.0000711693
Kangiella sediminilitoris	1144748	S	1	0	1	0.0000711693
Kangiella profundi	1561924	S	1	0	1	0.0000711693
Oleiphilus messinensis	141451	S	1	0	1	0.0000711693
Spartinivicinus ruber	2683272	S	1	0	1	0.0000711693
Rheinheimera sp. F8	1763998	S	1	0	1	0.0000711693
Thermochromatium tepidum	1050	S	1	0	1	0.0000711693
Caldichromatium japonicum	2699430	S	1	0	1	0.0000711693
Thioalkalivibrio paradoxus	108010	S	1	0	1	0.0000711693
Thioalkalivibrio sulfidiphilus	1033854	S	1	0	1	0.0000711693
Halorhodospira halochloris	1052	S	1	0	1	0.0000711693
Halorhodospira halophila	1053	S	1	0	1	0.0000711693
Ectothiorhodospira haloalkaliphila	421628	S	1	0	1	0.0000711693
Aquisalimonas sp. 2447	2740807	S	1	0	1	0.0000711693
Halothiobacillus neapolitanus	927	S	1	0	1	0.0000711693
Halothiobacillus sp. LS2	1860122	S	1	0	1	0.0000711693
Granulosicoccus antarcticus	437505	S	1	0	1	0.0000711693
Vibrio azureus	512649	S	1	0	1	0.0000711693
Vibrio sp. ZWAL4003	2711221	S	1	0	1	0.0000711693
Vibrio tapetis	52443	S	1	0	1	0.0000711693
Vibrio ponticus	265668	S	1	0	1	0.0000711693
Vibrio europaeus	300876	S	1	0	1	0.0000711693
Vibrio aphrogenes	1891186	S	1	0	1	0.0000711693
Vibrio chagasii	170679	S	1	0	1	0.0000711693
Vibrio coralliilyticus	190893	S	1	0	1	0.0000711693
Photobacterium profundum	74109	S	1	0	1	0.0000711693
Photobacterium ganghwense	320778	S	1	0	1	0.0000711693
Aliivibrio salmonicida	40269	S	1	0	1	0.0000711693
Aeromonas schubertii	652	S	1	0	1	0.0000711693
Aeromonas encheleia	73010	S	1	0	1	0.0000711693
Aeromonas sp. CA23	2033032	S	1	0	1	0.0000711693
Aeromonas dhakensis	196024	S	1	0	1	0.0000711693
Tolumonas auensis	43948	S	1	0	1	0.0000711693
Cellvibrio sp. PSBB006	1987723	S	1	0	1	0.0000711693
Simiduia agarivorans	447471	S	1	0	1	0.0000711693
Halioglobus japonicus	930805	S	1	0	1	0.0000711693
Halioglobus pacificus	930806	S	1	0	1	0.0000711693
Spongiibacter sp. IMCC21906	1620392	S	1	0	1	0.0000711693
Spongiibacter sp. CSC3.9	2794344	S	1	0	1	0.0000711693
Microbulbifer sp. GL-2	2591606	S	1	0	1	0.0000711693
Methylococcus sp. IM1	2681310	S	1	0	1	0.0000711693
Methylococcus sp. EFPC2	2812648	S	1	0	1	0.0000711693
Methylotuvimicrobium buryatense	95641	S	1	0	1	0.0000711693
Methylotuvimicrobium alcaliphilum	271065	S	1	0	1	0.0000711693
Methylovulum psychrotolerans	1704499	S	1	0	1	0.0000711693
Candidatus Methylospira mobilis	1808979	S	1	0	1	0.0000711693
Legionella sp. PC997	2755562	S	1	0	1	0.0000711693
Legionella hackeliae	449	S	1	0	1	0.0000711693
Legionella waltersii	66969	S	1	0	1	0.0000711693
Legionella sainthelensi	28087	S	1	0	1	0.0000711693
Legionella israelensis	454	S	1	0	1	0.0000711693
Legionella spiritensis	452	S	1	0	1	0.0000711693
Legionella longbeachae	450	S	1	0	1	0.0000711693
Thiothrix sp. Ku-5	2735563	S	1	0	1	0.0000711693
Thiothrix unzii	111769	S	1	0	1	0.0000711693
Beggiatoa leptomitoformis	288004	S	1	0	1	0.0000711693
Piscirickettsia salmonis	1238	S	1	0	1	0.0000711693
Hydrogenovibrio crunogenus	39765	S	1	0	1	0.0000711693
Bathymodiolus thermophilus thioautotrophic gill symbiont	2360	S	1	0	1	0.0000711693
Candidatus Ruthia magnifica	386487	S	1	0	1	0.0000711693
Candidatus Nardonella dryophthoridicola	1971485	S	1	0	1	0.0000711693
Candidatus Thioglobus singularis	1427364	S	1	0	1	0.0000711693
Pseudohongiella spirulinae	1249552	S	1	0	1	0.0000711693
Thiolapillus brandeum	1076588	S	1	0	1	0.0000711693
Sulfurifustis variabilis	1675686	S	1	0	1	0.0000711693
Sulfuricaulis limicola	1620215	S	1	0	1	0.0000711693
Dichelobacter nodosus	870	S	1	0	1	0.0000711693
Gilliamella apicola	1196095	S	1	0	1	0.0000711693
endosymbiont of unidentified scaly snail isolate Monju	1248727	S	1	0	1	0.0000711693
Methylobacterium sp. DM1	2067957	S	1	0	1	0.0000711693
Methylobacterium currus	2051553	S	1	0	1	0.0000711693
Bradyrhizobium sp. CCBAU 53340	1325112	S	1	0	1	0.0000711693
Bradyrhizobium sp. 6(2017)	1197460	S	1	0	1	0.0000711693
Bradyrhizobium sp. WSM471	319017	S	1	0	1	0.0000711693
Bradyrhizobium sp. BTAi1	288000	S	1	0	1	0.0000711693
Bradyrhizobium arachidis	858423	S	1	0	1	0.0000711693
Bradyrhizobium symbiodeficiens	1404367	S	1	0	1	0.0000711693
Nitrobacter hamburgensis	912	S	1	0	1	0.0000711693
Nitrobacter winogradskyi	913	S	1	0	1	0.0000711693
Mesorhizobium sp. J8	2777475	S	1	0	1	0.0000711693
Mesorhizobium sp. 8	2584466	S	1	0	1	0.0000711693
Mesorhizobium sp. M7A.F.Ce.TU.012.03.2.1	2493681	S	1	0	1	0.0000711693
Mesorhizobium sp. M8A.F.Ca.ET.057.01.1.1	2493679	S	1	0	1	0.0000711693
Mesorhizobium sp. M6A.T.Cr.TU.016.01.1.1	2493677	S	1	0	1	0.0000711693
Mesorhizobium sp. M3A.F.Ca.ET.080.04.2.1	2493676	S	1	0	1	0.0000711693
Mesorhizobium loti	381	S	1	0	1	0.0000711693
Mesorhizobium amorphae	71433	S	1	0	1	0.0000711693
Phyllobacterium sp. 628	2718938	S	1	0	1	0.0000711693
Hoeflea sp. IMCC20628	1620421	S	1	0	1	0.0000711693
Roseitalea porphyridii	1852022	S	1	0	1	0.0000711693
Rhizobium sp. NZLR1	2731096	S	1	0	1	0.0000711693
Rhizobium sp. BG4	2613770	S	1	0	1	0.0000711693
Rhizobium binae	1138190	S	1	0	1	0.0000711693
Rhizobium oryzihabitans	2267833	S	1	0	1	0.0000711693
Rhizobium etli	29449	S	1	0	1	0.0000711693
Agrobacterium vitis	373	S	1	0	1	0.0000711693
Agrobacterium sp. T29	2580515	S	1	0	1	0.0000711693
Neorhizobium sp. SOG26	2060726	S	1	0	1	0.0000711693
Sinorhizobium sp. BG8	2613773	S	1	0	1	0.0000711693
Ensifer sp. PDNC004	2811423	S	1	0	1	0.0000711693
Candidatus Liberibacter solanacearum	556287	S	1	0	1	0.0000711693
Kaistia sp. 32K	2795690	S	1	0	1	0.0000711693
Shinella sp. HZN7	879274	S	1	0	1	0.0000711693
Georhizobium profundi	2341112	S	1	0	1	0.0000711693
Hyphomicrobium sp. MC1	717785	S	1	0	1	0.0000711693
Blastochloris viridis	1079	S	1	0	1	0.0000711693
Maritalea myrionectae	454601	S	1	0	1	0.0000711693
Youhaiella tibetensis	1447062	S	1	0	1	0.0000711693
Ancylobacter sp. TS-1	1850374	S	1	0	1	0.0000711693
Starkeya sp. ORNL1	2709380	S	1	0	1	0.0000711693
Azorhizobium caulinodans	7	S	1	0	1	0.0000711693
Methylocystis bryophila	655015	S	1	0	1	0.0000711693
Methylosinus sp. C49	2699395	S	1	0	1	0.0000711693
Stappia indica	538381	S	1	0	1	0.0000711693
Stappia sp. ES.058	1881061	S	1	0	1	0.0000711693
Aureimonas sp. AU20	1349819	S	1	0	1	0.0000711693
Aureimonas populi	1701758	S	1	0	1	0.0000711693
Bartonella australis	388640	S	1	0	1	0.0000711693
Brucella intermedia	94625	S	1	0	1	0.0000711693
[Ochrobactrum] quorumnocens	271865	S	1	0	1	0.0000711693
Brucella sp. 2280	2592625	S	1	0	1	0.0000711693
Sphingomonas sp. YZ-8	2319844	S	1	0	1	0.0000711693
Sphingomonas sp. HMP9	1517554	S	1	0	1	0.0000711693
Sphingomonas sp. XS-10	2599297	S	1	0	1	0.0000711693
Sphingomonas sp. Cra20	1327635	S	1	0	1	0.0000711693
Sphingomonas sp. KC8	1030157	S	1	0	1	0.0000711693
Sphingomonas sp. AP4-R1	2735134	S	1	0	1	0.0000711693
Sphingomonas paucimobilis	13689	S	1	0	1	0.0000711693
Sphingomonas wittichii	160791	S	1	0	1	0.0000711693
Sphingomonas daechungensis	1176646	S	1	0	1	0.0000711693
Sphingomonas taxi	1549858	S	1	0	1	0.0000711693
Sphingobium sp. EP60837	1855519	S	1	0	1	0.0000711693
Sphingobium sp. Cam5-1	2789327	S	1	0	1	0.0000711693
Sphingobium herbicidovorans	76947	S	1	0	1	0.0000711693
Sphingobium japonicum	332056	S	1	0	1	0.0000711693
Sphingopyxis sp. 113P3	292913	S	1	0	1	0.0000711693
Sphingopyxis sp. QXT-31	1357916	S	1	0	1	0.0000711693
Sphingopyxis sp. LPB0140	1913578	S	1	0	1	0.0000711693
Sphingopyxis lindanitolerans	2054227	S	1	0	1	0.0000711693
Sphingorhabdus sp. M41	1806885	S	1	0	1	0.0000711693
Blastomonas sp. RAC04	1842535	S	1	0	1	0.0000711693
Sphingosinithalassobacter sp. zrk23	2711215	S	1	0	1	0.0000711693
Porphyrobacter sp. HT-58-2	2023229	S	1	0	1	0.0000711693
Erythrobacter sp. HL-111	1798193	S	1	0	1	0.0000711693
Erythrobacter sp. 6D36	2782568	S	1	0	1	0.0000711693
Croceicoccus sp. YJ47	2798724	S	1	0	1	0.0000711693
Altererythrobacter sp. ZODW24	2185142	S	1	0	1	0.0000711693
Altererythrobacter epoxidivorans	361183	S	1	0	1	0.0000711693
Tsuneonella dongtanensis	692370	S	1	0	1	0.0000711693
Aurantiacibacter atlanticus	1648404	S	1	0	1	0.0000711693
Qipengyuania flava	192812	S	1	0	1	0.0000711693
Qipengyuania seohaensis	266951	S	1	0	1	0.0000711693
Paracoccus liaowanqingii	2560053	S	1	0	1	0.0000711693
Paracoccus jeotgali	2065379	S	1	0	1	0.0000711693
Paracoccus marcusii	59779	S	1	0	1	0.0000711693
Paracoccus aminophilus	34003	S	1	0	1	0.0000711693
Sulfitobacter sp. B30-2	2785912	S	1	0	1	0.0000711693
Sulfitobacter pontiacus	60137	S	1	0	1	0.0000711693
Sulfitobacter mediterraneus	83219	S	1	0	1	0.0000711693
Rhodobacter sp. CZR27	2033869	S	1	0	1	0.0000711693
Celeribacter ethanolicus	1758178	S	1	0	1	0.0000711693
Phaeobacter gallaeciensis	60890	S	1	0	1	0.0000711693
Ruegeria sp. TM1040	292414	S	1	0	1	0.0000711693
Ruegeria sp. THAF33	2587853	S	1	0	1	0.0000711693
Leisingera methylohalidivorans	133924	S	1	0	1	0.0000711693
Octadecabacter antarcticus	1217908	S	1	0	1	0.0000711693
Octadecabacter temperatus	1458307	S	1	0	1	0.0000711693
Roseobacter denitrificans	2434	S	1	0	1	0.0000711693
Roseobacter litoralis	42443	S	1	0	1	0.0000711693
Pseudopuniceibacterium antarcticum	2613965	S	1	0	1	0.0000711693
Yoonia vestfoldensis	245188	S	1	0	1	0.0000711693
Pseudohalocynthiibacter aestuariivivens	1591409	S	1	0	1	0.0000711693
Pseudooceanicola algae	1537215	S	1	0	1	0.0000711693
Halocynthiibacter arcticus	1579316	S	1	0	1	0.0000711693
Qingshengfaniella alkalisoli	2599296	S	1	0	1	0.0000711693
Pelagovum pacificum	2588711	S	1	0	1	0.0000711693
Dinoroseobacter shibae	215813	S	1	0	1	0.0000711693
Antarctobacter heliothermus	74033	S	1	0	1	0.0000711693
Jannaschia sp. CCS1	290400	S	1	0	1	0.0000711693
Pelagibaca abyssi	1250539	S	1	0	1	0.0000711693
Defluviimonas alba	1335048	S	1	0	1	0.0000711693
Brevundimonas sp. MF30-B	2561924	S	1	0	1	0.0000711693
Brevundimonas sp. GRTSA-9	2800818	S	1	0	1	0.0000711693
Caulobacter mirabilis	69666	S	1	0	1	0.0000711693
Caulobacter sp. K31	366602	S	1	0	1	0.0000711693
Phenylobacterium parvum	2201350	S	1	0	1	0.0000711693
Azospirillum lipoferum	193	S	1	0	1	0.0000711693
Azospirillum ramasamyi	682998	S	1	0	1	0.0000711693
Azospirillum humicireducens	1226968	S	1	0	1	0.0000711693
Azospirillum thermophilum	2202148	S	1	0	1	0.0000711693
Magnetospirillum sp. ME-1	1639348	S	1	0	1	0.0000711693
Thalassospira marina	2048283	S	1	0	1	0.0000711693
Magnetospira sp. QH-2	1288970	S	1	0	1	0.0000711693
Nitrospirillum amazonense	28077	S	1	0	1	0.0000711693
Roseomonas gilardii	257708	S	1	0	1	0.0000711693
Gluconobacter oxydans	442	S	1	0	1	0.0000711693
Komagataeibacter saccharivorans	265959	S	1	0	1	0.0000711693
Komagataeibacter medellinensis	1177712	S	1	0	1	0.0000711693
Granulibacter bethesdensis	364410	S	1	0	1	0.0000711693
Lichenicola cladoniae	1484109	S	1	0	1	0.0000711693
Swingsia samuiensis	1293412	S	1	0	1	0.0000711693
Stella humosa	94	S	1	0	1	0.0000711693
Terasakiella sp. SH-1	2560057	S	1	0	1	0.0000711693
Wolbachia endosymbiont of Litomosoides sigmodontis	80850	S	1	0	1	0.0000711693
Wolbachia endosymbiont of Dirofilaria (Dirofilaria) immitis	1812115	S	1	0	1	0.0000711693
Wolbachia endosymbiont of Folsomia candida	169402	S	1	0	1	0.0000711693
Wolbachia pipientis	955	S	1	0	1	0.0000711693
Candidatus Wolbachia massiliensis	1845000	S	1	0	1	0.0000711693
Anaplasma marginale	770	S	1	0	1	0.0000711693
Anaplasma ovis	142058	S	1	0	1	0.0000711693
Rickettsia raoultii	369822	S	1	0	1	0.0000711693
Rickettsia bellii	33990	S	1	0	1	0.0000711693
Candidatus Sneabacter namystus	2601646	S	1	0	1	0.0000711693
Candidatus Fokinia solitaria	1802984	S	1	0	1	0.0000711693
Rickettsiales endosymbiont of Stachyamoeba lipophora	2486578	S	1	0	1	0.0000711693
Candidatus Pelagibacter sp. IMCC9063	1002672	S	1	0	1	0.0000711693
Candidatus Pelagibacter sp. RS40	1977865	S	1	0	1	0.0000711693
Phreatobacter cathodiphilus	1868589	S	1	0	1	0.0000711693
Phreatobacter stygius	1940610	S	1	0	1	0.0000711693
Hyphomonas sp. Mor2	1906738	S	1	0	1	0.0000711693
Hyphomonas sp. KY3	2016196	S	1	0	1	0.0000711693
Magnetococcus marinus	1124597	S	1	0	1	0.0000711693
Archangium gephyra	48	S	1	0	1	0.0000711693
Myxococcus hansupus	1297742	S	1	0	1	0.0000711693
Pyxidicoccus sp. SCPEA002	2813578	S	1	0	1	0.0000711693
Desulfovibrio sp. G11	631220	S	1	0	1	0.0000711693
Desulfovibrio sp. IOR2	2583823	S	1	0	1	0.0000711693
Desulfovibrio gigas	879	S	1	0	1	0.0000711693
Desulfovibrio fairfieldensis	44742	S	1	0	1	0.0000711693
Desulfovibrio magneticus	184917	S	1	0	1	0.0000711693
Desulfovibrio carbinoliphilus	345370	S	1	0	1	0.0000711693
Pseudodesulfovibrio piezophilus	879567	S	1	0	1	0.0000711693
Pseudodesulfovibrio cashew	2678688	S	1	0	1	0.0000711693
Desulfomicrobium baculatum	899	S	1	0	1	0.0000711693
Geobacter sp. M18	443143	S	1	0	1	0.0000711693
Geobacter sp. FeAm09	2597769	S	1	0	1	0.0000711693
Geobacter daltonii	1203471	S	1	0	1	0.0000711693
Desulfuromonas soudanensis	1603606	S	1	0	1	0.0000711693
Desulfuromonas sp. DDH964	1823759	S	1	0	1	0.0000711693
Desulfococcus oleovorans	181663	S	1	0	1	0.0000711693
Desulfonema limicola	45656	S	1	0	1	0.0000711693
Desulfobulbus propionicus	894	S	1	0	1	0.0000711693
Desulfurivibrio alkaliphilus	427923	S	1	0	1	0.0000711693
Desulfoglaeba alkanexedens	361111	S	1	0	1	0.0000711693
Aliarcobacter trophiarum	708186	S	1	0	1	0.0000711693
Aliarcobacter faecis	1564138	S	1	0	1	0.0000711693
Arcobacter ellisii	913109	S	1	0	1	0.0000711693
Arcobacter peruensis	2320140	S	1	0	1	0.0000711693
Halarcobacter bivalviorum	663364	S	1	0	1	0.0000711693
Halarcobacter ebronensis	1462615	S	1	0	1	0.0000711693
Campylobacter sp. RM16704	1500960	S	1	0	1	0.0000711693
Campylobacter sp. RM6137	1660073	S	1	0	1	0.0000711693
Campylobacter sp. RM6914	1032243	S	1	0	1	0.0000711693
Campylobacter peloridis	488546	S	1	0	1	0.0000711693
Campylobacter pinnipediorum	1965231	S	1	0	1	0.0000711693
Campylobacter mucosalis	202	S	1	0	1	0.0000711693
Campylobacter canadensis	449520	S	1	0	1	0.0000711693
Campylobacter sputorum	206	S	1	0	1	0.0000711693
Campylobacter volucris	1031542	S	1	0	1	0.0000711693
Campylobacter ureolyticus	827	S	1	0	1	0.0000711693
Campylobacter iguaniorum	1244531	S	1	0	1	0.0000711693
Campylobacter hominis	76517	S	1	0	1	0.0000711693
Sulfurospirillum sp. UCH001	1581011	S	1	0	1	0.0000711693
Sulfurimonas sp. S2-6	2590020	S	1	0	1	0.0000711693
Candidatus Sulfurimonas baltica	2740404	S	1	0	1	0.0000711693
Sulfuricurvum kujiense	148813	S	1	0	1	0.0000711693
Hydrogenimonas urashimensis	2740515	S	1	0	1	0.0000711693
Nitratifractor salsuginis	269261	S	1	0	1	0.0000711693
Bdellovibrio sp. KM01	2748865	S	1	0	1	0.0000711693
Bdellovibrio exovorus	453816	S	1	0	1	0.0000711693
Halobacteriovorax marinus	97084	S	1	0	1	0.0000711693
Acidithiobacillus thiooxidans	930	S	1	0	1	0.0000711693
Acidithiobacillus caldus	33059	S	1	0	1	0.0000711693
Acidithiobacillus ferrivorans	160808	S	1	0	1	0.0000711693
Microbacterium sp. TPU 3598	1938334	S	1	0	1	0.0000711693
Microbacterium sp. No. 7	1714373	S	1	0	1	0.0000711693
Microbacterium sp. RG1	2489212	S	1	0	1	0.0000711693
Microbacterium sp. Se63.02b	2709304	S	1	0	1	0.0000711693
Microbacterium sp. YJN-G	2763257	S	1	0	1	0.0000711693
Microbacterium schleiferi	69362	S	1	0	1	0.0000711693
Microbacterium oryzae	743009	S	1	0	1	0.0000711693
Microbacterium amylolyticum	936337	S	1	0	1	0.0000711693
Microbacterium lemovicicum	1072463	S	1	0	1	0.0000711693
Microbacterium protaetiae	2509458	S	1	0	1	0.0000711693
Curtobacterium sp. BH-2-1-1	1905847	S	1	0	1	0.0000711693
Curtobacterium sp. SGAir0471	2070337	S	1	0	1	0.0000711693
Curtobacterium sp. YC1	2795488	S	1	0	1	0.0000711693
Curtobacterium sp. 24E2	2804758	S	1	0	1	0.0000711693
Agromyces sp. HY052	2585717	S	1	0	1	0.0000711693
Agromyces sp. KACC 19306	2592652	S	1	0	1	0.0000711693
Agromyces protaetiae	2509455	S	1	0	1	0.0000711693
Candidatus Aquiluna sp. 15G-AUS-rot	2499157	S	1	0	1	0.0000711693
Rathayibacter toxicus	145458	S	1	0	1	0.0000711693
Agrococcus carbonis	684552	S	1	0	1	0.0000711693
Leucobacter triazinivorans	1784719	S	1	0	1	0.0000711693
Leucobacter coleopterorum	2714933	S	1	0	1	0.0000711693
Aurantimicrobium sp. MWH-Uga1	2079575	S	1	0	1	0.0000711693
Aurantimicrobium minutum	708131	S	1	0	1	0.0000711693
Cryobacterium sp.	1926290	S	1	0	1	0.0000711693
Cryobacterium soli	2220095	S	1	0	1	0.0000711693
Leifsonia sp. 21MFCrub1.1	1798223	S	1	0	1	0.0000711693
Leifsonia sp. PS1209	2724914	S	1	0	1	0.0000711693
Leifsonia xyli	1575	S	1	0	1	0.0000711693
Salinibacterium sp. dk2585	2603292	S	1	0	1	0.0000711693
Salinibacterium sp. ZJ450	2708338	S	1	0	1	0.0000711693
Salinibacterium hongtaonis	2079791	S	1	0	1	0.0000711693
Mycetocola zhujimingii	2079792	S	1	0	1	0.0000711693
Mycetocola sp. JXN-3	2116510	S	1	0	1	0.0000711693
Protaetiibacter intestinalis	2419774	S	1	0	1	0.0000711693
Protaetiibacter sp. SSC-01	2759943	S	1	0	1	0.0000711693
Glaciihabitans sp. INWT7	2596912	S	1	0	1	0.0000711693
Yimella sp. cx-51	2770551	S	1	0	1	0.0000711693
Kocuria sp. KD4	2719588	S	1	0	1	0.0000711693
Arthrobacter sp. YN	2020486	S	1	0	1	0.0000711693
Arthrobacter citreus	1670	S	1	0	1	0.0000711693
Arthrobacter alpinus	656366	S	1	0	1	0.0000711693
Rothia kristinae	37923	S	1	0	1	0.0000711693
Pseudarthrobacter phenanthrenivorans	361575	S	1	0	1	0.0000711693
Renibacterium salmoninarum	1646	S	1	0	1	0.0000711693
Zhihengliuella sp. ISTPL4	2058657	S	1	0	1	0.0000711693
Sinomonas sp. R1AF57	2020377	S	1	0	1	0.0000711693
Auritidibacter sp. NML130574	2170745	S	1	0	1	0.0000711693
Brevibacterium sp. WO024	2697563	S	1	0	1	0.0000711693
Brevibacterium luteolum	199591	S	1	0	1	0.0000711693
Brevibacterium siliguriense	1136497	S	1	0	1	0.0000711693
Cellulomonas sp. JZ18	2654191	S	1	0	1	0.0000711693
Cellulomonas gilvus	11	S	1	0	1	0.0000711693
Cellulomonas shaoxiangyii	2566013	S	1	0	1	0.0000711693
Cellulomonas taurus	2729175	S	1	0	1	0.0000711693
Oerskovia sp. KBS0722	1179673	S	1	0	1	0.0000711693
Actinotalea sp. JY-7876	2758442	S	1	0	1	0.0000711693
Tetrasphaera sp. HKS02	1813880	S	1	0	1	0.0000711693
Pedococcus dokdonensis	443156	S	1	0	1	0.0000711693
Brachybacterium faecium	43669	S	1	0	1	0.0000711693
Brachybacterium saurashtrense	556288	S	1	0	1	0.0000711693
Dermabacter jinjuensis	1667168	S	1	0	1	0.0000711693
Serinicoccus hydrothermalis	1758689	S	1	0	1	0.0000711693
Georgenia faecalis	2483799	S	1	0	1	0.0000711693
Georgenia sp. Z294	2585135	S	1	0	1	0.0000711693
Beutenbergia cavernae	84757	S	1	0	1	0.0000711693
Luteimicrobium xylanilyticum	1133546	S	1	0	1	0.0000711693
Jonesia denitrificans	43674	S	1	0	1	0.0000711693
Microlunatus sp. KUDC0627	2596828	S	1	0	1	0.0000711693
Tessaracoccus aquimaris	1332264	S	1	0	1	0.0000711693
Tessaracoccus sp. MC1865	2760310	S	1	0	1	0.0000711693
Propioniciclava sp. HDW11	2714937	S	1	0	1	0.0000711693
Nocardioides sp. HDW12A	2714938	S	1	0	1	0.0000711693
Nocardioides sp. HDW12B	2714939	S	1	0	1	0.0000711693
Nocardioides sp. MC1495	2736757	S	1	0	1	0.0000711693
Nocardioides sp. S-713	2760089	S	1	0	1	0.0000711693
Nocardioides marinisabuli	419476	S	1	0	1	0.0000711693
Nocardioides dokdonensis	450734	S	1	0	1	0.0000711693
Nocardioides seonyuensis	2518371	S	1	0	1	0.0000711693
Rhodococcus sp. P-2	2795031	S	1	0	1	0.0000711693
Rhodococcus sp. PBTS 2	1653479	S	1	0	1	0.0000711693
Rhodococcus sp. WAY2	2663121	S	1	0	1	0.0000711693
Nocardia farcinica	37329	S	1	0	1	0.0000711693
Nocardia wallacei	480035	S	1	0	1	0.0000711693
Mycolicibacterium mageritense	53462	S	1	0	1	0.0000711693
Mycolicibacterium hassiacum	46351	S	1	0	1	0.0000711693
Mycolicibacterium doricum	126673	S	1	0	1	0.0000711693
Mycolicibacterium fortuitum	1766	S	1	0	1	0.0000711693
Mycolicibacterium tokaiense	39695	S	1	0	1	0.0000711693
Mycolicibacterium phocaicum	319706	S	1	0	1	0.0000711693
Mycolicibacterium parafortuitum	39692	S	1	0	1	0.0000711693
Mycolicibacterium moriokaense	39691	S	1	0	1	0.0000711693
Mycolicibacterium duvalii	39688	S	1	0	1	0.0000711693
Mycolicibacterium aubagnense	319707	S	1	0	1	0.0000711693
Mycolicibacterium chitae	1792	S	1	0	1	0.0000711693
Mycobacterium kubicae	120959	S	1	0	1	0.0000711693
Mycobacterium saskatchewanense	220927	S	1	0	1	0.0000711693
Mycobacterium shigaense	722731	S	1	0	1	0.0000711693
Mycobacterium sp. JS623	212767	S	1	0	1	0.0000711693
Mycobacterium sp. YC-RL4	1682113	S	1	0	1	0.0000711693
Mycobacterium sp. DL440	2675523	S	1	0	1	0.0000711693
Mycobacterium colombiense	339268	S	1	0	1	0.0000711693
Mycobacterium paragordonae	1389713	S	1	0	1	0.0000711693
Mycobacterium kansasii	1768	S	1	0	1	0.0000711693
Mycobacterium cookii	1775	S	1	0	1	0.0000711693
Mycolicibacter terrae	1788	S	1	0	1	0.0000711693
Mycolicibacter minnesotensis	1118379	S	1	0	1	0.0000711693
Hoyosella subflava	639313	S	1	0	1	0.0000711693
Mycolicibacillus koreensis	1069220	S	1	0	1	0.0000711693
Corynebacterium sp. zg-917	2763010	S	1	0	1	0.0000711693
Corynebacterium sp. 1959	2675216	S	1	0	1	0.0000711693
Corynebacterium stationis	1705	S	1	0	1	0.0000711693
Corynebacterium phocae	161895	S	1	0	1	0.0000711693
Corynebacterium anserum	2684406	S	1	0	1	0.0000711693
Corynebacterium camporealensis	161896	S	1	0	1	0.0000711693
Corynebacterium provencense	1737425	S	1	0	1	0.0000711693
Corynebacterium atypicum	191610	S	1	0	1	0.0000711693
Corynebacterium doosanense	1121358	S	1	0	1	0.0000711693
Corynebacterium halotolerans	225326	S	1	0	1	0.0000711693
Corynebacterium epidermidicanis	1050174	S	1	0	1	0.0000711693
Corynebacterium nuruki	1032851	S	1	0	1	0.0000711693
Corynebacterium simulans	146827	S	1	0	1	0.0000711693
Corynebacterium ammoniagenes	1697	S	1	0	1	0.0000711693
Corynebacterium kutscheri	35755	S	1	0	1	0.0000711693
Corynebacterium jeikeium	38289	S	1	0	1	0.0000711693
Corynebacterium urealyticum	43771	S	1	0	1	0.0000711693
Gordonia sp. YC-JH1	2059875	S	1	0	1	0.0000711693
Gordonia sp. PDNC005	2811424	S	1	0	1	0.0000711693
Dietzia timorensis	499555	S	1	0	1	0.0000711693
Tomitella sp. HY188	2597660	S	1	0	1	0.0000711693
Tomitella sp. HY172	2760083	S	1	0	1	0.0000711693
Streptomyces sp. S4.7	2705439	S	1	0	1	0.0000711693
Streptomyces sp. JB150	2714844	S	1	0	1	0.0000711693
Streptomyces sp. DSM 40868	2721173	S	1	0	1	0.0000711693
Streptomyces sp. CFMR 7	1649184	S	1	0	1	0.0000711693
Streptomyces sp. SCSIO 3032	1264596	S	1	0	1	0.0000711693
Streptomyces sp. CB01881	2078691	S	1	0	1	0.0000711693
Streptomyces sp. QHH-9511	2684468	S	1	0	1	0.0000711693
Streptomyces sp. Tu 2975	2676871	S	1	0	1	0.0000711693
Streptomyces sp. 11-1-2	1851167	S	1	0	1	0.0000711693
Streptomyces sp. CMB-StM0423	2059884	S	1	0	1	0.0000711693
Streptomyces sp. INR7	2607753	S	1	0	1	0.0000711693
Streptomyces sp. 3211	1964449	S	1	0	1	0.0000711693
Streptomyces sp. SUK 48	2582831	S	1	0	1	0.0000711693
Streptomyces sp. 769	1262452	S	1	0	1	0.0000711693
Streptomyces sp. jing01	2726118	S	1	0	1	0.0000711693
Streptomyces sp. WAC 01529	2203205	S	1	0	1	0.0000711693
Streptomyces sp. P3	2135430	S	1	0	1	0.0000711693
Streptomyces sp. SirexAA-E	862751	S	1	0	1	0.0000711693
Streptomyces sp. So13.3	2136173	S	1	0	1	0.0000711693
Streptomyces sp. M2	646637	S	1	0	1	0.0000711693
Streptomyces sp. CB00271	2750025	S	1	0	1	0.0000711693
Streptomyces sp. Mg1	465541	S	1	0	1	0.0000711693
Streptomyces sp. NHF165	2175864	S	1	0	1	0.0000711693
Streptomyces sp. HSG2	2797167	S	1	0	1	0.0000711693
Streptomyces griseus	1911	S	1	0	1	0.0000711693
Streptomyces pactum	68249	S	1	0	1	0.0000711693
Streptomyces parvulus	146923	S	1	0	1	0.0000711693
Streptomyces spectabilis	68270	S	1	0	1	0.0000711693
Streptomyces cattleya	29303	S	1	0	1	0.0000711693
Streptomyces nitrosporeus	28894	S	1	0	1	0.0000711693
Streptomyces kanamyceticus	1967	S	1	0	1	0.0000711693
Streptomyces rectiverticillatus	173860	S	1	0	1	0.0000711693
Streptomyces peucetius	1950	S	1	0	1	0.0000711693
Streptomyces roseochromogenus	285450	S	1	0	1	0.0000711693
Streptomyces bingchenggensis	379067	S	1	0	1	0.0000711693
Streptomyces xinghaiensis	1038928	S	1	0	1	0.0000711693
Streptomyces rapamycinicus	1226757	S	1	0	1	0.0000711693
Streptomyces leeuwenhoekii	1437453	S	1	0	1	0.0000711693
Streptomyces lunaelactis	1535768	S	1	0	1	0.0000711693
Streptomyces spongiicola	1690221	S	1	0	1	0.0000711693
Streptomyces nigra	1827580	S	1	0	1	0.0000711693
Streptomyces dengpaensis	2049881	S	1	0	1	0.0000711693
Streptomyces clavuligerus	1901	S	1	0	1	0.0000711693
Streptomyces cacaoi	1898	S	1	0	1	0.0000711693
Streptomyces atratus	1893	S	1	0	1	0.0000711693
Streptomyces fagopyri	2662397	S	1	0	1	0.0000711693
Streptomyces bathyalis	2710756	S	1	0	1	0.0000711693
Streptomyces alboflavus	67267	S	1	0	1	0.0000711693
Streptomyces chromofuscus	42881	S	1	0	1	0.0000711693
Streptomyces olivaceus	47716	S	1	0	1	0.0000711693
Streptomyces griseocarneus	51201	S	1	0	1	0.0000711693
Streptomyces subrutilus	36818	S	1	0	1	0.0000711693
Streptomyces gardneri	66892	S	1	0	1	0.0000711693
Streptomyces cavourensis	67258	S	1	0	1	0.0000711693
Streptomyces finlayi	67296	S	1	0	1	0.0000711693
Streptomyces griseorubiginosus	67304	S	1	0	1	0.0000711693
Streptomyces viridosporus	67581	S	1	0	1	0.0000711693
Streptomyces fulvissimus	68202	S	1	0	1	0.0000711693
Kitasatospora sp. NA04385	2742135	S	1	0	1	0.0000711693
Kitasatospora setae	2066	S	1	0	1	0.0000711693
Kitasatospora albolonga	68173	S	1	0	1	0.0000711693
Candidatus Planktophila limnetica	573600	S	1	0	1	0.0000711693
Amycolatopsis sp. AA4	1896961	S	1	0	1	0.0000711693
Amycolatopsis sp. BJA-103	1911175	S	1	0	1	0.0000711693
Amycolatopsis orientalis	31958	S	1	0	1	0.0000711693
Saccharopolyspora erythraea	1836	S	1	0	1	0.0000711693
Pseudonocardia sp. HH130630-07	1690815	S	1	0	1	0.0000711693
Saccharomonospora cyanea	40989	S	1	0	1	0.0000711693
Saccharomonospora marina	632569	S	1	0	1	0.0000711693
Saccharothrix syringae	103733	S	1	0	1	0.0000711693
Kutzneria albida	43357	S	1	0	1	0.0000711693
Actinoplanes sp. OR16	946334	S	1	0	1	0.0000711693
Actinoplanes missouriensis	1866	S	1	0	1	0.0000711693
Micromonospora sp. WMMC415	2675222	S	1	0	1	0.0000711693
Micromonospora echinofusca	47858	S	1	0	1	0.0000711693
Micromonospora terminaliae	1914461	S	1	0	1	0.0000711693
Micromonospora purpureochromogenes	47872	S	1	0	1	0.0000711693
Micromonospora maris	1003110	S	1	0	1	0.0000711693
Micromonospora sagamiensis	47875	S	1	0	1	0.0000711693
Micromonospora coxensis	356852	S	1	0	1	0.0000711693
Micromonospora krabiensis	307121	S	1	0	1	0.0000711693
Salinispora tropica	168695	S	1	0	1	0.0000711693
Actinocatenispora thailandica	227318	S	1	0	1	0.0000711693
Bifidobacterium bifidum	1681	S	1	0	1	0.0000711693
Actinomyces sp. HMT 175	2789425	S	1	0	1	0.0000711693
Actinomyces viscosus	1656	S	1	0	1	0.0000711693
Actinomyces slackii	52774	S	1	0	1	0.0000711693
Actinomyces oris	544580	S	1	0	1	0.0000711693
Actinomyces qiguomingii	2057800	S	1	0	1	0.0000711693
Actinomyces lilanjuaniae	2321394	S	1	0	1	0.0000711693
Actinomyces marmotae	2737173	S	1	0	1	0.0000711693
Schaalia cardiffensis	181487	S	1	0	1	0.0000711693
Arcanobacterium sp. JY-X040	2758440	S	1	0	1	0.0000711693
Trueperella pyogenes	1661	S	1	0	1	0.0000711693
Fannyhessea vaginae	82135	S	1	0	1	0.0000711693
Thermobispora bispora	2006	S	1	0	1	0.0000711693
Modestobacter marinus	477641	S	1	0	1	0.0000711693
Stackebrandtia nassauensis	283811	S	1	0	1	0.0000711693
Olsenella sp. GAM18	2109685	S	1	0	1	0.0000711693
Eggerthella lenta	84112	S	1	0	1	0.0000711693
Eggerthella sp. YY7918	502558	S	1	0	1	0.0000711693
Gordonibacter urolithinfaciens	1335613	S	1	0	1	0.0000711693
Arabia massiliensis	1870985	S	1	0	1	0.0000711693
Rubrobacter sp. SCSIO 52909	2653851	S	1	0	1	0.0000711693
Rubrobacter sp. SCSIO 52915	2653852	S	1	0	1	0.0000711693
Euzebya sp. DY32-46	1608957	S	1	0	1	0.0000711693
Egibacter rhizosphaerae	1670831	S	1	0	1	0.0000711693
Egicoccus halophilus	1670830	S	1	0	1	0.0000711693
Bacillus sp. PAMC26568	2760090	S	1	0	1	0.0000711693
Bacillus sp. FJAT-22090	1581038	S	1	0	1	0.0000711693
Bacillus sp. FJAT-18017	1705566	S	1	0	1	0.0000711693
Bacillus sp. DSL-17	2567941	S	1	0	1	0.0000711693
Bacillus sp. CS13	2728853	S	1	0	1	0.0000711693
Bacillus sp. HD4P25	2779776	S	1	0	1	0.0000711693
Bacillus sp. V3	2795526	S	1	0	1	0.0000711693
Bacillus atrophaeus	1452	S	1	0	1	0.0000711693
Bacillus sonorensis	119858	S	1	0	1	0.0000711693
Bacillus mojavensis	72360	S	1	0	1	0.0000711693
Bacillus sporothermodurans	46224	S	1	0	1	0.0000711693
Bacillus oleronius	38875	S	1	0	1	0.0000711693
Bacillus ciccensis	1670641	S	1	0	1	0.0000711693
Bacillus freudenreichii	1783501	S	1	0	1	0.0000711693
Bacillus methanolicus	1471	S	1	0	1	0.0000711693
Lysinibacillus timonensis	2086577	S	1	0	1	0.0000711693
Metabacillus sp. cB07	2806989	S	1	0	1	0.0000711693
Metabacillus litoralis	152268	S	1	0	1	0.0000711693
Mesobacillus jeotgali	129985	S	1	0	1	0.0000711693
Oceanobacillus iheyensis	182710	S	1	0	1	0.0000711693
Virgibacillus halodenitrificans	1482	S	1	0	1	0.0000711693
Virgibacillus phasianinus	2017483	S	1	0	1	0.0000711693
Neobacillus thermocopriae	1215031	S	1	0	1	0.0000711693
Neobacillus cucumis	1740721	S	1	0	1	0.0000711693
Alkalihalobacillus clausii	79880	S	1	0	1	0.0000711693
Alkalihalobacillus lehensis	300825	S	1	0	1	0.0000711693
Halobacillus litoralis	45668	S	1	0	1	0.0000711693
Halobacillus mangrovi	402384	S	1	0	1	0.0000711693
Anoxybacillus caldiproteolyticus	247480	S	1	0	1	0.0000711693
Anoxybacillus sp. PDR2	1636720	S	1	0	1	0.0000711693
Gracilibacillus sp. SCU50	2663022	S	1	0	1	0.0000711693
Salicibibacter halophilus	2502791	S	1	0	1	0.0000711693
Lentibacillus amyloliquefaciens	1472767	S	1	0	1	0.0000711693
Caldibacillus thermoamylovorans	35841	S	1	0	1	0.0000711693
Parageobacillus genomosp. 1	1295642	S	1	0	1	0.0000711693
Peribacillus psychrosaccharolyticus	1407	S	1	0	1	0.0000711693
Staphylococcus pasteuri	45972	S	1	0	1	0.0000711693
Staphylococcus pseudintermedius	283734	S	1	0	1	0.0000711693
Staphylococcus equorum	246432	S	1	0	1	0.0000711693
Staphylococcus nepalensis	214473	S	1	0	1	0.0000711693
Staphylococcus saprophyticus	29385	S	1	0	1	0.0000711693
Staphylococcus cohnii	29382	S	1	0	1	0.0000711693
Staphylococcus hominis	1290	S	1	0	1	0.0000711693
Staphylococcus warneri	1292	S	1	0	1	0.0000711693
Macrococcus caseolyticus	69966	S	1	0	1	0.0000711693
Jeotgalicoccus saudimassiliensis	1461582	S	1	0	1	0.0000711693
Paenibacillus sp. B01	2660554	S	1	0	1	0.0000711693
Paenibacillus sp. RUD330	2023772	S	1	0	1	0.0000711693
Paenibacillus sp. JZ16	1906272	S	1	0	1	0.0000711693
Paenibacillus sp. 32O-W	1695218	S	1	0	1	0.0000711693
Paenibacillus sp. 37	2607911	S	1	0	1	0.0000711693
Paenibacillus sp. Y412MC10	481743	S	1	0	1	0.0000711693
Paenibacillus baekrokdamisoli	1712516	S	1	0	1	0.0000711693
Paenibacillus cellulositrophicus	562959	S	1	0	1	0.0000711693
Paenibacillus swuensis	1178515	S	1	0	1	0.0000711693
Paenibacillus yonginensis	1462996	S	1	0	1	0.0000711693
Paenibacillus antarcticus	253703	S	1	0	1	0.0000711693
Paenibacillus barcinonensis	198119	S	1	0	1	0.0000711693
Paenibacillus odorifer	189426	S	1	0	1	0.0000711693
Paenibacillus kribbensis	172713	S	1	0	1	0.0000711693
Paenibacillus stellifer	169760	S	1	0	1	0.0000711693
Paenibacillus terrae	159743	S	1	0	1	0.0000711693
Paenibacillus lautus	1401	S	1	0	1	0.0000711693
Paenibacillus psychroresistens	1778678	S	1	0	1	0.0000711693
Paenibacillus riograndensis	483937	S	1	0	1	0.0000711693
Paenibacillus alvei	44250	S	1	0	1	0.0000711693
Paenibacillus protaetiae	2509456	S	1	0	1	0.0000711693
Paenibacillus rhizovicinus	2704463	S	1	0	1	0.0000711693
Cohnella sp. LGH	1619153	S	1	0	1	0.0000711693
Cohnella sp. KS 22	2598458	S	1	0	1	0.0000711693
Cohnella candidum	2674991	S	1	0	1	0.0000711693
Brevibacillus sp. 7WMA2	2683193	S	1	0	1	0.0000711693
Brevibacillus sp. JNUCC-41	2778370	S	1	0	1	0.0000711693
Saccharibacillus brassicae	2583377	S	1	0	1	0.0000711693
Planococcus plakortidis	1038856	S	1	0	1	0.0000711693
Planococcus massiliensis	1499687	S	1	0	1	0.0000711693
Jeotgalibacillus malaysiensis	1508404	S	1	0	1	0.0000711693
Alicyclobacillus sp. TC	2606450	S	1	0	1	0.0000711693
Kyrpidia spormannii	2055160	S	1	0	1	0.0000711693
Effusibacillus sp. skT53	2743772	S	1	0	1	0.0000711693
Kroppenstedtia eburnea	714067	S	1	0	1	0.0000711693
Exiguobacterium antarcticum	132920	S	1	0	1	0.0000711693
Exiguobacterium mexicanum	340146	S	1	0	1	0.0000711693
Exiguobacterium sp. N4-1P	2051906	S	1	0	1	0.0000711693
Listeria seeligeri	1640	S	1	0	1	0.0000711693
Lactobacillus iners	147802	S	1	0	1	0.0000711693
Lactobacillus taiwanensis	508451	S	1	0	1	0.0000711693
Lactobacillus amylolyticus	83683	S	1	0	1	0.0000711693
Lactobacillus acetotolerans	1600	S	1	0	1	0.0000711693
Ligilactobacillus agilis	1601	S	1	0	1	0.0000711693
Ligilactobacillus animalis	1605	S	1	0	1	0.0000711693
Leuconostoc gelidum	1244	S	1	0	1	0.0000711693
Pediococcus inopinatus	114090	S	1	0	1	0.0000711693
Pediococcus acidilactici	1254	S	1	0	1	0.0000711693
Weissella paramesenteroides	1249	S	1	0	1	0.0000711693
Weissella confusa	1583	S	1	0	1	0.0000711693
Companilactobacillus farciminis	1612	S	1	0	1	0.0000711693
Schleiferilactobacillus harbinensis	304207	S	1	0	1	0.0000711693
Loigolactobacillus coryniformis	1610	S	1	0	1	0.0000711693
Liquorilactobacillus hordei	468911	S	1	0	1	0.0000711693
Bombilactobacillus bombi	1303590	S	1	0	1	0.0000711693
Apilactobacillus kunkeei	148814	S	1	0	1	0.0000711693
Lacticaseibacillus zeae	57037	S	1	0	1	0.0000711693
Limosilactobacillus fermentum	1613	S	1	0	1	0.0000711693
Streptococcus sp. zg-86	2664091	S	1	0	1	0.0000711693
Streptococcus oralis	1303	S	1	0	1	0.0000711693
Streptococcus parauberis	1348	S	1	0	1	0.0000711693
Streptococcus canis	1329	S	1	0	1	0.0000711693
Streptococcus pneumoniae	1313	S	1	0	1	0.0000711693
Streptococcus salivarius	1304	S	1	0	1	0.0000711693
Lactococcus raffinolactis	1366	S	1	0	1	0.0000711693
Enterococcus hirae	1354	S	1	0	1	0.0000711693
Enterococcus avium	33945	S	1	0	1	0.0000711693
Enterococcus cecorum	44008	S	1	0	1	0.0000711693
Vagococcus penaei	633807	S	1	0	1	0.0000711693
Vagococcus zengguangii	2571750	S	1	0	1	0.0000711693
Vagococcus hydrophili	2714947	S	1	0	1	0.0000711693
Tetragenococcus halophilus	51669	S	1	0	1	0.0000711693
Tetragenococcus osmophilus	526944	S	1	0	1	0.0000711693
Jeotgalibaca ciconiae	2496265	S	1	0	1	0.0000711693
Carnobacterium maltaromaticum	2751	S	1	0	1	0.0000711693
Carnobacterium inhibens	147709	S	1	0	1	0.0000711693
Carnobacterium sp. 17-4	208596	S	1	0	1	0.0000711693
Dolosigranulum pigrum	29394	S	1	0	1	0.0000711693
Aerococcus urinae	1376	S	1	0	1	0.0000711693
Aerococcus viridans	1377	S	1	0	1	0.0000711693
Suicoccus acidiformans	2036206	S	1	0	1	0.0000711693
Blautia argi	1912897	S	1	0	1	0.0000711693
Anaerocolumna cellulosilytica	433286	S	1	0	1	0.0000711693
[Clostridium] scindens	29347	S	1	0	1	0.0000711693
[Clostridium] hylemonae	89153	S	1	0	1	0.0000711693
Butyrivibrio proteoclasticus	43305	S	1	0	1	0.0000711693
Enterocloster bolteae	208479	S	1	0	1	0.0000711693
Lacrimispora sphenoides	29370	S	1	0	1	0.0000711693
Anaerotignum propionicum	28446	S	1	0	1	0.0000711693
Clostridium sp. JN-1	2483110	S	1	0	1	0.0000711693
Clostridium pasteurianum	1501	S	1	0	1	0.0000711693
Clostridium scatologenes	1548	S	1	0	1	0.0000711693
Clostridium beijerinckii	1520	S	1	0	1	0.0000711693
Clostridium saccharoperbutylacetonicum	36745	S	1	0	1	0.0000711693
Clostridium tyrobutyricum	1519	S	1	0	1	0.0000711693
Clostridium cellulovorans	1493	S	1	0	1	0.0000711693
Clostridium drakei	332101	S	1	0	1	0.0000711693
Clostridium isatidis	182773	S	1	0	1	0.0000711693
Candidatus Arthromitus sp. SFB-rat-Yit	1041504	S	1	0	1	0.0000711693
Ruminiclostridium cellulolyticum	1521	S	1	0	1	0.0000711693
Acetivibrio clariflavus	288965	S	1	0	1	0.0000711693
Ethanoligenens harbinense	253239	S	1	0	1	0.0000711693
Flavonifractor plautii	292800	S	1	0	1	0.0000711693
Caproiciproducens sp. NJN-50	2507162	S	1	0	1	0.0000711693
Romboutsia ilealis	1115758	S	1	0	1	0.0000711693
Romboutsia hominis	1507512	S	1	0	1	0.0000711693
Thermaerobacter marianensis	73919	S	1	0	1	0.0000711693
Thermaerobacter sp. FW80	2546351	S	1	0	1	0.0000711693
Flintibacter sp. KGMB00164	2610895	S	1	0	1	0.0000711693
Monoglobus pectinilyticus	1981510	S	1	0	1	0.0000711693
Massilistercora timonensis	2086584	S	1	0	1	0.0000711693
Desulfotomaculum ruminis	1564	S	1	0	1	0.0000711693
Desulfitobacterium hafniense	49338	S	1	0	1	0.0000711693
Desulfitobacterium dichloroeliminans	233055	S	1	0	1	0.0000711693
Syntrophobotulus glycolicus	51197	S	1	0	1	0.0000711693
Desulfofarcimen acetoxidans	58138	S	1	0	1	0.0000711693
Acetobacterium woodii	33952	S	1	0	1	0.0000711693
Heliobacterium modesticaldum	35701	S	1	0	1	0.0000711693
Syntrophomonas wolfei	863	S	1	0	1	0.0000711693
Christensenella minuta	626937	S	1	0	1	0.0000711693
Thermoanaerobacterium thermosaccharolyticum	1517	S	1	0	1	0.0000711693
Caldicellulosiruptor kristjanssonii	52765	S	1	0	1	0.0000711693
Moorella glycerini	55779	S	1	0	1	0.0000711693
Tepidanaerobacter acetatoxydans	499229	S	1	0	1	0.0000711693
Halanaerobium praevalens	2331	S	1	0	1	0.0000711693
Halanaerobium hydrogeniformans	656519	S	1	0	1	0.0000711693
Halocella sp. SP3-1	2382161	S	1	0	1	0.0000711693
Megamonas hypermegale	158847	S	1	0	1	0.0000711693
Sporomusa termitida	2377	S	1	0	1	0.0000711693
Phascolarctobacterium faecium	33025	S	1	0	1	0.0000711693
Phascolarctobacterium sp. Marseille-Q4147	2823317	S	1	0	1	0.0000711693
[Clostridium] innocuum	1522	S	1	0	1	0.0000711693
Erysipelatoclostridium ramosum	1547	S	1	0	1	0.0000711693
Faecalitalea cylindroides	39483	S	1	0	1	0.0000711693
Amedibacterium intestinale	2583452	S	1	0	1	0.0000711693
Turicibacter sanguinis	154288	S	1	0	1	0.0000711693
Tissierellia sp. JN-28	2507161	S	1	0	1	0.0000711693
Schnuerera ultunensis	45497	S	1	0	1	0.0000711693
Limnochorda pilosa	1555112	S	1	0	1	0.0000711693
Nostoc sp. TCL240-02	2572090	S	1	0	1	0.0000711693
Nostoc sp. TCL26-01	2576904	S	1	0	1	0.0000711693
Nostoc piscinale	224012	S	1	0	1	0.0000711693
Nostoc punctiforme	272131	S	1	0	1	0.0000711693
Nostoc sphaeroides	446679	S	1	0	1	0.0000711693
Nostoc flagelliforme	1306274	S	1	0	1	0.0000711693
Trichormus azollae	1164	S	1	0	1	0.0000711693
Calothrix parietina	32054	S	1	0	1	0.0000711693
Raphidiopsis curvata	312883	S	1	0	1	0.0000711693
Halothece sp. PCC 7418	65093	S	1	0	1	0.0000711693
Crocosphaera subtropica	2546360	S	1	0	1	0.0000711693
Candidatus Atelocyanobacterium thalassa	713887	S	1	0	1	0.0000711693
Microcoleus sp. PCC 7113	1173027	S	1	0	1	0.0000711693
Synechococcus sp. CBW1107	2789857	S	1	0	1	0.0000711693
Synechococcus sp. KORDI-100	1280380	S	1	0	1	0.0000711693
Synechococcus sp. JA-3-3Ab	321327	S	1	0	1	0.0000711693
Synechococcus sp. ROS8604	1442557	S	1	0	1	0.0000711693
Synechococcus sp. PCC 6312	195253	S	1	0	1	0.0000711693
Synechococcus sp. HK01-R	2751171	S	1	0	1	0.0000711693
Synechococcus elongatus	32046	S	1	0	1	0.0000711693
Leptolyngbya sp. O-77	1080068	S	1	0	1	0.0000711693
Leptolyngbya sp. NIES-3755	1752064	S	1	0	1	0.0000711693
Acaryochloris marina	155978	S	1	0	1	0.0000711693
Pseudanabaena sp. ABRG5-3	685565	S	1	0	1	0.0000711693
Gloeobacter kilaueensis	1416614	S	1	0	1	0.0000711693
Chroococcidiopsis thermalis	54299	S	1	0	1	0.0000711693
Mycoplasma sp. Zaradi2	547987	S	1	0	1	0.0000711693
Mycoplasma sp. Pen4	640330	S	1	0	1	0.0000711693
Mycoplasma sp. 1654_15	2725994	S	1	0	1	0.0000711693
Mycoplasma capricolum	2095	S	1	0	1	0.0000711693
Mycoplasma struthionis	538220	S	1	0	1	0.0000711693
Mycoplasma anserisalpingitidis	519450	S	1	0	1	0.0000711693
Mycoplasma nasistruthionis	353852	S	1	0	1	0.0000711693
Mycoplasma haemocanis	136241	S	1	0	1	0.0000711693
Mycoplasma yeatsii	51365	S	1	0	1	0.0000711693
Mycoplasma hyosynoviae	29559	S	1	0	1	0.0000711693
Mycoplasma hominis	2098	S	1	0	1	0.0000711693
Mycoplasma pneumoniae	2104	S	1	0	1	0.0000711693
Mycoplasma mobile	2118	S	1	0	1	0.0000711693
Mycoplasma synoviae	2109	S	1	0	1	0.0000711693
Mycoplasma citelli	171281	S	1	0	1	0.0000711693
Mycoplasma bovirhinis	29553	S	1	0	1	0.0000711693
Mycoplasma maculosum	114885	S	1	0	1	0.0000711693
Spiroplasma litorale	216942	S	1	0	1	0.0000711693
Spiroplasma helicoides	216938	S	1	0	1	0.0000711693
Spiroplasma floricola	216937	S	1	0	1	0.0000711693
Spiroplasma sabaudiense	216944	S	1	0	1	0.0000711693
Spiroplasma citri	2133	S	1	0	1	0.0000711693
Spiroplasma chrysopicola	216933	S	1	0	1	0.0000711693
Spiroplasma chinense	216932	S	1	0	1	0.0000711693
Spiroplasma alleghenense	216931	S	1	0	1	0.0000711693
Spiroplasma eriocheiris	315358	S	1	0	1	0.0000711693
Spiroplasma gladiatoris	2143	S	1	0	1	0.0000711693
Spiroplasma tabanidicola	324079	S	1	0	1	0.0000711693
Spiroplasma poulsonii	2138	S	1	0	1	0.0000711693
Mesoplasma entomophilum	2149	S	1	0	1	0.0000711693
Acholeplasma brassicae	61635	S	1	0	1	0.0000711693
Deinococcus gobiensis	502394	S	1	0	1	0.0000711693
Deinococcus sp. NW-56	2080419	S	1	0	1	0.0000711693
Deinococcus actinosclerus	1768108	S	1	0	1	0.0000711693
Deinococcus swuensis	1182571	S	1	0	1	0.0000711693
Thermus parvatiensis	456163	S	1	0	1	0.0000711693
Marinithermus hydrothermalis	186192	S	1	0	1	0.0000711693
Truepera radiovictrix	332249	S	1	0	1	0.0000711693
Pelolinea submarina	913107	S	1	0	1	0.0000711693
Brevefilum fermentans	1986204	S	1	0	1	0.0000711693
Thermomicrobium roseum	500	S	1	0	1	0.0000711693
Flavobacterium sp. xlx-214	2654325	S	1	0	1	0.0000711693
Flavobacterium sp. P2-65	2748320	S	1	0	1	0.0000711693
Flavobacterium sediminis	2201181	S	1	0	1	0.0000711693
Capnocytophaga canimorsus	28188	S	1	0	1	0.0000711693
Capnocytophaga cynodegmi	28189	S	1	0	1	0.0000711693
Capnocytophaga haemolytica	45243	S	1	0	1	0.0000711693
Capnocytophaga leadbetteri	327575	S	1	0	1	0.0000711693
Polaribacter sejongensis	985043	S	1	0	1	0.0000711693
Tenacibaculum sp. SZ-18	754423	S	1	0	1	0.0000711693
Tenacibaculum sp. DSM 106434	2358479	S	1	0	1	0.0000711693
Tenacibaculum maritimum	107401	S	1	0	1	0.0000711693
Tenacibaculum dicentrarchi	669041	S	1	0	1	0.0000711693
Lacinutrix sp. Bg11-31	2057808	S	1	0	1	0.0000711693
Winogradskyella sp. PG-2	754409	S	1	0	1	0.0000711693
Winogradskyella sp. PC-19	754417	S	1	0	1	0.0000711693
Winogradskyella sp. J14-2	1936080	S	1	0	1	0.0000711693
Winogradskyella schleiferi	2686078	S	1	0	1	0.0000711693
Winogradskyella helgolandensis	2697010	S	1	0	1	0.0000711693
Aequorivita sublithincola	101385	S	1	0	1	0.0000711693
Antarcticibacterium arcticum	2585771	S	1	0	1	0.0000711693
Formosa agariphila	320324	S	1	0	1	0.0000711693
Nonlabens spongiae	331648	S	1	0	1	0.0000711693
Nonlabens marinus	930802	S	1	0	1	0.0000711693
Nonlabens sp. Ci31	2608253	S	1	0	1	0.0000711693
Cellulophaga lytica	979	S	1	0	1	0.0000711693
Maribacter sp. T28	1836467	S	1	0	1	0.0000711693
Maribacter dokdonensis	320912	S	1	0	1	0.0000711693
Maribacter cobaltidurans	1178778	S	1	0	1	0.0000711693
Euzebyella marina	1761453	S	1	0	1	0.0000711693
Aureitalea sp. RR4-38	2094025	S	1	0	1	0.0000711693
Mariniflexile sp. TRM1-10	2027857	S	1	0	1	0.0000711693
Zunongwangia profunda	398743	S	1	0	1	0.0000711693
Urechidicola croceus	1850246	S	1	0	1	0.0000711693
Sediminicola sp. YIK13	1453352	S	1	0	1	0.0000711693
Amniculibacterium sp. G2-70	2767188	S	1	0	1	0.0000711693
Costertonia aggregata	343403	S	1	0	1	0.0000711693
Muricauda lutaonensis	516051	S	1	0	1	0.0000711693
Croceibacter atlanticus	313588	S	1	0	1	0.0000711693
Gramella fulva	2126553	S	1	0	1	0.0000711693
Chryseobacterium sp. StRB126	878220	S	1	0	1	0.0000711693
Chryseobacterium sp. IHB B 17019	1721091	S	1	0	1	0.0000711693
Chryseobacterium sp. 3008163	2478663	S	1	0	1	0.0000711693
Chryseobacterium shandongense	1493872	S	1	0	1	0.0000711693
Kaistella flava (ex Peng et al. 2021)	2038776	S	1	0	1	0.0000711693
Kaistella daneshvariae	2487074	S	1	0	1	0.0000711693
Elizabethkingia sp. JS20170427COW	2583851	S	1	0	1	0.0000711693
Elizabethkingia ursingii	1756150	S	1	0	1	0.0000711693
Empedobacter brevis	247	S	1	0	1	0.0000711693
Ornithobacterium rhinotracheale	28251	S	1	0	1	0.0000711693
Bergeyella cardium	1585976	S	1	0	1	0.0000711693
Candidatus Sulcia muelleri	336810	S	1	0	1	0.0000711693
Owenweeksia hongkongensis	253245	S	1	0	1	0.0000711693
Bacteroides caecimuris	1796613	S	1	0	1	0.0000711693
Prevotella intermedia	28131	S	1	0	1	0.0000711693
Prevotella scopos	589437	S	1	0	1	0.0000711693
Dysgonomonas sp. HDW5A	2714926	S	1	0	1	0.0000711693
Proteiniphilum saccharofermentans	1642647	S	1	0	1	0.0000711693
Petrimonas mucosa	1642646	S	1	0	1	0.0000711693
Porphyromonas gingivalis	837	S	1	0	1	0.0000711693
Coprobacter sp. 2CBH44	2751153	S	1	0	1	0.0000711693
Alkalitalea saponilacus	889453	S	1	0	1	0.0000711693
Draconibacterium orientale	1168034	S	1	0	1	0.0000711693
Spirosoma sp. KCTC 42546	2520506	S	1	0	1	0.0000711693
Spirosoma montaniterrae	1178516	S	1	0	1	0.0000711693
Spirosoma endbachense	2666025	S	1	0	1	0.0000711693
Spirosoma aureum	2692134	S	1	0	1	0.0000711693
Dyadobacter sp. Q3-56	2747268	S	1	0	1	0.0000711693
Fibrella aestuarina	651143	S	1	0	1	0.0000711693
Fibrella sp. ES10-3-2-2	1834519	S	1	0	1	0.0000711693
Leadbetterella byssophila	316068	S	1	0	1	0.0000711693
Hymenobacter sp. DG25A	1385663	S	1	0	1	0.0000711693
Hymenobacter sp. PAMC 26554	1484116	S	1	0	1	0.0000711693
Hymenobacter sp. DG01	2584940	S	1	0	1	0.0000711693
Hymenobacter sp. BRD67	2675877	S	1	0	1	0.0000711693
Hymenobacter sp. S2-20-2	2761579	S	1	0	1	0.0000711693
Hymenobacter busanensis	2607656	S	1	0	1	0.0000711693
Pontibacter actiniarum	323450	S	1	0	1	0.0000711693
Cyclobacterium marinum	104	S	1	0	1	0.0000711693
Bernardetia litoralis	999	S	1	0	1	0.0000711693
Mucilaginibacter gotjawali	1550579	S	1	0	1	0.0000711693
Pedobacter sp. KBS0701	2578106	S	1	0	1	0.0000711693
Pedobacter cryoconitis	188932	S	1	0	1	0.0000711693
Pedobacter ginsengisoli	363852	S	1	0	1	0.0000711693
Sphingobacterium sp. dk4302	2662364	S	1	0	1	0.0000711693
Sphingobacterium mizutaii	1010	S	1	0	1	0.0000711693
Sphingobacterium psychroaquaticum	561061	S	1	0	1	0.0000711693
Olivibacter sp. LS-1	2592345	S	1	0	1	0.0000711693
Olivibacter sp. SDN3	2764720	S	1	0	1	0.0000711693
Pseudopedobacter saltans	151895	S	1	0	1	0.0000711693
Chitinophaga sp. MD30	2033437	S	1	0	1	0.0000711693
Chitinophaga pinensis	79329	S	1	0	1	0.0000711693
Chitinophaga caeni	2029983	S	1	0	1	0.0000711693
Chitinophaga agri	2703787	S	1	0	1	0.0000711693
Arachidicoccus sp. BS20	1850526	S	1	0	1	0.0000711693
Arachidicoccus sp. B3-10	2545455	S	1	0	1	0.0000711693
Flavisolibacter ginsenosidimutans	661481	S	1	0	1	0.0000711693
Pseudocnuella soli	2502779	S	1	0	1	0.0000711693
Chlorobium limicola	1092	S	1	0	1	0.0000711693
Chlorobium chlorochromatii	337090	S	1	0	1	0.0000711693
Pelodictyon luteolum	1100	S	1	0	1	0.0000711693
Prosthecochloris sp. HL-130-GSB	1974213	S	1	0	1	0.0000711693
Ignavibacterium album	591197	S	1	0	1	0.0000711693
Bythopirellula goksoyri	1400387	S	1	0	1	0.0000711693
Thermogutta terrifontis	1331910	S	1	0	1	0.0000711693
Gimesia maris	122	S	1	0	1	0.0000711693
Gimesia panareensis	2527978	S	1	0	1	0.0000711693
Planctomyces sp. SH-PL62	1636152	S	1	0	1	0.0000711693
Crateriforma conspicua	2527996	S	1	0	1	0.0000711693
Maioricimonas rarisocia	2528026	S	1	0	1	0.0000711693
Aquisphaera giovannonii	406548	S	1	0	1	0.0000711693
Phycisphaera mikurensis	547188	S	1	0	1	0.0000711693
Sedimentisphaera cyanobacteriorum	1940790	S	1	0	1	0.0000711693
Methylacidimicrobium sp. B4	2796139	S	1	0	1	0.0000711693
Parachlamydia acanthamoebae	83552	S	1	0	1	0.0000711693
Candidatus Protochlamydia amoebophila	362787	S	1	0	1	0.0000711693
Chlamydia pecorum	85991	S	1	0	1	0.0000711693
Kiritimatiella glycovorans	1307763	S	1	0	1	0.0000711693
Treponema caldarium	215591	S	1	0	1	0.0000711693
Spirochaeta thermophila	154	S	1	0	1	0.0000711693
Sphaerochaeta pleomorpha	1131707	S	1	0	1	0.0000711693
Sediminispirochaeta smaragdinae	55206	S	1	0	1	0.0000711693
Leptospira santarosai	28183	S	1	0	1	0.0000711693
Brachyspira hyodysenteriae	159	S	1	0	1	0.0000711693
Brachyspira intermedia	84377	S	1	0	1	0.0000711693
Fusobacterium sp. oral taxon 203	671211	S	1	0	1	0.0000711693
Fusobacterium nucleatum	851	S	1	0	1	0.0000711693
Leptotrichia trevisanii	109328	S	1	0	1	0.0000711693
Leptotrichia hofstadii	157688	S	1	0	1	0.0000711693
Streptobacillus moniliformis	34105	S	1	0	1	0.0000711693
Granulicella sp. 5B5	1617967	S	1	0	1	0.0000711693
Candidatus Koribacter versatilis	658062	S	1	0	1	0.0000711693
Petrotoga mobilis	69499	S	1	0	1	0.0000711693
Athalassotoga saccharophila	1441386	S	1	0	1	0.0000711693
Thermocrinis albus	136094	S	1	0	1	0.0000711693
Candidatus Nanosynbacter lyticus	2093824	S	1	0	1	0.0000711693
Candidatus Endomicrobium trichonymphae	1408204	S	1	0	1	0.0000711693
Elusimicrobium minutum	423605	S	1	0	1	0.0000711693
Aminobacterium colombiense	81468	S	1	0	1	0.0000711693
Fretibacterium fastidiosum	651822	S	1	0	1	0.0000711693
Caldithrix abyssi	187145	S	1	0	1	0.0000711693
Haloarcula marismortui	2238	S	1	0	1	0.0000711693
Halosimplex rubrum	869889	S	1	0	1	0.0000711693
Halorussus sp. ZS-3	2650975	S	1	0	1	0.0000711693
Natrarchaeobaculum aegyptiacum	745377	S	1	0	1	0.0000711693
Natrarchaeobaculum sulfurireducens	2044521	S	1	0	1	0.0000711693
Natronococcus occultus	29288	S	1	0	1	0.0000711693
Natronorubrum aibiense	348826	S	1	0	1	0.0000711693
Halorubrum lacusprofundi	2247	S	1	0	1	0.0000711693
Halorubrum sp. CBA1229	1853699	S	1	0	1	0.0000711693
Halolamina sp. CBA1230	1853690	S	1	0	1	0.0000711693
Halopenitus persicus	1048396	S	1	0	1	0.0000711693
Halobonum sp. Gai3-2	2743090	S	1	0	1	0.0000711693
Haloplanus rubicundus	1547898	S	1	0	1	0.0000711693
Methanosarcina barkeri	2208	S	1	0	1	0.0000711693
Methanosarcina mazei	2209	S	1	0	1	0.0000711693
Methanosarcina siciliae	38027	S	1	0	1	0.0000711693
Methanoculleus marisnigri	2198	S	1	0	1	0.0000711693
Methanolacinia petrolearia	54120	S	1	0	1	0.0000711693
Methanospirillum hungatei	2203	S	1	0	1	0.0000711693
Methanobrevibacter olleyae	294671	S	1	0	1	0.0000711693
Methanothermococcus okinawensis	155863	S	1	0	1	0.0000711693
Thermococcus litoralis	2265	S	1	0	1	0.0000711693
Thermococcus sp. IRI35c	2016373	S	1	0	1	0.0000711693
Thermococcus kodakarensis	311400	S	1	0	1	0.0000711693
Pyrococcus yayanosii	1008460	S	1	0	1	0.0000711693
Candidatus Nitrosotenuis sp. DW1	2259672	S	1	0	1	0.0000711693
Nitrosopumilus maritimus	338192	S	1	0	1	0.0000711693
Nitrosopumilus oxyclinae	1959104	S	1	0	1	0.0000711693
Acidianus brierleyi	41673	S	1	0	1	0.0000711693
Acidianus sulfidivorans	312539	S	1	0	1	0.0000711693
Thermoproteus uzoniensis	184117	S	1	0	1	0.0000711693
Staphylothermus hellenicus	84599	S	1	0	1	0.0000711693
Caldisphaera lagunensis	200415	S	1	0	1	0.0000711693
Gordonia virus GAL1	2560493	S	1	0	1	0.0000711693
Caulobacter virus Rogue	1211643	S	1	0	1	0.0000711693
Prochlorococcus phage P-TIM68	1542477	S	1	0	1	0.0000711693
Acinetobacter virus Aci01-1	2734138	S	1	0	1	0.0000711693
Cyanophage P-RSM6	929832	S	1	0	1	0.0000711693
Microbacterium phage Arete	2713257	S	1	0	1	0.0000711693
uncultured crAssphage	1211417	S	1	0	1	0.0000711693
Staphylococcus virus Andhra	2732591	S	1	0	1	0.0000711693
Staphylococcus virus BS2	2734047	S	1	0	1	0.0000711693
Human betaherpesvirus 5	10359	S	1	0	1	0.0000711693
Chrysochromulina ericina virus	455364	S	1	0	1	0.0000711693
Singapore grouper iridovirus	262968	S	1	0	1	0.0000711693
African swine fever virus	10497	S	1	0	1	0.0000711693
Choristoneura biennis entomopoxvirus	10288	S	1	0	1	0.0000711693
Puerto Almendras almendravirus	1972686	S	1	0	1	0.0000711693
Warrego virus	40062	S	1	0	1	0.0000711693
Antheraea pernyi iflavirus	1460071	S	1	0	1	0.0000711693
Clostera anastomosis granulovirus B	1986290	S	1	0	1	0.0000711693
Diabrotica virgifera virgifera virus 3	1920989	S	1	0	1	0.0000711693
Candidatus Kinetoplastibacterium blastocrithidii	233181	S	1	-1	0	0.0000000000
Azotobacter vinelandii	354	S	3	-3	0	0.0000000000
Fluoribacter dumoffii	463	S	1	-1	0	0.0000000000
Rhodospirillum rubrum	1085	S	3	-3	0	0.0000000000
Desulfovibrio vulgaris	881	S	2	-2	0	0.0000000000
Paenibacillus mucilaginosus	61624	S	1	-1	0	0.0000000000
Mycoplasma genitalium	2097	S	1	-1	0	0.0000000000
Tannerella forsythia	28112	S	1	-1	0	0.0000000000
Borrelia anserina	143	S	1	-1	0	0.0000000000
Methanosarcina thermophila	2210	S	2	-2	0	0.0000000000
