name	taxonomy_id	taxonomy_lvl	kraken_assigned_reads	added_reads	new_est_reads	fraction_total_reads
Cutibacterium acnes	1747	S	6020	252	6272	0.1455456803
Staphylococcus cohnii	29382	S	1015	105	1120	0.0259903000
Klebsiella pneumoniae	573	S	616	489	1105	0.0256422157
Dermacoccus nishinomiyaensis	1274	S	872	51	923	0.0214187919
Xanthomonas euvesicatoria	456327	S	37	791	828	0.0192142575
Acinetobacter junii	40215	S	492	49	541	0.0125542431
Kocuria rhizophila	72000	S	371	53	424	0.0098391850
Streptomyces lividans	1916	S	175	246	421	0.0097695681
Bacillus cereus	1396	S	203	172	375	0.0087021094
Ralstonia solanacearum	305	S	297	39	336	0.0077970900
Acidovorax sp. KKS102	358220	S	249	57	306	0.0071009213
Variovorax paradoxus	34073	S	255	50	305	0.0070777156
Moraxella osloensis	34062	S	280	7	287	0.0066600144
Diaphorobacter sp. HDW4A	2714924	S	206	65	271	0.0062887244
Pseudomonas sp. CMR12a	658629	S	197	62	259	0.0060102569
Paenibacillus larvae	1464	S	1	239	240	0.0055693500
Variovorax boronicumulans	436515	S	159	69	228	0.0052908825
Rhodococcus qingshengii	334542	S	37	157	194	0.0045018913
Propionibacterium sp. oral taxon 193	671223	S	174	15	189	0.0043858631
Spirosoma sp. KUDC1026	2745947	S	184	5	189	0.0043858631
Acidovorax sp. JMULE5	2518343	S	166	19	185	0.0042930406
Staphylococcus epidermidis	1282	S	144	15	159	0.0036896944
Rhodococcus erythropolis	1833	S	38	118	156	0.0036200775
Staphylococcus capitis	29388	S	137	13	150	0.0034808438
Pseudomonas aeruginosa	287	S	46	102	148	0.0034344325
Burkholderia pseudomallei	28450	S	28	116	144	0.0033416100
Variovorax sp. PMC12	2126319	S	6	130	136	0.0031559650
Streptococcus thermophilus	1308	S	110	23	133	0.0030863481
Janibacter indicus	857417	S	87	45	132	0.0030631425
Paenarthrobacter sp. YJN-D	2735317	S	113	10	123	0.0028542919
Acidovorax sp. JS42	232721	S	9	112	121	0.0028078806
Diaphorobacter aerolatus	1288495	S	80	36	116	0.0026918525
Priestia megaterium	1404	S	90	26	116	0.0026918525
Variovorax sp. 38R	2774875	S	70	42	112	0.0025990300
Pedobacter sp. SW-16	2766984	S	95	16	111	0.0025758244
Pseudomonas putida	303	S	62	47	109	0.0025294131
Lawsonella clevelandensis	1528099	S	106	3	109	0.0025294131
Variovorax sp. PAMC 28711	1795631	S	103	4	107	0.0024830019
Halomonas sp. JS92-SW72	2306583	S	99	6	105	0.0024365906
Methylorubrum extorquens	408	S	53	51	104	0.0024133850
Gordonia bronchialis	2054	S	97	7	104	0.0024133850
Stenotrophomonas maltophilia	40324	S	64	39	103	0.0023901794
Acidovorax sp. T1	1858609	S	45	57	102	0.0023669738
Acinetobacter baumannii	470	S	34	66	100	0.0023205625
Kinneretia sp. DAIF2	2714952	S	89	8	97	0.0022509456
Micrococcus luteus	1270	S	66	28	94	0.0021813288
Janthinobacterium sp. HH102	1537274	S	44	49	93	0.0021581231
Janthinobacterium agaricidamnosum	55508	S	51	42	93	0.0021581231
Acidovorax carolinensis	553814	S	65	27	92	0.0021349175
Paracoccus yeei	147645	S	52	33	85	0.0019724781
Sphingobium yanoikuyae	13690	S	48	33	81	0.0018796556
Staphylococcus warneri	1292	S	66	15	81	0.0018796556
Salmonella phage TS13	2500149	S	78	1	79	0.0018332444
Delftia acidovorans	80866	S	38	40	78	0.0018100388
Cutibacterium avidum	33010	S	73	3	76	0.0017636275
Corynebacterium kefirresidentii	1979527	S	62	14	76	0.0017636275
Pseudomonas fluorescens	294	S	54	21	75	0.0017404219
Pasteurella multocida	747	S	62	13	75	0.0017404219
Alicycliphilus denitrificans	179636	S	36	38	74	0.0017172163
Paracoccus sanguinis	1545044	S	67	6	73	0.0016940106
Urbifossiella limnaea	2528023	S	69	4	73	0.0016940106
Staphylococcus virus Andhra	2732591	S	73	0	73	0.0016940106
Flavobacterium phage vB_FspS_filifjonk9-1	2686245	S	33	37	70	0.0016243938
Rhizobacter sp. AJA081-3	2753607	S	60	9	69	0.0016011881
Acaryochloris marina	155978	S	66	1	67	0.0015547769
Variovorax sp. PAMC26660	2762322	S	61	5	66	0.0015315713
Bacillus thuringiensis	1428	S	14	52	66	0.0015315713
Staphylococcus aureus	1280	S	37	27	64	0.0014851600
Hydrogenophaga sp. BPS33	2651974	S	47	16	63	0.0014619544
Limnohabitans sp. 63ED37-2	1678128	S	60	3	63	0.0014619544
Lysobacter enzymogenes	69	S	58	5	63	0.0014619544
Pseudomonas tolaasii	29442	S	56	6	62	0.0014387488
Sphingomonas melonis	152682	S	26	34	60	0.0013923375
Rhodococcus sp. YL-1	1045808	S	13	47	60	0.0013923375
Janthinobacterium sp. LM6	1938606	S	46	13	59	0.0013691319
Escherichia coli	562	S	18	38	56	0.0012995150
Acidovorax sp. RAC01	1842533	S	45	10	55	0.0012763094
Rhodoferax sediminis	2509614	S	52	3	55	0.0012763094
Polynucleobacter difficilis	556054	S	54	1	55	0.0012763094
Bradyrhizobium diazoefficiens	1355477	S	21	32	53	0.0012298981
Comamonas testosteroni	285	S	31	21	52	0.0012066925
Lactococcus lactis	1358	S	31	21	52	0.0012066925
Hymenobacter sp. APR13	1356852	S	41	11	52	0.0012066925
Flavobacterium phage vB_FspS_lillamy9-1	2686251	S	2	50	52	0.0012066925
Methylobacterium durans	2202825	S	48	3	51	0.0011834869
Clostridium botulinum	1491	S	43	8	51	0.0011834869
Rhodoferax koreense	1842727	S	38	12	50	0.0011602813
Methylobacterium sp. C1	1479019	S	8	42	50	0.0011602813
Methylobacterium aquaticum	270351	S	40	10	50	0.0011602813
Methylorubrum populi	223967	S	37	13	50	0.0011602813
Variovorax sp. RKNM96	2681552	S	41	7	48	0.0011138700
Rubrivivax gelatinosus	28068	S	41	7	48	0.0011138700
Bradyrhizobium sp. CCBAU 51765	1325102	S	37	11	48	0.0011138700
Curtobacterium flaccumfaciens	2035	S	46	2	48	0.0011138700
Acinetobacter ursingii	108980	S	41	6	47	0.0010906644
Rhodopseudomonas palustris	1076	S	37	10	47	0.0010906644
Sorangium cellulosum	56	S	44	3	47	0.0010906644
Corynebacterium segmentosum	43990	S	45	2	47	0.0010906644
Paucibacter sp. KCTC 42545	1768242	S	42	4	46	0.0010674588
Aquabacterium olei	1296669	S	40	6	46	0.0010674588
Pseudomonas stutzeri	316	S	42	4	46	0.0010674588
Buchnera aphidicola	9	S	47	-1	46	0.0010674588
Epilithonimonas vandammei	2487072	S	22	23	45	0.0010442531
Sphaerotilus natans	34103	S	37	7	44	0.0010210475
Methylobacterium sp. WL1	2603276	S	40	4	44	0.0010210475
Limnoglobus roseus	2598579	S	42	2	44	0.0010210475
Mitsuaria sp. 7	1658665	S	38	5	43	0.0009978419
Kaistella jeonii	266749	S	41	2	43	0.0009978419
Curvibacter sp. AEP1-3	1844971	S	42	0	42	0.0009746363
Tardiphaga robiniae	943830	S	39	3	42	0.0009746363
Cloacibacterium normanense	237258	S	37	5	42	0.0009746363
Acidovorax sp. 1608163	2478662	S	38	3	41	0.0009514306
Methylobacterium sp. 17Sr1-43	2202828	S	37	4	41	0.0009514306
Staphylococcus xylosus	1288	S	39	1	40	0.0009282250
Pedobacter sp. G11	2482728	S	36	4	40	0.0009282250
Pseudomonas oryzihabitans	47885	S	36	3	39	0.0009050194
Cutibacterium granulosum	33011	S	38	1	39	0.0009050194
Flavobacterium psychrophilum	96345	S	31	8	39	0.0009050194
Blattabacterium cuenoti	1653831	S	31	8	39	0.0009050194
Sphingobacterium multivorum	28454	S	21	18	39	0.0009050194
Microbacterium sp. PM5	2014534	S	35	3	38	0.0008818138
Brevibacterium sp. CS2	2575923	S	36	2	38	0.0008818138
Oscillatoria nigro-viridis	482564	S	35	3	38	0.0008818138
Variovorax sp. HW608	1034889	S	36	1	37	0.0008586081
Acidovorax avenae	80867	S	26	11	37	0.0008586081
Hydrogenophaga pseudoflava	47421	S	17	20	37	0.0008586081
Achromobacter xylosoxidans	85698	S	21	16	37	0.0008586081
Corynebacterium jeikeium	38289	S	22	15	37	0.0008586081
Nostoc carneum	374162	S	10	27	37	0.0008586081
Hymenobacter sedentarius	1411621	S	36	1	37	0.0008586081
Polaromonas naphthalenivorans	216465	S	33	3	36	0.0008354025
Ramlibacter tataouinensis	94132	S	34	2	36	0.0008354025
Gordonia polyisoprenivorans	84595	S	35	1	36	0.0008354025
Variovorax sp. WDL1	207745	S	24	11	35	0.0008121969
Hydrogenophaga sp. PBL-H3	434010	S	23	12	35	0.0008121969
Polaromonas sp. JS666	296591	S	21	14	35	0.0008121969
Cupriavidus taiwanensis	164546	S	29	6	35	0.0008121969
Bosea sp. ANAM02	2020412	S	29	6	35	0.0008121969
Methylobacterium brachiatum	269660	S	27	8	35	0.0008121969
Sphingobium sp. YG1	2082188	S	29	6	35	0.0008121969
Corynebacterium xerosis	1725	S	32	3	35	0.0008121969
Flavobacterium nackdongense	2547394	S	34	1	35	0.0008121969
Variovorax sp. PDNC026	2811425	S	2	32	34	0.0007889913
Rhizobacter gummiphilus	946333	S	31	3	34	0.0007889913
Candidatus Planktophila sulfonica	1884904	S	31	3	34	0.0007889913
Flavobacterium columnare	996	S	30	4	34	0.0007889913
Corynebacterium tuberculostearicum	38304	S	29	4	33	0.0007657856
Microcystis aeruginosa	1126	S	30	3	33	0.0007657856
Proteus virus Isfahan	2560650	S	33	0	33	0.0007657856
Flavobacterium virus 2A	2560471	S	3	30	33	0.0007657856
Rhodoferax saidenbachensis	1484693	S	30	2	32	0.0007425800
Delftia lacustris	558537	S	8	24	32	0.0007425800
Ottowia oryzae	2109914	S	31	1	32	0.0007425800
Brevundimonas sp. LVF1	2774189	S	28	4	32	0.0007425800
Mycobacteroides chelonae	1774	S	14	18	32	0.0007425800
Pedobacter roseus	336820	S	26	6	32	0.0007425800
Pseudobacter ginsenosidimutans	661488	S	30	2	32	0.0007425800
Variovorax sp. PAMC28562	2762323	S	31	0	31	0.0007193744
Variovorax sp. PBL-E5	434014	S	14	17	31	0.0007193744
Hydrogenophaga sp. RAC07	1842537	S	25	6	31	0.0007193744
Methylibium petroleiphilum	105560	S	20	11	31	0.0007193744
Enterobacter hormaechei	158836	S	9	22	31	0.0007193744
Sphingopyxis fribergensis	1515612	S	23	8	31	0.0007193744
Brevundimonas sp. GW460-12-10-14-LB2	1827469	S	18	13	31	0.0007193744
Brachybacterium sp. SGAir0954	2571029	S	30	1	31	0.0007193744
Rhodococcus sp. NJ-530	2490853	S	6	25	31	0.0007193744
Variovorax sp. RA8	662548	S	23	7	30	0.0006961688
Vibrio anguillarum	55601	S	28	2	30	0.0006961688
Methylobacterium sp. 4-46	426117	S	28	2	30	0.0006961688
Sphingorhabdus lacus	392610	S	30	0	30	0.0006961688
Staphylococcus hominis	1290	S	28	2	30	0.0006961688
Chryseobacterium sp. NEB161	2724619	S	18	12	30	0.0006961688
Lacibacter sp. S13-6-6	2760713	S	30	0	30	0.0006961688
Hydrogenophaga sp. PBC	795665	S	22	7	29	0.0006729631
Duganella sp. AF9R3	2728021	S	27	2	29	0.0006729631
Acinetobacter johnsonii	40214	S	17	12	29	0.0006729631
Rhizobium pusense	648995	S	8	21	29	0.0006729631
Sphingopyxis macrogoltabida	33050	S	21	8	29	0.0006729631
Roseomonas mucosa	207340	S	11	18	29	0.0006729631
Pedobacter sp. HDW13	2714940	S	27	2	29	0.0006729631
Frigoriglobus tundricola	2774151	S	25	4	29	0.0006729631
Delftia tsuruhatensis	180282	S	9	19	28	0.0006497575
Melaminivora sp. SC2-9	2109913	S	23	5	28	0.0006497575
Janthinobacterium sp. PLB02	2808899	S	13	15	28	0.0006497575
Massilia sp. LPB0304	2769491	S	17	11	28	0.0006497575
Bosea sp. RAC05	1842539	S	23	5	28	0.0006497575
Tabrizicola piscis	2494374	S	27	1	28	0.0006497575
Brevundimonas sp. CS1	2813778	S	20	8	28	0.0006497575
Microbacterium hominis	162426	S	24	4	28	0.0006497575
Hydrogenophaga sp. YM1	2806262	S	22	5	27	0.0006265519
Janthinobacterium sp. 1_2014MBL_MicDiv	1644131	S	24	3	27	0.0006265519
Janthinobacterium tructae	2590869	S	21	6	27	0.0006265519
Massilia oculi	945844	S	24	3	27	0.0006265519
Leptothrix cholodnii	34029	S	23	4	27	0.0006265519
Pseudomonas chlororaphis	587753	S	20	7	27	0.0006265519
Bradyrhizobium erythrophlei	1437360	S	26	1	27	0.0006265519
Sphingomonas sp. NIC1	1961362	S	16	11	27	0.0006265519
Sphingopyxis sp. EG6	1874061	S	18	9	27	0.0006265519
Gemmata obscuriglobus	114	S	25	2	27	0.0006265519
Gemmata massiliana	1210884	S	17	10	27	0.0006265519
Burkholderia cenocepacia	95486	S	12	14	26	0.0006033463
Methylibium sp. Pch-M	2082386	S	15	11	26	0.0006033463
Lysobacter oculi	2698682	S	26	0	26	0.0006033463
Novosphingobium sp. KA1	164608	S	8	18	26	0.0006033463
Janibacter sp. YB324	2761047	S	15	11	26	0.0006033463
Roseateles depolymerans	76731	S	23	2	25	0.0005801406
Methylobacterium sp. AMS5	925818	S	15	10	25	0.0005801406
Sphingomonas panacisoli	1813879	S	25	0	25	0.0005801406
Flavobacterium sp. Sr18	935222	S	23	2	25	0.0005801406
Gemmata sp. SH-PL17	1630693	S	15	10	25	0.0005801406
Variovorax sp. PBS-H4	434008	S	19	5	24	0.0005569350
Acidovorax monticola	1926868	S	22	2	24	0.0005569350
Hydrogenophaga sp. PAMC20947	2565558	S	24	0	24	0.0005569350
Massilia sp. WG5	1707785	S	15	9	24	0.0005569350
Achromobacter spanius	217203	S	21	3	24	0.0005569350
Xanthomonas campestris	339	S	23	1	24	0.0005569350
Bradyrhizobium sp. CCBAU 051011	858422	S	21	3	24	0.0005569350
Methylobacterium sp. DM1	2067957	S	6	18	24	0.0005569350
Rhizobium leguminosarum	384	S	19	5	24	0.0005569350
Sphingomonas koreensis	93064	S	17	7	24	0.0005569350
Roseomonas sp. FDAARGOS_362	2018065	S	11	13	24	0.0005569350
Kocuria palustris	71999	S	23	1	24	0.0005569350
Corynebacterium sp. LMM-1652	2487892	S	24	0	24	0.0005569350
Finegoldia magna	1260	S	21	3	24	0.0005569350
Flavobacterium phage vB_FspS_tooticki6-1	2686279	S	7	17	24	0.0005569350
Comamonas aquatica	225991	S	20	3	23	0.0005337294
Schlegelella thermodepolymerans	215580	S	21	2	23	0.0005337294
Cupriavidus basilensis	68895	S	20	3	23	0.0005337294
Massilia sp. CCM 8941	2765360	S	17	6	23	0.0005337294
Aeromonas caviae	648	S	6	17	23	0.0005337294
Bradyrhizobium icense	1274631	S	21	2	23	0.0005337294
Methylobacterium nodulans	114616	S	22	1	23	0.0005337294
Labilithrix luteola	1391654	S	23	0	23	0.0005337294
Prochlorococcus marinus	1219	S	22	1	23	0.0005337294
Acidovorax antarcticus	2743470	S	19	3	22	0.0005105238
Hydrogenophaga sp. NH-16	2184519	S	9	13	22	0.0005105238
Rhodoferax sp. AJA081-3	2752316	S	21	1	22	0.0005105238
Verminephrobacter eiseniae	364317	S	22	0	22	0.0005105238
Massilia putida	1141883	S	17	5	22	0.0005105238
Duganella sp. GN2-R2	2728020	S	19	3	22	0.0005105238
Pseudomonas citronellolis	53408	S	14	8	22	0.0005105238
Sphingomonas sp. IC081	304378	S	6	16	22	0.0005105238
Sphingomonas taxi	1549858	S	22	0	22	0.0005105238
Minicystis rosea	888845	S	21	1	22	0.0005105238
Megamonas funiformis	437897	S	22	0	22	0.0005105238
Flavobacterium sp. KBS0721	1179672	S	18	4	22	0.0005105238
Myroides odoratimimus	76832	S	9	13	22	0.0005105238
Chryseobacterium manosquense	2754694	S	8	14	22	0.0005105238
Paraflavitalea soli	2315862	S	21	1	22	0.0005105238
Ottowia sp. 27C	2816950	S	21	0	21	0.0004873181
Janthinobacterium svalbardensis	368607	S	17	4	21	0.0004873181
Janthinobacterium lividum	29581	S	12	9	21	0.0004873181
Pseudomonas veronii	76761	S	8	13	21	0.0004873181
Pseudomonas alcaligenes	43263	S	19	2	21	0.0004873181
Klebsiella grimontii	2058152	S	12	9	21	0.0004873181
Salmonella enterica	28901	S	16	5	21	0.0004873181
Pantoea agglomerans	549	S	21	0	21	0.0004873181
Stenotrophomonas rhizophila	216778	S	20	1	21	0.0004873181
Bradyrhizobium guangdongense	1325090	S	11	10	21	0.0004873181
Aminobacter sp. MDW-2	2666139	S	6	15	21	0.0004873181
Sphingomonas sp. MM-1	745310	S	11	10	21	0.0004873181
Sphingomonas alpina	653931	S	21	0	21	0.0004873181
Novosphingobium resinovorum	158500	S	16	5	21	0.0004873181
Cereibacter sphaeroides	1063	S	20	1	21	0.0004873181
Kytococcus sedentarius	1276	S	20	1	21	0.0004873181
Staphylococcus auricularis	29379	S	21	0	21	0.0004873181
Listeria monocytogenes	1639	S	4	17	21	0.0004873181
Flavobacterium sp. MDT1-60	1979344	S	19	2	21	0.0004873181
Pedobacter sp. KBS0701	2578106	S	18	3	21	0.0004873181
Luteolibacter luteus	2728835	S	21	0	21	0.0004873181
Rhodoferax sp. PAMC29310	2822760	S	19	1	20	0.0004641125
Xylophilus rhododendri	2697032	S	18	2	20	0.0004641125
Serratia marcescens	615	S	12	8	20	0.0004641125
Bradyrhizobium paxllaeri	190148	S	18	2	20	0.0004641125
Bradyrhizobium ottawaense	931866	S	2	18	20	0.0004641125
Bosea sp. F3-2	2599640	S	17	3	20	0.0004641125
Brevundimonas vesicularis	41276	S	9	11	20	0.0004641125
Kocuria varians	1272	S	18	2	20	0.0004641125
Tsukamurella tyrosinosolvens	57704	S	16	4	20	0.0004641125
Streptomyces venezuelae	54571	S	20	0	20	0.0004641125
Chryseobacterium indologenes	253	S	16	4	20	0.0004641125
Kaistella flava (ex Peng et al. 2021)	2038776	S	18	2	20	0.0004641125
Variovorax sp. SRS16	282217	S	10	9	19	0.0004409069
Hydrogenophaga sp. BA0156	2716225	S	15	4	19	0.0004409069
Cupriavidus oxalaticus	96344	S	17	2	19	0.0004409069
Bordetella hinzii	103855	S	17	2	19	0.0004409069
Oryzomicrobium terrae	1735038	S	19	0	19	0.0004409069
Bosea vaviloviae	1526658	S	15	4	19	0.0004409069
Methylobacterium mesophilicum	39956	S	18	1	19	0.0004409069
Agrobacterium tumefaciens	358	S	12	7	19	0.0004409069
Sphingomonas sp. FARSPH	2219696	S	14	5	19	0.0004409069
Haematobacter massiliensis	195105	S	14	5	19	0.0004409069
Brevundimonas naejangsanensis	588932	S	17	2	19	0.0004409069
Kocuria sp. BT304	1702043	S	13	6	19	0.0004409069
Rhodococcus sp. AQ5-07	2054902	S	5	14	19	0.0004409069
Bacillus mycoides	1405	S	17	2	19	0.0004409069
Carnobacterium maltaromaticum	2751	S	18	1	19	0.0004409069
Flavobacterium sp. M31R6	2739062	S	18	1	19	0.0004409069
Hymenobacter radiodurans	2496028	S	4	15	19	0.0004409069
Pedobacter sp. JBR3-12	2789740	S	18	1	19	0.0004409069
Pedobacter suwonensis	332999	S	16	3	19	0.0004409069
Panacibacter ginsenosidivorans	1813871	S	19	0	19	0.0004409069
Phocaeicola vulgatus	821	S	12	7	19	0.0004409069
Diaphorobacter sp. HDW4B	2714925	S	18	0	18	0.0004177013
Diaphorobacter polyhydroxybutyrativorans	1546149	S	3	15	18	0.0004177013
blood disease bacterium A2-HR MARDI	1944648	S	2	16	18	0.0004177013
Burkholderia multivorans	87883	S	15	3	18	0.0004177013
Cupriavidus sp. USMAHM13	1389192	S	5	13	18	0.0004177013
Limnobacter sp. SAORIC-580	2732163	S	18	0	18	0.0004177013
Citrobacter freundii	546	S	10	8	18	0.0004177013
Stenotrophomonas acidaminiphila	128780	S	10	8	18	0.0004177013
Bradyrhizobium sp.	376	S	6	12	18	0.0004177013
Methylobacterium terrae	2202827	S	15	3	18	0.0004177013
Sphingobium hydrophobicum	1673076	S	11	7	18	0.0004177013
Microbacterium sp. PAMC 28756	1795053	S	7	11	18	0.0004177013
Actinomyces oris	544580	S	13	5	18	0.0004177013
Streptococcus mitis	28037	S	16	2	18	0.0004177013
Pedobacter ginsengisoli	363852	S	17	1	18	0.0004177013
Verrucomicrobium spinosum	2736	S	17	1	18	0.0004177013
Variovorax sp. PBL-H6	434009	S	11	6	17	0.0003944956
Acidovorax sp. HDW3	2714923	S	16	1	17	0.0003944956
Rhodoferax sp. BAB1	2741720	S	15	2	17	0.0003944956
Massilia violaceinigra	2045208	S	14	3	17	0.0003944956
Collimonas arenae	279058	S	16	1	17	0.0003944956
Pseudomonas protegens	380021	S	16	1	17	0.0003944956
Acinetobacter pittii	48296	S	10	7	17	0.0003944956
Acinetobacter haemolyticus	29430	S	15	2	17	0.0003944956
Methylobacterium indicum	1775910	S	13	4	17	0.0003944956
Ensifer adhaerens	106592	S	14	3	17	0.0003944956
Shinella sp. HZN7	879274	S	13	4	17	0.0003944956
Sphingomonas sp. HMP9	1517554	S	15	2	17	0.0003944956
Sphingopyxis sp. 113P3	292913	S	13	4	17	0.0003944956
Porphyrobacter sp. YT40	2547601	S	11	6	17	0.0003944956
Croceicoccus marinus	450378	S	13	4	17	0.0003944956
Brevundimonas sp. Bb-A	2560058	S	7	10	17	0.0003944956
Gordonia terrae	2055	S	13	4	17	0.0003944956
Bifidobacterium longum	216816	S	9	8	17	0.0003944956
Staphylococcus simulans	1286	S	17	0	17	0.0003944956
Faecalibacterium prausnitzii	853	S	13	4	17	0.0003944956
Flavobacterium sp. SLB02	2665645	S	15	2	17	0.0003944956
Flavobacterium sp. LPB0248	2614441	S	12	5	17	0.0003944956
Flavobacterium sangjuense	2518177	S	17	0	17	0.0003944956
Chryseobacterium sp. SNU WT5	2594269	S	14	3	17	0.0003944956
Rhodoferax antarcticus	81479	S	16	0	16	0.0003712900
Comamonas thiooxydans	363952	S	9	7	16	0.0003712900
Cupriavidus metallidurans	119219	S	13	3	16	0.0003712900
Massilia sp. NR 4-1	1678028	S	14	2	16	0.0003712900
Massilia albidiflava	321983	S	12	4	16	0.0003712900
Enterobacter asburiae	61645	S	7	9	16	0.0003712900
Methylobacterium oryzae	334852	S	1	15	16	0.0003712900
Rhizobium phaseoli	396	S	9	7	16	0.0003712900
Archangium violaceum	83451	S	14	2	16	0.0003712900
Microbacterium sp. Y-01	2048898	S	13	3	16	0.0003712900
Rhodococcus fascians	1828	S	14	2	16	0.0003712900
Tsukamurella paurometabola	2061	S	15	1	16	0.0003712900
Staphylococcus saccharolyticus	33028	S	16	0	16	0.0003712900
Streptococcus dysgalactiae	1334	S	6	10	16	0.0003712900
Flavobacterium anhuiense	459526	S	13	3	16	0.0003712900
Chryseobacterium lactis	1241981	S	9	7	16	0.0003712900
Pedobacter sp. CJ43	2605747	S	16	0	16	0.0003712900
Symmachiella dynata	2527995	S	16	0	16	0.0003712900
Massilia sp. YMA4	1593482	S	9	6	15	0.0003480844
Azospira sp. I09	1765049	S	8	7	15	0.0003480844
Pseudoxanthomonas mexicana	128785	S	14	1	15	0.0003480844
Sinorhizobium meliloti	382	S	14	1	15	0.0003480844
Sinorhizobium fredii	380	S	10	5	15	0.0003480844
Sphingomonas sp. NBWT7	2596913	S	14	1	15	0.0003480844
Sphingomonas sp. PAMC26645	2565555	S	14	1	15	0.0003480844
Sphingomonas sp. AAP5	1523415	S	14	1	15	0.0003480844
Sphingopyxis sp. OPL5	2486273	S	14	1	15	0.0003480844
Brevundimonas vancanneytii	1325724	S	5	10	15	0.0003480844
Roseomonas gilardii	257708	S	14	1	15	0.0003480844
Azospirillum thermophilum	2202148	S	14	1	15	0.0003480844
Microbacterium aurum	36805	S	13	2	15	0.0003480844
Janibacter limosus	53458	S	15	0	15	0.0003480844
Clostridium perfringens	1502	S	15	0	15	0.0003480844
Calothrix sp. NIES-2098	1954171	S	10	5	15	0.0003480844
Mucilaginibacter rubeus	2027860	S	6	9	15	0.0003480844
Haliscomenobacter hydrossis	2350	S	15	0	15	0.0003480844
Planctomyces sp. SH-PL62	1636152	S	13	2	15	0.0003480844
Roseimicrobium sp. ORNL1	2711231	S	15	0	15	0.0003480844
Diaphorobacter sp. JS3050	2735554	S	1	13	14	0.0003248788
Diaphorobacter sp. JS3051	2792224	S	1	13	14	0.0003248788
Hydrogenophaga crassostreae	1763535	S	14	0	14	0.0003248788
Comamonas sp. NLF-7-7	2597701	S	12	2	14	0.0003248788
Simplicispira suum	2109915	S	13	1	14	0.0003248788
Cupriavidus pauculus	82633	S	13	1	14	0.0003248788
Pandoraea pnomenusa	93220	S	12	2	14	0.0003248788
Massilia lutea	321985	S	12	2	14	0.0003248788
Thiomonas sp. X19	1050370	S	12	2	14	0.0003248788
Achromobacter denitrificans	32002	S	10	4	14	0.0003248788
Chromobacterium paludis	2605945	S	13	1	14	0.0003248788
Acinetobacter lwoffii	28090	S	9	5	14	0.0003248788
Pantoea vagans	470934	S	12	2	14	0.0003248788
Bradyrhizobium sp. BTAi1	288000	S	13	1	14	0.0003248788
Bradyrhizobium lablabi	722472	S	5	9	14	0.0003248788
Bosea sp. Tri-49	1867715	S	13	1	14	0.0003248788
Methylobacterium sp. XJLW	739141	S	1	13	14	0.0003248788
Methylobacterium currus	2051553	S	11	3	14	0.0003248788
Sphingomonas sp. HMP6	1517551	S	14	0	14	0.0003248788
Sphingomonas insulae	424800	S	14	0	14	0.0003248788
Sphingomonas paucimobilis	13689	S	12	2	14	0.0003248788
Sphingomonas sanxanigenens	397260	S	11	3	14	0.0003248788
Sphingobium sp. Cam5-1	2789327	S	12	2	14	0.0003248788
Sphingobium amiense	135719	S	7	7	14	0.0003248788
Blastomonas sp. RAC04	1842535	S	7	7	14	0.0003248788
Paracoccus zhejiangensis	1077935	S	13	1	14	0.0003248788
Rhodobacter blasticus	1075	S	13	1	14	0.0003248788
Caulobacter vibrioides	155892	S	11	3	14	0.0003248788
Aliarcobacter cryaerophilus	28198	S	12	2	14	0.0003248788
Dermacoccus sp. PAMC28757	2762331	S	14	0	14	0.0003248788
Rhodococcus sp. H-CA8f	1727214	S	3	11	14	0.0003248788
Gordonia sp. 135	2676309	S	5	9	14	0.0003248788
Actinoplanes sp. N902-109	649831	S	10	4	14	0.0003248788
Staphylococcus lugdunensis	28035	S	14	0	14	0.0003248788
Bacillus subtilis	1423	S	8	6	14	0.0003248788
Lacticaseibacillus rhamnosus	47715	S	14	0	14	0.0003248788
Flavobacterium sp. HYN0086	2249356	S	12	2	14	0.0003248788
Amniculibacterium sp. G2-70	2767188	S	9	5	14	0.0003248788
Hymenobacter sp. PAMC 26628	1484118	S	13	1	14	0.0003248788
Chitinophaga pinensis	79329	S	12	2	14	0.0003248788
Akkermansia muciniphila	239935	S	13	1	14	0.0003248788
Opitutus sp. GAS368	1882749	S	11	3	14	0.0003248788
Rhodoferax ferrireducens	192843	S	13	0	13	0.0003016731
Serpentinomonas mccroryi	1458426	S	11	2	13	0.0003016731
Pulveribacter suum	2116657	S	12	1	13	0.0003016731
Burkholderia gladioli	28095	S	13	0	13	0.0003016731
Massilia armeniaca	2072590	S	9	4	13	0.0003016731
Alcaligenes faecalis	511	S	8	5	13	0.0003016731
Pseudomonas sp. 02C 26	2054914	S	13	0	13	0.0003016731
Xanthomonas oryzae	347	S	13	0	13	0.0003016731
Lysobacter capsici	435897	S	12	1	13	0.0003016731
Haemophilus parainfluenzae	729	S	12	1	13	0.0003016731
Methylobacterium phyllosphaerae	418223	S	3	10	13	0.0003016731
Sphingomonas sp. XS-10	2599297	S	13	0	13	0.0003016731
Sphingobium sp. SYK-6	627192	S	11	2	13	0.0003016731
Sphingobium sp. YBL2	484429	S	4	9	13	0.0003016731
Erythrobacter litoralis	39960	S	12	1	13	0.0003016731
Paracoccus sp. Arc7-R13	2500532	S	13	0	13	0.0003016731
Brevundimonas sp. LVF2	2774190	S	13	0	13	0.0003016731
Brevundimonas subvibrioides	74313	S	13	0	13	0.0003016731
Brevundimonas mediterranea	74329	S	12	1	13	0.0003016731
Myxococcus xanthus	34	S	10	3	13	0.0003016731
Nocardioides humi	449461	S	12	1	13	0.0003016731
Micrococcus sp. KBS0714	1179670	S	3	10	13	0.0003016731
Rothia mucilaginosa	43675	S	13	0	13	0.0003016731
Nocardia brasiliensis	37326	S	13	0	13	0.0003016731
Corynebacterium glucuronolyticum	39791	S	13	0	13	0.0003016731
Gordonia rubripertincta	36822	S	10	3	13	0.0003016731
Streptomyces sp. RLB3-17	2594455	S	1	12	13	0.0003016731
Pseudonocardia sp. AL041005-10	445576	S	9	4	13	0.0003016731
Actinocatenispora thailandica	227318	S	13	0	13	0.0003016731
Bacillus vini	1476025	S	13	0	13	0.0003016731
Limosilactobacillus fermentum	1613	S	13	0	13	0.0003016731
Flavobacterium sp. CLA17	2724135	S	12	1	13	0.0003016731
Flavobacterium sp. 140616W15	2478552	S	12	1	13	0.0003016731
Flavobacterium sp. I3-2	2748319	S	7	6	13	0.0003016731
Formosa agariphila	320324	S	12	1	13	0.0003016731
Urechidicola croceus	1850246	S	9	4	13	0.0003016731
Chryseobacterium bernardetii	1241978	S	6	7	13	0.0003016731
Chryseobacterium taklimakanense	536441	S	10	3	13	0.0003016731
Olivibacter sp. LS-1	2592345	S	2	11	13	0.0003016731
Lacunisphaera limnophila	1838286	S	10	3	13	0.0003016731
Polaromonas sp.	1869339	S	1	11	12	0.0002784675
Massilia umbonata	864828	S	9	3	12	0.0002784675
Collimonas pratensis	279113	S	11	1	12	0.0002784675
Undibacterium parvum	401471	S	11	1	12	0.0002784675
Pseudomonas sp. MPDS	2762896	S	7	5	12	0.0002784675
Legionella pneumophila	446	S	12	0	12	0.0002784675
Bradyrhizobium sp. CCBAU 51753	1325100	S	11	1	12	0.0002784675
Bradyrhizobium sp. WSM471	319017	S	3	9	12	0.0002784675
Bradyrhizobium betae	244734	S	8	4	12	0.0002784675
Rhizobium ruizarguesonis	2081791	S	4	8	12	0.0002784675
Mesorhizobium sp. Pch-S	2082387	S	12	0	12	0.0002784675
Mesorhizobium sp. M8A.F.Ca.ET.057.01.1.1	2493679	S	10	2	12	0.0002784675
Mesorhizobium sp. M1B.F.Ca.ET.045.04.1.1	2493673	S	10	2	12	0.0002784675
Mesorhizobium sp. L-8-10	2744523	S	4	8	12	0.0002784675
Hyphomicrobium nitrativorans	1427356	S	12	0	12	0.0002784675
Sphingomonas panacis	1560345	S	12	0	12	0.0002784675
Sphingopyxis sp. FD7	1914525	S	9	3	12	0.0002784675
Sphingosinicella sp. BN140058	1892855	S	12	0	12	0.0002784675
Azospirillum brasilense	192	S	9	3	12	0.0002784675
Anaeromyxobacter dehalogenans	161493	S	9	3	12	0.0002784675
Propionibacterium freudenreichii	1744	S	11	1	12	0.0002784675
Nocardioides sp. zg-579	2663857	S	11	1	12	0.0002784675
Pimelobacter simplex	2045	S	11	1	12	0.0002784675
Arthrobacter sp. D5-1	1477518	S	10	2	12	0.0002784675
Microbacterium foliorum	104336	S	11	1	12	0.0002784675
Brevibacterium linens	1703	S	11	1	12	0.0002784675
Corynebacterium anserum	2684406	S	12	0	12	0.0002784675
Corynebacterium kroppenstedtii	161879	S	12	0	12	0.0002784675
Corynebacterium urealyticum	43771	S	10	2	12	0.0002784675
Corynebacterium amycolatum	43765	S	3	9	12	0.0002784675
Corynebacterium glutamicum	1718	S	2	10	12	0.0002784675
Gordonia sp. KTR9	337191	S	11	1	12	0.0002784675
Gordonia insulae	2420509	S	12	0	12	0.0002784675
Nakamurella multipartita	53461	S	12	0	12	0.0002784675
Bacillus velezensis	492670	S	6	6	12	0.0002784675
Deinococcus actinosclerus	1768108	S	8	4	12	0.0002784675
Flavobacterium johnsoniae	986	S	10	2	12	0.0002784675
Chryseobacterium indoltheticum	254	S	11	1	12	0.0002784675
Chryseobacterium aureum	2497456	S	11	1	12	0.0002784675
Kaistella carnis	1241979	S	10	2	12	0.0002784675
Chryseobacterium haifense	421525	S	5	7	12	0.0002784675
Spirosoma pollinicola	2057025	S	12	0	12	0.0002784675
Hymenobacter sp. PAMC 26554	1484116	S	12	0	12	0.0002784675
Hymenobacter busanensis	2607656	S	12	0	12	0.0002784675
Flavihumibacter sp. SB-02	2676868	S	12	0	12	0.0002784675
Paludisphaera borealis	1387353	S	11	1	12	0.0002784675
Fusobacterium sp. oral taxon 203	671211	S	5	7	12	0.0002784675
Comamonas koreensis	160825	S	10	1	11	0.0002552619
Hylemonella gracilis	80880	S	11	0	11	0.0002552619
Cupriavidus necator	106590	S	10	1	11	0.0002552619
Polynucleobacter necessarius	576610	S	11	0	11	0.0002552619
Inhella inkyongensis	392593	S	11	0	11	0.0002552619
Azospira oryzae	146939	S	6	5	11	0.0002552619
Pseudomonas moraviensis	321662	S	8	3	11	0.0002552619
Pseudoxanthomonas suwonensis	314722	S	11	0	11	0.0002552619
Vibrio parahaemolyticus	670	S	10	1	11	0.0002552619
Bradyrhizobium sp. CCBAU 53340	1325112	S	7	4	11	0.0002552619
Bradyrhizobium japonicum	375	S	6	5	11	0.0002552619
Labrys sp. KNU-23	2789216	S	11	0	11	0.0002552619
[Ochrobactrum] quorumnocens	271865	S	11	0	11	0.0002552619
Ochrobactrum sp. MT180101	2726427	S	3	8	11	0.0002552619
Sphingomonas sp. LMO-1	2681549	S	11	0	11	0.0002552619
Sphingomonas sp. DH-S5	2759526	S	11	0	11	0.0002552619
Sphingomonas sp. LK11	1390395	S	10	1	11	0.0002552619
Novosphingobium ginsenosidimutans	1176536	S	11	0	11	0.0002552619
Sphingosinithalassobacter sp. zrk23	2711215	S	10	1	11	0.0002552619
Sulfitobacter pseudonitzschiae	1402135	S	9	2	11	0.0002552619
Brevundimonas sp. 'scallop'	2562582	S	6	5	11	0.0002552619
Nitrospirillum amazonense	28077	S	11	0	11	0.0002552619
Sandaracinus amylolyticus	927083	S	11	0	11	0.0002552619
Haliangium ochraceum	80816	S	11	0	11	0.0002552619
Nocardioides sp. zg-1228	2763008	S	10	1	11	0.0002552619
Rhodococcus sp. 008	1723645	S	2	9	11	0.0002552619
Corynebacterium variabile	1727	S	10	1	11	0.0002552619
Gordonia sp. YC-JH1	2059875	S	8	3	11	0.0002552619
Dietzia psychralcaliphila	139021	S	11	0	11	0.0002552619
Streptomyces chartreusis	1969	S	11	0	11	0.0002552619
Pseudonocardia sp. HH130629-09	1641402	S	5	6	11	0.0002552619
Actinoalloteichus hymeniacidonis	340345	S	5	6	11	0.0002552619
Micromonospora aurantiaca	47850	S	3	8	11	0.0002552619
Actinomarinicola tropica	2789776	S	11	0	11	0.0002552619
Conexibacter sp. SYSU D00693	2812560	S	10	1	11	0.0002552619
Paenibacillus polymyxa	1406	S	4	7	11	0.0002552619
Streptococcus sanguinis	1305	S	11	0	11	0.0002552619
Lactobacillus delbrueckii	1584	S	11	0	11	0.0002552619
Lactobacillus helveticus	1587	S	10	1	11	0.0002552619
Clostridium saccharoperbutylacetonicum	36745	S	11	0	11	0.0002552619
Anaerostipes hadrus	649756	S	9	2	11	0.0002552619
Nostoc sp. PCC 7524	28072	S	9	2	11	0.0002552619
Anabaena sp. 90	46234	S	1	10	11	0.0002552619
Dolichospermum compactum	136073	S	5	6	11	0.0002552619
Flavobacterium sp. BB8	2816357	S	10	1	11	0.0002552619
Flavobacterium indicum	312277	S	11	0	11	0.0002552619
Flavobacterium gilvum	1492737	S	11	0	11	0.0002552619
Flavobacterium crocinum	2183896	S	9	2	11	0.0002552619
Polaribacter sp. SA4-12	1312072	S	10	1	11	0.0002552619
Chryseobacterium sp. NBC 122	2547600	S	11	0	11	0.0002552619
Chryseobacterium sp. G0162	2487063	S	6	5	11	0.0002552619
Elizabethkingia anophelis	1117645	S	3	8	11	0.0002552619
Cytophaga hutchinsonii	985	S	11	0	11	0.0002552619
Aquirufa nivalisilvae	2516557	S	11	0	11	0.0002552619
Hymenobacter sp. BRD128	2675878	S	11	0	11	0.0002552619
Bernardetia litoralis	999	S	11	0	11	0.0002552619
Solitalea canadensis	995	S	11	0	11	0.0002552619
Bacteroides fragilis	817	S	6	5	11	0.0002552619
Gemmatimonas sp. TET16	2732249	S	11	0	11	0.0002552619
Gemmatirosa kalamazoonesis	861299	S	11	0	11	0.0002552619
Planctomyces sp. SH-PL14	1632864	S	11	0	11	0.0002552619
Rosistilla oblonga	2527990	S	9	2	11	0.0002552619
Anatilimnocola aggregata	2528021	S	10	1	11	0.0002552619
Tautonia plasticadhaerens	2527974	S	11	0	11	0.0002552619
Humisphaera borealis	2807512	S	11	0	11	0.0002552619
Comamonas serinivorans	1082851	S	10	0	10	0.0002320563
Polaromonas vacuolata	37448	S	9	1	10	0.0002320563
Serpentinomonas raichei	1458425	S	8	2	10	0.0002320563
Ralstonia pickettii	329	S	9	1	10	0.0002320563
Collimonas fungivorans	158899	S	10	0	10	0.0002320563
Achromobacter deleyi	1353891	S	5	5	10	0.0002320563
Bordetella genomosp. 9	1416803	S	10	0	10	0.0002320563
Bordetella bronchiseptica	518	S	5	5	10	0.0002320563
Pigmentiphaga sp. H8	2488560	S	10	0	10	0.0002320563
Pseudogulbenkiania sp. NH8B	748280	S	9	1	10	0.0002320563
Nitrosomonas sp. Is79A3	261292	S	10	0	10	0.0002320563
Pseudomonas sp. CC6-YY-74	1930532	S	10	0	10	0.0002320563
Pseudomonas mendocina	300	S	9	1	10	0.0002320563
Pseudomonas koreensis	198620	S	9	1	10	0.0002320563
Acinetobacter sp. WCHA45	2004644	S	7	3	10	0.0002320563
Enterobacter cloacae complex sp. FDA-CDC-AR_0164	2077136	S	2	8	10	0.0002320563
Dokdonella koreensis	323415	S	10	0	10	0.0002320563
Bradyrhizobium sp. SG09	2599805	S	1	9	10	0.0002320563
Bradyrhizobium oligotrophicum	44255	S	9	1	10	0.0002320563
Bradyrhizobium cosmicum	1404864	S	8	2	10	0.0002320563
Bosea sp. AS-1	2015316	S	9	1	10	0.0002320563
Shinella sp. PSBB067	2715959	S	8	2	10	0.0002320563
Kaistia sp. 32K	2795690	S	9	1	10	0.0002320563
Aminobacter sp. MSH1	374606	S	8	2	10	0.0002320563
Xanthobacter sp. YN2	2528964	S	9	1	10	0.0002320563
Aureimonas sp. AU20	1349819	S	10	0	10	0.0002320563
Sphingomonas sp. SH	849864	S	1	9	10	0.0002320563
Sphingomonas wittichii	160791	S	8	2	10	0.0002320563
Tardibacter chloracetimidivorans	1921510	S	6	4	10	0.0002320563
Tsuneonella flava	2055955	S	8	2	10	0.0002320563
Paracoccus mutanolyticus	1499308	S	4	6	10	0.0002320563
Rhodobacter capsulatus	1061	S	9	1	10	0.0002320563
Celeribacter manganoxidans	1411902	S	9	1	10	0.0002320563
Roseovarius indicus	540747	S	7	3	10	0.0002320563
Caulobacter sp. FWC26	69665	S	8	2	10	0.0002320563
Caulobacter flavus	1679497	S	9	1	10	0.0002320563
Caulobacter segnis	88688	S	8	2	10	0.0002320563
Terricaulis silvestris	2686094	S	10	0	10	0.0002320563
Corallococcus coralloides	184914	S	9	1	10	0.0002320563
Corallococcus macrosporus	35	S	6	4	10	0.0002320563
Bdellovibrio bacteriovorus	959	S	10	0	10	0.0002320563
Microlunatus sagamiharensis	546874	S	10	0	10	0.0002320563
Nocardioides sp. dk884	2662361	S	7	3	10	0.0002320563
Rhodococcus sp. PBTS 2	1653479	S	7	3	10	0.0002320563
Streptomyces sp. So13.3	2136173	S	10	0	10	0.0002320563
Streptomyces globosus	68209	S	10	0	10	0.0002320563
Streptomyces vietnamensis	362257	S	10	0	10	0.0002320563
Streptomyces bingchenggensis	379067	S	10	0	10	0.0002320563
Amycolatopsis sp. Hca4	2742131	S	10	0	10	0.0002320563
Lentzea guizhouensis	1586287	S	10	0	10	0.0002320563
Plantactinospora sp. BC1	2108470	S	6	4	10	0.0002320563
Ilumatobacter coccineus	467094	S	10	0	10	0.0002320563
Staphylococcus pasteuri	45972	S	9	1	10	0.0002320563
Lacticaseibacillus paracasei	1597	S	6	4	10	0.0002320563
Leuconostoc mesenteroides	1245	S	10	0	10	0.0002320563
Clostridium intestinale	36845	S	10	0	10	0.0002320563
Clostridioides difficile	1496	S	6	4	10	0.0002320563
Calothrix brevissima	938406	S	7	3	10	0.0002320563
Dolichospermum sp. UHCC 0315A	1914871	S	1	9	10	0.0002320563
Flavobacterium crassostreae	1763534	S	9	1	10	0.0002320563
Olleya sp. Bg11-27	2058135	S	5	5	10	0.0002320563
Zunongwangia profunda	398743	S	6	4	10	0.0002320563
Chryseobacterium arthrosphaerae	651561	S	7	3	10	0.0002320563
Hymenobacter nivis	1850093	S	9	1	10	0.0002320563
Sphingobacterium spiritivorum	258	S	7	3	10	0.0002320563
Chitinophaga sp. 1303	2725414	S	2	8	10	0.0002320563
Niastella koreensis	354356	S	10	0	10	0.0002320563
Alistipes onderdonkii	328813	S	9	1	10	0.0002320563
Gimesia panareensis	2527978	S	10	0	10	0.0002320563
Fusobacterium nucleatum	851	S	7	3	10	0.0002320563
Ottowia sp. oral taxon 894	1658672	S	9	0	9	0.0002088506
Paraburkholderia caribensis	75105	S	7	2	9	0.0002088506
Herbaspirillum robiniae	2014887	S	8	1	9	0.0002088506
Herbaspirillum seropedicae	964	S	7	2	9	0.0002088506
Herbaspirillum huttiense	863372	S	7	2	9	0.0002088506
Bordetella parapertussis	519	S	3	6	9	0.0002088506
Azoarcus sp. CIB	198107	S	6	3	9	0.0002088506
Denitratisoma sp. DHT3	1981880	S	7	2	9	0.0002088506
Pseudomonas sp. phDV1	253237	S	4	5	9	0.0002088506
Pseudomonas syringae	317	S	6	3	9	0.0002088506
Pseudomonas brassicacearum	930166	S	4	5	9	0.0002088506
Pantoea sp. PSNIH1	1484158	S	8	1	9	0.0002088506
Yersinia enterocolitica	630	S	9	0	9	0.0002088506
Proteus mirabilis	584	S	8	1	9	0.0002088506
Stenotrophomonas sp. CW117	2775920	S	1	8	9	0.0002088506
Xanthomonas citri	346	S	9	0	9	0.0002088506
Rhodanobacter denitrificans	666685	S	8	1	9	0.0002088506
Shewanella baltica	62322	S	8	1	9	0.0002088506
Solimonas sp. K1W22B-7	2303331	S	9	0	9	0.0002088506
Bradyrhizobium sp. ORS 285	115808	S	8	1	9	0.0002088506
Bradyrhizobium sp. SK17	2057741	S	7	2	9	0.0002088506
Bradyrhizobium sp. CCBAU 53351	1325114	S	5	4	9	0.0002088506
Microvirga thermotolerans	2651334	S	8	1	9	0.0002088506
Mesorhizobium sp. M4B.F.Ca.ET.058.02.1.1	2493675	S	8	1	9	0.0002088506
Mesorhizobium sp. 131-2-1	2744518	S	7	2	9	0.0002088506
Hyphomicrobium sp. MC1	717785	S	9	0	9	0.0002088506
Ancylobacter sp. TS-1	1850374	S	8	1	9	0.0002088506
Aureimonas sp. OT7	2816454	S	6	3	9	0.0002088506
Sphingomonas sp. C33	2698679	S	9	0	9	0.0002088506
Sphingobium sp. RAC03	1843368	S	9	0	9	0.0002088506
Sphingopyxis lindanitolerans	2054227	S	7	2	9	0.0002088506
Novosphingobium sp. THN1	1016987	S	9	0	9	0.0002088506
Allosphingosinicella indica	941907	S	9	0	9	0.0002088506
Erythrobacter sp. 6D36	2782568	S	9	0	9	0.0002088506
Ruegeria pomeroyi	89184	S	9	0	9	0.0002088506
Phenylobacterium zucineum	284016	S	8	1	9	0.0002088506
Phreatobacter cathodiphilus	1868589	S	9	0	9	0.0002088506
Nocardioides aromaticivorans	200618	S	8	1	9	0.0002088506
Arthrobacter sp. ZXY-2	1806905	S	1	8	9	0.0002088506
Rothia dentocariosa	2047	S	8	1	9	0.0002088506
Microbacterium paraoxydans	199592	S	1	8	9	0.0002088506
Leifsonia xyli	1575	S	8	1	9	0.0002088506
Clavibacter michiganensis	28447	S	9	0	9	0.0002088506
Frigoribacterium sp. NBH87	2596916	S	9	0	9	0.0002088506
Brachybacterium ginsengisoli	1331682	S	9	0	9	0.0002088506
Nocardia farcinica	37329	S	8	1	9	0.0002088506
Corynebacterium ureicelerivorans	401472	S	9	0	9	0.0002088506
Corynebacterium testudinoris	136857	S	9	0	9	0.0002088506
Mycolicibacterium aurum	1791	S	9	0	9	0.0002088506
Mycobacteroides abscessus	36809	S	9	0	9	0.0002088506
Streptomyces antimycoticus	68175	S	9	0	9	0.0002088506
Streptacidiphilus bronchialis	2126346	S	9	0	9	0.0002088506
Pseudonocardia broussonetiae	2736640	S	8	1	9	0.0002088506
Saccharothrix syringae	103733	S	9	0	9	0.0002088506
Actinoplanes missouriensis	1866	S	8	1	9	0.0002088506
Phytohabitans suffuscus	624315	S	8	1	9	0.0002088506
Actinomadura sp. WMMA1423	2591108	S	9	0	9	0.0002088506
Streptococcus oralis	1303	S	8	1	9	0.0002088506
Dolosigranulum pigrum	29394	S	9	0	9	0.0002088506
Clostridium pasteurianum	1501	S	9	0	9	0.0002088506
Veillonella parvula	29466	S	9	0	9	0.0002088506
Flavobacterium branchiophilum	55197	S	9	0	9	0.0002088506
Flavobacterium haoranii	683124	S	8	1	9	0.0002088506
Polaribacter sp. ALD11	2058137	S	8	1	9	0.0002088506
Formosa sp. Hel1_31_208	1798225	S	9	0	9	0.0002088506
Winogradskyella schleiferi	2686078	S	6	3	9	0.0002088506
Algibacter sp. L3A6	2686366	S	7	2	9	0.0002088506
Mariniflexile sp. TRM1-10	2027857	S	9	0	9	0.0002088506
Fluviicola taffensis	191579	S	9	0	9	0.0002088506
Hymenobacter sp. DG01	2584940	S	8	1	9	0.0002088506
Pedobacter heparinus	984	S	9	0	9	0.0002088506
Chitinophaga sp. MD30	2033437	S	9	0	9	0.0002088506
Arachidicoccus soli	2341117	S	9	0	9	0.0002088506
Filimonas lacunae	477680	S	9	0	9	0.0002088506
Fuerstia marisgermanicae	1891926	S	9	0	9	0.0002088506
Lacipirellula limnantheis	2528024	S	9	0	9	0.0002088506
Nibricoccus aquaticus	2576891	S	9	0	9	0.0002088506
Paludibaculum fermentans	1473598	S	9	0	9	0.0002088506
Acidovorax citrulli	80869	S	5	3	8	0.0001856450
Acidovorax ebreus	721785	S	1	7	8	0.0001856450
Diaphorobacter ruginosibacter	1715720	S	8	0	8	0.0001856450
Comamonas kerstersii	225992	S	8	0	8	0.0001856450
Comamonas piscis	1562974	S	8	0	8	0.0001856450
Burkholderia ubonensis	101571	S	5	3	8	0.0001856450
Burkholderia vietnamiensis	60552	S	4	4	8	0.0001856450
Burkholderia sp. Bp7605	1740163	S	8	0	8	0.0001856450
Paraburkholderia acidisoli	2571748	S	8	0	8	0.0001856450
Chitinimonas arctica	2594795	S	8	0	8	0.0001856450
Massilia plicata	321984	S	7	1	8	0.0001856450
Undibacterium sp. KW1	2058624	S	6	2	8	0.0001856450
Achromobacter sp. AONIH1	1758194	S	6	2	8	0.0001856450
Achromobacter pestifer	1353889	S	6	2	8	0.0001856450
Advenella mimigardefordensis	302406	S	7	1	8	0.0001856450
Azoarcus pumilus	2067960	S	8	0	8	0.0001856450
Thauera sp. K11	2005884	S	7	1	8	0.0001856450
Dechloromonas sp. HYN0024	2231055	S	7	1	8	0.0001856450
Chromobacterium violaceum	536	S	7	1	8	0.0001856450
Neisseria meningitidis	487	S	4	4	8	0.0001856450
Pseudomonas orientalis	76758	S	7	1	8	0.0001856450
Pseudomonas gozinkensis	2774461	S	7	1	8	0.0001856450
Pseudomonas atacamensis	2565368	S	5	3	8	0.0001856450
Azotobacter chroococcum	353	S	7	1	8	0.0001856450
Acinetobacter sp. MYb10	1827285	S	8	0	8	0.0001856450
Enterobacter ludwigii	299767	S	3	5	8	0.0001856450
Lelliottia amnigena	61646	S	8	0	8	0.0001856450
Erwinia gerundensis	1619313	S	8	0	8	0.0001856450
Candidatus Erwinia haradaeae	1922217	S	8	0	8	0.0001856450
Yersinia intermedia	631	S	3	5	8	0.0001856450
Rahnella aquatilis	34038	S	4	4	8	0.0001856450
Stenotrophomonas sp. LM091	1904944	S	8	0	8	0.0001856450
Xanthomonas hyacinthi	56455	S	8	0	8	0.0001856450
Luteimonas sp. MC1750	2799326	S	8	0	8	0.0001856450
Thermomonas carbonis	1463158	S	8	0	8	0.0001856450
Shewanella sp. Scap07	2589987	S	8	0	8	0.0001856450
Halomonas campisalis	74661	S	2	6	8	0.0001856450
Aeromonas sp. CU5	2033033	S	7	1	8	0.0001856450
Bradyrhizobium sp. 1(2017)	1404888	S	7	1	8	0.0001856450
Bradyrhizobium canariense	255045	S	8	0	8	0.0001856450
Variibacter gotjawalensis	1333996	S	8	0	8	0.0001856450
Afipia sp. GAS231	1882747	S	4	4	8	0.0001856450
Methylobacterium sp. 17Sr1-1	2202826	S	7	1	8	0.0001856450
Microvirga ossetica	1882682	S	8	0	8	0.0001856450
Agrobacterium vitis	373	S	8	0	8	0.0001856450
Agrobacterium rhizogenes	359	S	5	3	8	0.0001856450
Mesorhizobium sp. 131-2-5	2744519	S	1	7	8	0.0001856450
Blastochloris tepida	2233851	S	7	1	8	0.0001856450
Stappia indica	538381	S	7	1	8	0.0001856450
Sphingomonas sp. LM7	1938607	S	8	0	8	0.0001856450
Sphingobium herbicidovorans	76947	S	6	2	8	0.0001856450
Novosphingobium sp. Gsoil 351	2675225	S	8	0	8	0.0001856450
Novosphingobium sp. ES2-1	2780074	S	7	1	8	0.0001856450
Erythrobacter neustonensis	1112	S	8	0	8	0.0001856450
Porphyrobacter sp. CACIAM 03H1	2003315	S	7	1	8	0.0001856450
Paracoccus aminophilus	34003	S	8	0	8	0.0001856450
Paracoccus contaminans	1945662	S	8	0	8	0.0001856450
Polymorphum gilvum	991904	S	8	0	8	0.0001856450
Confluentimicrobium sp. EMB200-NS6	1609966	S	5	3	8	0.0001856450
Brevundimonas sp. M20	2591463	S	8	0	8	0.0001856450
Roseococcus sp. NIBR12	2771361	S	8	0	8	0.0001856450
Hyphomonas sp. KY3	2016196	S	8	0	8	0.0001856450
Archangium gephyra	48	S	7	1	8	0.0001856450
Acidithiobacillus ferrivorans	160808	S	8	0	8	0.0001856450
Tessaracoccus flavescens	399497	S	6	2	8	0.0001856450
Nocardioides sp. S5	2017486	S	7	1	8	0.0001856450
Nocardioides anomalus	2712223	S	8	0	8	0.0001856450
Marmoricola scoriae	642780	S	8	0	8	0.0001856450
Arthrobacter sp. Rue61a	1118963	S	3	5	8	0.0001856450
Arthrobacter agilis	37921	S	8	0	8	0.0001856450
Microbacterium sp. 10M-3C3	2483401	S	7	1	8	0.0001856450
Microbacterium oleivorans	273677	S	8	0	8	0.0001856450
Rathayibacter sp. VKM Ac-2804	2609257	S	5	3	8	0.0001856450
Microterricola viridarii	412690	S	8	0	8	0.0001856450
Humibacter sp. BT305	2282656	S	2	6	8	0.0001856450
Rhodococcus sp. PBTS 1	1653478	S	8	0	8	0.0001856450
Nocardia sp. WCH-YHL-001	2755382	S	8	0	8	0.0001856450
Nocardia seriolae	37332	S	8	0	8	0.0001856450
Corynebacterium sp. zg-320	2768834	S	8	0	8	0.0001856450
Mycobacteroides salmoniphilum	404941	S	8	0	8	0.0001856450
Gordonia alkanivorans	84096	S	3	5	8	0.0001856450
Streptomyces sp. SAT1	1849967	S	8	0	8	0.0001856450
Streptomyces sp. SCUT-3	2684469	S	8	0	8	0.0001856450
Streptomyces actuosus	1885	S	8	0	8	0.0001856450
Streptomyces tendae	1932	S	8	0	8	0.0001856450
Pseudonocardia sp. CGMCC 4.1532	2761535	S	7	1	8	0.0001856450
Kutzneria albida	43357	S	8	0	8	0.0001856450
Micromonospora echinaurantiaca	47857	S	8	0	8	0.0001856450
Nonomuraea sp. ATCC 55076	1909395	S	8	0	8	0.0001856450
Stackebrandtia nassauensis	283811	S	8	0	8	0.0001856450
Staphylococcus haemolyticus	1283	S	8	0	8	0.0001856450
Lactiplantibacillus plantarum	1590	S	5	3	8	0.0001856450
Clostridium sporogenes	1509	S	3	5	8	0.0001856450
Romboutsia ilealis	1115758	S	8	0	8	0.0001856450
Fischerella sp. NIES-4106	2005456	S	7	1	8	0.0001856450
Chamaesiphon minutus	1173032	S	8	0	8	0.0001856450
Microcystis sp. MC19	1967666	S	7	1	8	0.0001856450
Flavobacterium commune	1306519	S	8	0	8	0.0001856450
Flavobacterium nitrogenifigens	1617283	S	6	2	8	0.0001856450
Flavobacterium sediminis	2201181	S	5	3	8	0.0001856450
Polaribacter sp. KT25b	1855336	S	8	0	8	0.0001856450
Myroides odoratus	256	S	8	0	8	0.0001856450
Maribacter sp. 1_2014MBL_MicDiv	1644130	S	2	6	8	0.0001856450
Chryseobacterium sp. T16E-39	2015076	S	8	0	8	0.0001856450
Empedobacter falsenii	343874	S	6	2	8	0.0001856450
Riemerella anatipestifer	34085	S	8	0	8	0.0001856450
Runella sp. SP2	2268026	S	8	0	8	0.0001856450
Rhodocytophaga rosea	2704465	S	8	0	8	0.0001856450
Mucilaginibacter celer	2305508	S	8	0	8	0.0001856450
Arachidicoccus sp. BS20	1850526	S	6	2	8	0.0001856450
Flavisolibacter tropicus	1492898	S	7	1	8	0.0001856450
Phocaeicola dorei	357276	S	5	3	8	0.0001856450
Paludibacter propionicigenes	185300	S	8	0	8	0.0001856450
Caulifigura coniformis	2527983	S	8	0	8	0.0001856450
Pirellula sp. SH-Sr6A	1632865	S	8	0	8	0.0001856450
Aquisphaera giovannonii	406548	S	8	0	8	0.0001856450
Borrelia miyamotoi	47466	S	8	0	8	0.0001856450
Terriglobus roseus	392734	S	8	0	8	0.0001856450
Flavobacterium phage vB_FspS_mymlan6-1	2686266	S	3	5	8	0.0001856450
Limnohabitans sp. 103DPR2	1678129	S	7	0	7	0.0001624394
Ralstonia mannitolilytica	105219	S	6	1	7	0.0001624394
Cupriavidus pinatubonensis	248026	S	6	1	7	0.0001624394
Polynucleobacter duraquae	1835254	S	7	0	7	0.0001624394
Thiomonas arsenitoxydans	426114	S	2	5	7	0.0001624394
Bordetella pseudohinzii	1331258	S	6	1	7	0.0001624394
Azospira restricta	404405	S	7	0	7	0.0001624394
Azoarcus sp. DD4	2027405	S	5	2	7	0.0001624394
Azoarcus olearius	418699	S	6	1	7	0.0001624394
Thauera sp. MZ1T	85643	S	6	1	7	0.0001624394
Dechloromonas sp. TW-R-39-2	2654218	S	6	1	7	0.0001624394
Jeongeupia sp. USM3	1906741	S	6	1	7	0.0001624394
Vitreoscilla filiformis	63	S	7	0	7	0.0001624394
Methylotenera mobilis	359408	S	7	0	7	0.0001624394
Casimicrobium huifangae	2591109	S	7	0	7	0.0001624394
Pseudomonas sp. S1-A32-2	2731681	S	7	0	7	0.0001624394
Pseudomonas sp. SXM-1	2169583	S	3	4	7	0.0001624394
Pseudomonas sp. CFSAN084952	2664899	S	2	5	7	0.0001624394
Pseudomonas libanensis	75588	S	4	3	7	0.0001624394
Pseudomonas fulva	47880	S	7	0	7	0.0001624394
Pseudomonas oleovorans	301	S	3	4	7	0.0001624394
Pseudomonas yamanorum	515393	S	7	0	7	0.0001624394
Pseudomonas denitrificans (nom. rej.)	43306	S	7	0	7	0.0001624394
Pseudomonas bijieensis	2681983	S	2	5	7	0.0001624394
Acinetobacter sp. NEB 394	2743575	S	4	3	7	0.0001624394
Acinetobacter venetianus	52133	S	7	0	7	0.0001624394
Acinetobacter indicus	756892	S	6	1	7	0.0001624394
Raoultella terrigena	577	S	4	3	7	0.0001624394
Leclercia adecarboxylata	83655	S	3	4	7	0.0001624394
Xanthomonas translucens	343	S	7	0	7	0.0001624394
Xanthomonas arboricola	56448	S	5	2	7	0.0001624394
Lysobacter antibioticus	84531	S	7	0	7	0.0001624394
Luteimonas sp. YGD11-2	2508168	S	7	0	7	0.0001624394
Luteimonas chenhongjianii	2006110	S	7	0	7	0.0001624394
Halomonas sp. THAF5a	2587844	S	7	0	7	0.0001624394
Vibrio coralliilyticus	190893	S	6	1	7	0.0001624394
Aeromonas hydrophila	644	S	4	3	7	0.0001624394
Bradyrhizobium sp. PSBB068	2715960	S	6	1	7	0.0001624394
Bradyrhizobium sp. CCBAU 53421	1325120	S	6	1	7	0.0001624394
Bradyrhizobium sp. 6(2017)	1197460	S	6	1	7	0.0001624394
Bradyrhizobium arachidis	858423	S	6	1	7	0.0001624394
Bradyrhizobium vignae	1549949	S	6	1	7	0.0001624394
Microvirga sp. 17 mud 1-3	2082949	S	7	0	7	0.0001624394
Rhizobium daejeonense	240521	S	6	1	7	0.0001624394
Rhizobium rosettiformans	1368430	S	5	2	7	0.0001624394
Mesorhizobium loti	381	S	3	4	7	0.0001624394
Hoeflea sp. IMCC20628	1620421	S	7	0	7	0.0001624394
Devosia sp. S02	2657486	S	7	0	7	0.0001624394
Aquabacter sp. L1I39	2820278	S	7	0	7	0.0001624394
Starkeya novella	921	S	6	1	7	0.0001624394
Azorhizobium caulinodans	7	S	7	0	7	0.0001624394
Martelella sp. AD-3	686597	S	4	3	7	0.0001624394
Methylocella tundrae	227605	S	7	0	7	0.0001624394
Sphingobium chlorophenolicum	46429	S	6	1	7	0.0001624394
Sphingobium baderi	1332080	S	4	3	7	0.0001624394
Sphingopyxis alaskensis	117207	S	6	1	7	0.0001624394
Novosphingobium sp. P6W	1609758	S	7	0	7	0.0001624394
Novosphingobium sp. ABRDHK2	2571749	S	6	1	7	0.0001624394
Sphingorhabdus sp. YGSMI21	2077182	S	6	1	7	0.0001624394
Rhizorhabdus dicambivorans	1850238	S	4	3	7	0.0001624394
Qipengyuania flava	192812	S	5	2	7	0.0001624394
Brevirhabdus pacifica	1267768	S	5	2	7	0.0001624394
Brevundimonas sp. DS20	1532555	S	3	4	7	0.0001624394
Roseomonas sp. 1318	2768161	S	7	0	7	0.0001624394
Desulfonema magnum	45655	S	7	0	7	0.0001624394
Malaciobacter mytili	603050	S	5	2	7	0.0001624394
Poseidonibacter parvus	1850254	S	1	6	7	0.0001624394
Campylobacter armoricus	2505970	S	6	1	7	0.0001624394
Helicobacter pylori	210	S	7	0	7	0.0001624394
Microlunatus phosphovorus	29405	S	7	0	7	0.0001624394
Tessaracoccus defluvii	1285901	S	6	1	7	0.0001624394
Arthrobacter sp. YN	2020486	S	7	0	7	0.0001624394
Arthrobacter alpinus	656366	S	6	1	7	0.0001624394
Microbacterium sp. NY27	2782169	S	7	0	7	0.0001624394
Cnuibacter physcomitrellae	1619308	S	2	5	7	0.0001624394
Janibacter melonis	262209	S	7	0	7	0.0001624394
Brevibacterium sp. o2	2697565	S	7	0	7	0.0001624394
Brevibacterium casei	33889	S	7	0	7	0.0001624394
Haloactinobacterium sp. HY164	2675754	S	7	0	7	0.0001624394
Nocardia asteroides	1824	S	7	0	7	0.0001624394
Nocardia arthritidis	228602	S	7	0	7	0.0001624394
Corynebacterium sp. L2-79-05	373068	S	1	6	7	0.0001624394
Corynebacterium matruchotii	43768	S	7	0	7	0.0001624394
Mycolicibacterium smegmatis	1772	S	7	0	7	0.0001624394
Mycolicibacterium pulveris	36813	S	7	0	7	0.0001624394
Mycolicibacterium vaccae	1810	S	7	0	7	0.0001624394
Mycolicibacterium confluentis	28047	S	7	0	7	0.0001624394
Mycobacterium paraseoulense	590652	S	7	0	7	0.0001624394
Mycobacterium shinjukuense	398694	S	7	0	7	0.0001624394
Mycobacterium paragordonae	1389713	S	7	0	7	0.0001624394
Mycobacterium cookii	1775	S	7	0	7	0.0001624394
Dietzia lutea	546160	S	7	0	7	0.0001624394
Streptomyces sp. MBT27	1488356	S	7	0	7	0.0001624394
Streptomyces sp. NA02950	2742137	S	7	0	7	0.0001624394
Streptomyces sp. 2323.1	1938841	S	7	0	7	0.0001624394
Streptomyces lincolnensis	1915	S	7	0	7	0.0001624394
Streptomyces exfoliatus	1905	S	7	0	7	0.0001624394
Streptomyces rapamycinicus	1226757	S	7	0	7	0.0001624394
Streptomyces griseocarneus	51201	S	7	0	7	0.0001624394
Streptomyces ambofaciens	1889	S	7	0	7	0.0001624394
Streptomyces parvulus	146923	S	7	0	7	0.0001624394
Kitasatospora sp. NA04385	2742135	S	6	1	7	0.0001624394
Kitasatospora setae	2066	S	6	1	7	0.0001624394
Streptacidiphilus sp. P02-A3a	2704468	S	7	0	7	0.0001624394
Amycolatopsis albispora	1804986	S	6	1	7	0.0001624394
Amycolatopsis keratiniphila	129921	S	5	2	7	0.0001624394
Kibdelosporangium phytohabitans	860235	S	7	0	7	0.0001624394
Gardnerella vaginalis	2702	S	5	2	7	0.0001624394
Frankia sp. EAN1pec	298653	S	7	0	7	0.0001624394
Frankia inefficax	298654	S	7	0	7	0.0001624394
Modestobacter marinus	477641	S	7	0	7	0.0001624394
Jiangella sp. DSM 45060	1798224	S	7	0	7	0.0001624394
Catenulispora acidiphila	304895	S	7	0	7	0.0001624394
Collinsella aerofaciens	74426	S	6	1	7	0.0001624394
Conexibacter woesei	191495	S	7	0	7	0.0001624394
Bacillus luti	2026191	S	6	1	7	0.0001624394
Bacillus sp. Y1	352858	S	7	0	7	0.0001624394
Geobacillus sp. 46C-IIa	1963025	S	2	5	7	0.0001624394
Streptococcus salivarius	1304	S	6	1	7	0.0001624394
Streptococcus pneumoniae	1313	S	3	4	7	0.0001624394
Candidatus Arthromitus sp. SFB-rat-Yit	1041504	S	5	2	7	0.0001624394
Nostoc edaphicum	264686	S	6	1	7	0.0001624394
Chroococcidiopsis thermalis	54299	S	7	0	7	0.0001624394
Flavobacterium sp. CS20	2775246	S	6	1	7	0.0001624394
Flavobacterium faecale	1355330	S	7	0	7	0.0001624394
Polaribacter sp. L12M9	2738844	S	6	1	7	0.0001624394
Polaribacter vadi	1774273	S	7	0	7	0.0001624394
Tenacibaculum sp. DSM 106434	2358479	S	6	1	7	0.0001624394
Tenacibaculum todarodis	1850252	S	6	1	7	0.0001624394
Aquimarina sp. BL5	1714860	S	7	0	7	0.0001624394
Kordia sp. SMS9	2282170	S	7	0	7	0.0001624394
Lutibacter profundi	1622118	S	7	0	7	0.0001624394
Chryseobacterium carnipullorum	1124835	S	6	1	7	0.0001624394
Elizabethkingia bruuniana	1756149	S	2	5	7	0.0001624394
Spirosoma endbachense	2666025	S	6	1	7	0.0001624394
Runella sp. HYN0085	2259595	S	7	0	7	0.0001624394
Runella slithyformis	106	S	7	0	7	0.0001624394
Fibrella aestuarina	651143	S	7	0	7	0.0001624394
Adhaeribacter swui	2086471	S	7	0	7	0.0001624394
Pedobacter sp. eg	2201271	S	7	0	7	0.0001624394
Sphingobacterium sp. dk4302	2662364	S	7	0	7	0.0001624394
Sphingobacterium daejeonense	371142	S	7	0	7	0.0001624394
Sphingobacterium lactis	797291	S	5	2	7	0.0001624394
Pseudocnuella soli	2502779	S	7	0	7	0.0001624394
Bacteroides ovatus	28116	S	4	3	7	0.0001624394
Rubinisphaera brasiliensis	119	S	7	0	7	0.0001624394
Stieleria maiorica	2795974	S	6	1	7	0.0001624394
Verrucomicrobium sp. GAS474	1882831	S	6	1	7	0.0001624394
Borrelia crocidurae	29520	S	7	0	7	0.0001624394
Fusobacterium varium	856	S	7	0	7	0.0001624394
Candidatus Koribacter versatilis	658062	S	7	0	7	0.0001624394
Luteitalea pratensis	1855912	S	7	0	7	0.0001624394
Streptococcus phage SpSL1	1566990	S	6	1	7	0.0001624394
Flavobacterium phage vB_FspS_hattifnatt9-1	2686246	S	6	1	7	0.0001624394
Burkholderia thailandensis	57975	S	6	0	6	0.0001392338
Cupriavidus sp. USMAA2-4	876364	S	2	4	6	0.0001392338
Cupriavidus campinensis	151783	S	6	0	6	0.0001392338
Paraburkholderia sp. 7MH5	2547399	S	6	0	6	0.0001392338
Paraburkholderia tropica	92647	S	6	0	6	0.0001392338
Lautropia mirabilis	47671	S	6	0	6	0.0001392338
Massilia flava	871742	S	6	0	6	0.0001392338
Herbaspirillum rubrisubalbicans	80842	S	5	1	6	0.0001392338
Herbaspirillum frisingense	92645	S	5	1	6	0.0001392338
Noviherbaspirillum sp. UKPF54	2601898	S	6	0	6	0.0001392338
Bordetella flabilis	463014	S	6	0	6	0.0001392338
Bordetella bronchialis	463025	S	6	0	6	0.0001392338
Bordetella genomosp. 8	1416806	S	6	0	6	0.0001392338
Aromatoleum petrolei	76116	S	6	0	6	0.0001392338
Niveibacterium sp. HC41	2811415	S	6	0	6	0.0001392338
Azoarcus communis	41977	S	6	0	6	0.0001392338
Aquaspirillum sp. LM1	1938604	S	6	0	6	0.0001392338
Neisseria elongata	495	S	5	1	6	0.0001392338
Neisseria sicca	490	S	4	2	6	0.0001392338
Methylovorus glucosotrophus	266009	S	1	5	6	0.0001392338
Sulfuriferula nivalis	2675298	S	6	0	6	0.0001392338
Sulfurimicrobium lacus	2715678	S	6	0	6	0.0001392338
Pseudomonas sp. OST1909	2777367	S	2	4	6	0.0001392338
Pseudomonas plecoglossicida	70775	S	5	1	6	0.0001392338
Pseudomonas fragi	296	S	4	2	6	0.0001392338
Pseudomonas parafulva	157782	S	6	0	6	0.0001392338
Acinetobacter guillouiae	106649	S	6	0	6	0.0001392338
Psychrobacter sp. AntiMn-1	1720344	S	4	2	6	0.0001392338
Psychrobacter sp. PRwf-1	349106	S	3	3	6	0.0001392338
Psychrobacter maritimus	256325	S	2	4	6	0.0001392338
Klebsiella aerogenes	548	S	6	0	6	0.0001392338
Enterobacter cloacae	550	S	4	2	6	0.0001392338
Pantoea sp. MSR2	2052056	S	6	0	6	0.0001392338
Serratia fonticola	47917	S	6	0	6	0.0001392338
Edwardsiella anguillarum	1821960	S	1	5	6	0.0001392338
Stenotrophomonas sp. YAU14A_MKIMI4_1	2072408	S	2	4	6	0.0001392338
Stenotrophomonas sp. 169	2770322	S	6	0	6	0.0001392338
Xanthomonas sp. LMG 31887	2775162	S	3	3	6	0.0001392338
Lysobacter sp. HDW10	2714936	S	6	0	6	0.0001392338
Lysobacter maris	1605891	S	6	0	6	0.0001392338
Luteimonas sp. MC1572	2799325	S	5	1	6	0.0001392338
Pseudoxanthomonas spadix	415229	S	6	0	6	0.0001392338
Shewanella sp. W3-18-1	351745	S	1	5	6	0.0001392338
Shewanella putrefaciens	24	S	3	3	6	0.0001392338
Pseudoalteromonas nigrifaciens	28109	S	2	4	6	0.0001392338
Alteromonas stellipolaris	233316	S	1	5	6	0.0001392338
Vibrio vulnificus	672	S	6	0	6	0.0001392338
Aeromonas sp. ASNIH1	1636606	S	1	5	6	0.0001392338
Candidatus Thiodictyon syntrophicum	1166950	S	6	0	6	0.0001392338
Sulfurifustis variabilis	1675686	S	6	0	6	0.0001392338
Bradyrhizobium genosp. L	83637	S	6	0	6	0.0001392338
Bradyrhizobium symbiodeficiens	1404367	S	5	1	6	0.0001392338
Bradyrhizobium guangxiense	1325115	S	4	2	6	0.0001392338
Rhizobium favelukesii	348824	S	6	0	6	0.0001392338
Neorhizobium sp. NCHU2750	1825976	S	6	0	6	0.0001392338
Ensifer mexicanus	375549	S	6	0	6	0.0001392338
Mesorhizobium sp. N3	675281	S	6	0	6	0.0001392338
Mesorhizobium sp. NZP2298	2483403	S	5	1	6	0.0001392338
Mesorhizobium sp. L-8-3	2744522	S	2	4	6	0.0001392338
Hyphomicrobium denitrificans	53399	S	6	0	6	0.0001392338
Methylocystis bryophila	655015	S	6	0	6	0.0001392338
Methylosinus trichosporium	426	S	6	0	6	0.0001392338
Sphingomonas sp. KC8	1030157	S	5	1	6	0.0001392338
Sphingomonas sp. C8-2	2492837	S	4	2	6	0.0001392338
Sphingobium sp. KCTC 72723	2733867	S	6	0	6	0.0001392338
Sphingobium sp. MI1205	407020	S	3	3	6	0.0001392338
Sphingorhabdus sp. SMR4y	2584094	S	5	1	6	0.0001392338
Novosphingopyxis sp. PB63	2762729	S	5	1	6	0.0001392338
Porphyrobacter sp. LM 6	1896196	S	5	1	6	0.0001392338
Tsuneonella amylolytica	2338327	S	6	0	6	0.0001392338
Sphingosinicella microcystinivorans	335406	S	6	0	6	0.0001392338
Sandaracinobacter sp. M6	2759707	S	6	0	6	0.0001392338
Paracoccus denitrificans	266	S	6	0	6	0.0001392338
Rhodobacter sp. CZR27	2033869	S	6	0	6	0.0001392338
Phaeobacter gallaeciensis	60890	S	4	2	6	0.0001392338
Silicimonas algicola	1826607	S	6	0	6	0.0001392338
Gemmobacter sp. HYN0069	2169400	S	6	0	6	0.0001392338
Pelagibaca abyssi	1250539	S	5	1	6	0.0001392338
Defluviimonas alba	1335048	S	5	1	6	0.0001392338
Sagittula sp. P11	2009329	S	4	2	6	0.0001392338
Brevundimonas sp. LM2	1938605	S	6	0	6	0.0001392338
Brevundimonas sp. GRTSA-9	2800818	S	6	0	6	0.0001392338
Brevundimonas sp. SGAir0440	2579977	S	5	1	6	0.0001392338
Caulobacter soli	2708539	S	5	1	6	0.0001392338
Acetobacter ghanensis	431306	S	6	0	6	0.0001392338
Granulibacter bethesdensis	364410	S	6	0	6	0.0001392338
Stella humosa	94	S	6	0	6	0.0001392338
Magnetospirillum sp. XM-1	1663591	S	5	1	6	0.0001392338
Hyphomonas sp. CACIAM 19H1	1873716	S	6	0	6	0.0001392338
Marinicauda algicola	2029849	S	6	0	6	0.0001392338
Pyxidicoccus sp. SCPEA002	2813578	S	6	0	6	0.0001392338
Melittangium boletus	83453	S	5	1	6	0.0001392338
Anaeromyxobacter sp. Fw109-5	404589	S	6	0	6	0.0001392338
Anaeromyxobacter sp. K	447217	S	3	3	6	0.0001392338
Chondromyces crocatus	52	S	6	0	6	0.0001392338
Pelobacter propionicus	29543	S	5	1	6	0.0001392338
Aliarcobacter butzleri	28197	S	6	0	6	0.0001392338
Bdellovibrio sp. KM01	2748865	S	6	0	6	0.0001392338
Acidipropionibacterium jensenii	1749	S	5	1	6	0.0001392338
Nocardioides sp. S-1144	2582905	S	6	0	6	0.0001392338
Nocardioides euryhalodurans	2518370	S	6	0	6	0.0001392338
Mumia sp. ZJ1417	2708082	S	6	0	6	0.0001392338
Paenarthrobacter ureafaciens	37931	S	2	4	6	0.0001392338
Citricoccus sp. SGAir0253	2567881	S	6	0	6	0.0001392338
Microbacterium sp. No. 7	1714373	S	6	0	6	0.0001392338
Microbacterium esteraromaticum	57043	S	6	0	6	0.0001392338
Chryseoglobus indicus	2750620	S	1	5	6	0.0001392338
Intrasporangium calvum	53358	S	6	0	6	0.0001392338
Cellulomonas sp. H30R-01	2704467	S	6	0	6	0.0001392338
Cellulomonas shaoxiangyii	2566013	S	6	0	6	0.0001392338
Georgenia sp. Z443	2589797	S	6	0	6	0.0001392338
Rhodococcus sp. P1Y	1302308	S	6	0	6	0.0001392338
Rhodococcus sp. 2G	1570939	S	2	4	6	0.0001392338
Rhodococcus rhodochrous	1829	S	5	1	6	0.0001392338
Rhodococcus opacus	37919	S	5	1	6	0.0001392338
Nocardia otitidiscaviarum	1823	S	6	0	6	0.0001392338
Nocardia cyriacigeorgica	135487	S	6	0	6	0.0001392338
Corynebacterium sp. zg-917	2763010	S	6	0	6	0.0001392338
Corynebacterium sp. FDAARGOS 1242	2778078	S	3	3	6	0.0001392338
Corynebacterium resistens	258224	S	5	1	6	0.0001392338
Corynebacterium casei	160386	S	5	1	6	0.0001392338
Corynebacterium crudilactis	1652495	S	5	1	6	0.0001392338
Mycolicibacterium phlei	1771	S	6	0	6	0.0001392338
Mycolicibacterium chitae	1792	S	6	0	6	0.0001392338
Mycolicibacterium psychrotolerans	216929	S	6	0	6	0.0001392338
Mycolicibacterium parafortuitum	39692	S	6	0	6	0.0001392338
Mycolicibacterium rhodesiae	36814	S	6	0	6	0.0001392338
Mycolicibacterium austroafricanum	39687	S	1	5	6	0.0001392338
Mycobacterium sp. JS623	212767	S	6	0	6	0.0001392338
Mycobacterium sp. KMS	189918	S	1	5	6	0.0001392338
Gordonia sp. PDNC005	2811424	S	6	0	6	0.0001392338
Gordonia iterans	1004901	S	6	0	6	0.0001392338
Streptomyces sp. W1SF4	2305220	S	6	0	6	0.0001392338
Streptomyces sp. SCSIO 3032	1264596	S	6	0	6	0.0001392338
Streptomyces sp. NEAU-sy36	2751189	S	6	0	6	0.0001392338
Streptomyces sp. CCM_MD2014	1561022	S	5	1	6	0.0001392338
Streptomyces sp. WAC 06738	2203210	S	4	2	6	0.0001392338
Streptomyces cattleya	29303	S	6	0	6	0.0001392338
Streptomyces galilaeus	33899	S	6	0	6	0.0001392338
Streptomyces griseorubiginosus	67304	S	6	0	6	0.0001392338
Streptomyces nodosus	40318	S	6	0	6	0.0001392338
Streptomyces buecherae	2763006	S	6	0	6	0.0001392338
Streptomyces peucetius	1950	S	6	0	6	0.0001392338
Streptomyces pratensis	1169025	S	6	0	6	0.0001392338
Streptomyces ferrugineus	1413221	S	6	0	6	0.0001392338
Kitasatospora albolonga	68173	S	5	1	6	0.0001392338
Amycolatopsis mediterranei	33910	S	6	0	6	0.0001392338
Saccharothrix sp. 6-C	2781735	S	6	0	6	0.0001392338
Saccharopolyspora erythraea	1836	S	6	0	6	0.0001392338
Micromonospora maris	1003110	S	6	0	6	0.0001392338
Micromonospora carbonacea	47853	S	6	0	6	0.0001392338
Actinoplanes teichomyceticus	1867	S	6	0	6	0.0001392338
Actinoplanes friuliensis	196914	S	6	0	6	0.0001392338
Streptosporangium sp. 'caverna'	2202249	S	6	0	6	0.0001392338
Actinomadura sp. NAK00032	2742128	S	6	0	6	0.0001392338
Frankia sp. QA3	710111	S	5	1	6	0.0001392338
Frankia alni	1859	S	5	1	6	0.0001392338
Staphylococcus equorum	246432	S	5	1	6	0.0001392338
Bacillus anthracis	1392	S	3	3	6	0.0001392338
Caldibacillus thermoamylovorans	35841	S	6	0	6	0.0001392338
Paenibacillus sp. B01	2660554	S	6	0	6	0.0001392338
Streptococcus sp. oral taxon 431	712633	S	6	0	6	0.0001392338
Streptococcus gwangjuense	1433513	S	5	1	6	0.0001392338
Pediococcus pentosaceus	1255	S	6	0	6	0.0001392338
Ligilactobacillus salivarius	1624	S	6	0	6	0.0001392338
Paucilactobacillus hokkaidonensis	1193095	S	6	0	6	0.0001392338
Enterococcus faecalis	1351	S	6	0	6	0.0001392338
Enterococcus cecorum	44008	S	6	0	6	0.0001392338
Enterococcus faecium	1352	S	4	2	6	0.0001392338
Clostridium sp. JN-1	2483110	S	6	0	6	0.0001392338
Clostridium sp. 'deep sea'	2779445	S	6	0	6	0.0001392338
Clostridium tetani	1513	S	6	0	6	0.0001392338
Coprococcus catus	116085	S	5	1	6	0.0001392338
Eubacterium sp. NSJ-61	2764325	S	5	1	6	0.0001392338
Thermoanaerobacterium thermosaccharolyticum	1517	S	6	0	6	0.0001392338
Selenomonas sputigena	69823	S	6	0	6	0.0001392338
Nostoc sp. TCL240-02	2572090	S	5	1	6	0.0001392338
Nostoc sp. C052	2576902	S	5	1	6	0.0001392338
Anabaena sp. WA102	1647413	S	2	4	6	0.0001392338
Calothrix parasitica	1973486	S	6	0	6	0.0001392338
Microchaete diplosiphon	1197	S	2	4	6	0.0001392338
Microcystis viridis	44822	S	3	3	6	0.0001392338
Mycoplasma hominis	2098	S	5	1	6	0.0001392338
Flavobacterium sp. CJ74	2294119	S	6	0	6	0.0001392338
Polaribacter sp. Hel1_33_78	1336804	S	6	0	6	0.0001392338
Tenacibaculum maritimum	107401	S	6	0	6	0.0001392338
Winogradskyella helgolandensis	2697010	S	6	0	6	0.0001392338
Winogradskyella sediminis	1382466	S	5	1	6	0.0001392338
Cellulophaga baltica	76594	S	6	0	6	0.0001392338
Lacinutrix venerupis	1486034	S	6	0	6	0.0001392338
Psychroflexus sp. ALD_RP9	2777186	S	6	0	6	0.0001392338
Salegentibacter salegens	143223	S	6	0	6	0.0001392338
Changchengzhania lutea	2049305	S	6	0	6	0.0001392338
Chryseobacterium sp. IHB B 17019	1721091	S	6	0	6	0.0001392338
Chryseobacterium sp. 6424	2039166	S	6	0	6	0.0001392338
Chryseobacterium glaciei	1685010	S	6	0	6	0.0001392338
Chryseobacterium piperi	558152	S	6	0	6	0.0001392338
Kaistella antarctica	266748	S	6	0	6	0.0001392338
Cruoricaptor ignavus	1118202	S	6	0	6	0.0001392338
Spirosoma sp. KCTC 42546	2520506	S	6	0	6	0.0001392338
Spirosoma rigui	564064	S	6	0	6	0.0001392338
Dyadobacter fermentans	94254	S	6	0	6	0.0001392338
Hymenobacter sp. BRD67	2675877	S	4	2	6	0.0001392338
Hymenobacter swuensis	1446467	S	6	0	6	0.0001392338
Fulvivirga sp. S481	2810512	S	6	0	6	0.0001392338
Flammeovirga pectinis	2494373	S	6	0	6	0.0001392338
Chitinophaga sp. XS-30	2604421	S	6	0	6	0.0001392338
Arachidicoccus ginsenosidivorans	496057	S	6	0	6	0.0001392338
Flavisolibacter ginsenosidimutans	661481	S	6	0	6	0.0001392338
Niabella ginsenosidivorans	1176587	S	6	0	6	0.0001392338
Bacteroides thetaiotaomicron	818	S	6	0	6	0.0001392338
Prevotella melaninogenica	28132	S	6	0	6	0.0001392338
Parabacteroides distasonis	823	S	1	5	6	0.0001392338
Salinibacter ruber	146919	S	6	0	6	0.0001392338
Alienimonas californiensis	2527989	S	6	0	6	0.0001392338
Aureliella helgolandensis	2527968	S	6	0	6	0.0001392338
Lacipirellula parvula	2650471	S	6	0	6	0.0001392338
Leptospira interrogans	173	S	7	-1	6	0.0001392338
Fusobacterium ulcerans	861	S	6	0	6	0.0001392338
Candidatus Solibacter usitatus	332163	S	6	0	6	0.0001392338
Haloferax gibbonsii	35746	S	1	5	6	0.0001392338
Methanosarcina barkeri	2208	S	6	0	6	0.0001392338
Paramecium bursaria Chlorella virus A1	381899	S	6	0	6	0.0001392338
Yellowstone lake phycodnavirus 2	1586714	S	6	0	6	0.0001392338
Delftia sp. Cs1-4	742013	S	2	3	5	0.0001160281
Candidatus Symbiobacter mobilis	1436290	S	5	0	5	0.0001160281
Burkholderia contaminans	488447	S	4	1	5	0.0001160281
Burkholderia sp. DHOD12	2571746	S	5	0	5	0.0001160281
Paraburkholderia graminis	60548	S	5	0	5	0.0001160281
Paraburkholderia acidiphila	2571747	S	5	0	5	0.0001160281
Paraburkholderia aromaticivorans	2026199	S	4	1	5	0.0001160281
Paraburkholderia hospita	169430	S	3	2	5	0.0001160281
Pandoraea thiooxydans	445709	S	5	0	5	0.0001160281
Caballeronia sp. M1242	2814653	S	2	3	5	0.0001160281
Pigmentiphaga aceris	1940612	S	5	0	5	0.0001160281
Orrella dioscoreae	1851544	S	5	0	5	0.0001160281
Aromatoleum aromaticum	551760	S	5	0	5	0.0001160281
Dechloromonas aromatica	259537	S	5	0	5	0.0001160281
Methyloversatilis sp. RAC08	1842540	S	5	0	5	0.0001160281
Candidatus Accumulibacter phosphatis	327160	S	5	0	5	0.0001160281
Pseudomonas sp. MRSN12121	1611770	S	3	2	5	0.0001160281
Pseudomonas synxantha	47883	S	4	1	5	0.0001160281
Pseudomonas azotoformans	47878	S	4	1	5	0.0001160281
Pseudomonas furukawaii	1149133	S	5	0	5	0.0001160281
Pseudomonas marincola	437900	S	5	0	5	0.0001160281
Pseudomonas eucalypticola	2599595	S	5	0	5	0.0001160281
Pseudomonas taetrolens	47884	S	5	0	5	0.0001160281
Pseudomonas psychrophila	122355	S	5	0	5	0.0001160281
Pseudomonas vancouverensis	95300	S	5	0	5	0.0001160281
Pseudomonas granadensis	1421430	S	4	1	5	0.0001160281
Acinetobacter seifertii	1530123	S	5	0	5	0.0001160281
Acinetobacter radioresistens	40216	S	5	0	5	0.0001160281
Acinetobacter bereziniae	106648	S	5	0	5	0.0001160281
Psychrobacter sp. G	571800	S	2	3	5	0.0001160281
Klebsiella michiganensis	1134687	S	4	1	5	0.0001160281
Cedecea neteri	158822	S	5	0	5	0.0001160281
Pantoea cypripedii	55209	S	5	0	5	0.0001160281
Pantoea dispersa	59814	S	5	0	5	0.0001160281
Pantoea stewartii	66269	S	5	0	5	0.0001160281
Erwinia sp. Ejp617	215689	S	2	3	5	0.0001160281
Serratia sp. P2ACOL2	2482769	S	2	3	5	0.0001160281
Serratia liquefaciens	614	S	3	2	5	0.0001160281
Thermomonas brevis	215691	S	5	0	5	0.0001160281
Luteibacter pinisoli	2589080	S	4	1	5	0.0001160281
Shewanella sp. WE21	2029986	S	5	0	5	0.0001160281
Alteromonas sp. BL110	1714845	S	3	2	5	0.0001160281
Psychromonas sp. CNPT3	314282	S	5	0	5	0.0001160281
Halomonas sp. HG01	1609967	S	5	0	5	0.0001160281
Actinobacillus pleuropneumoniae	715	S	3	2	5	0.0001160281
Aeromonas veronii	654	S	4	1	5	0.0001160281
Zobellella denitrificans	347534	S	5	0	5	0.0001160281
Rheinheimera sp. LHK132	2498451	S	5	0	5	0.0001160281
Legionella anisa	28082	S	5	0	5	0.0001160281
Tatlockia micdadei	451	S	5	0	5	0.0001160281
Zhongshania aliphaticivorans	1470434	S	5	0	5	0.0001160281
Piscirickettsia salmonis	1238	S	5	0	5	0.0001160281
Candidatus Methylospira mobilis	1808979	S	5	0	5	0.0001160281
Sulfuricaulis limicola	1620215	S	5	0	5	0.0001160281
Bradyrhizobium sp. ORS 278	114615	S	5	0	5	0.0001160281
Bradyrhizobium sp. CCBAU 53338	1325111	S	3	2	5	0.0001160281
Bradyrhizobium guangzhouense	1325095	S	3	2	5	0.0001160281
Methylorubrum zatmanii	29429	S	1	4	5	0.0001160281
Rhizobium sp. Kim5	2020311	S	2	3	5	0.0001160281
Rhizobium gallicum	56730	S	4	1	5	0.0001160281
Agrobacterium larrymoorei	160699	S	5	0	5	0.0001160281
Agrobacterium sp. RAC06	1842536	S	2	3	5	0.0001160281
Sinorhizobium medicae	110321	S	5	0	5	0.0001160281
Sinorhizobium sp. RAC02	1842534	S	5	0	5	0.0001160281
Mesorhizobium sp. INR15	2654248	S	5	0	5	0.0001160281
Mesorhizobium amorphae	71433	S	5	0	5	0.0001160281
Mesorhizobium ciceri	39645	S	2	3	5	0.0001160281
Hoeflea phototrophica	244596	S	5	0	5	0.0001160281
Nitratireductor sp. SY7	2599600	S	5	0	5	0.0001160281
Chelativorans sp. BNC1	266779	S	5	0	5	0.0001160281
Devosia sp. A16	1736675	S	5	0	5	0.0001160281
Devosia sp. LEGU1	2774137	S	5	0	5	0.0001160281
Candidatus Filomicrobium marinum	1608628	S	5	0	5	0.0001160281
Starkeya sp. ORNL1	2709380	S	5	0	5	0.0001160281
Labrenzia sp. VG12	2021862	S	5	0	5	0.0001160281
Pannonibacter phragmitetus	121719	S	3	2	5	0.0001160281
Chelatococcus daeguensis	444444	S	4	1	5	0.0001160281
Sphingomonas sp. Cra20	1327635	S	5	0	5	0.0001160281
Sphingomonas sp. AP4-R1	2735134	S	5	0	5	0.0001160281
Sphingomonas sp. YZ-8	2319844	S	5	0	5	0.0001160281
Sphingomonas hengshuiensis	1609977	S	5	0	5	0.0001160281
Sphingomonas lacunae	2698828	S	5	0	5	0.0001160281
Sphingobium sp. SCG-1	2072936	S	5	0	5	0.0001160281
Sphingobium sp. LF-16	2185111	S	1	4	5	0.0001160281
Sphingopyxis sp. PAMC25046	2565556	S	4	1	5	0.0001160281
Sphingopyxis terrae	33052	S	4	1	5	0.0001160281
Novosphingobium sp. PP1Y	702113	S	3	2	5	0.0001160281
Sphingosinithalassobacter sp. CS137	2762748	S	5	0	5	0.0001160281
Parasphingopyxis sp. CP4	2724527	S	5	0	5	0.0001160281
Erythrobacter sp. HKB08	2502843	S	5	0	5	0.0001160281
Tsuneonella dongtanensis	692370	S	5	0	5	0.0001160281
Altererythrobacter sp. B11	2060312	S	5	0	5	0.0001160281
Paracoccus sp. BM15	1529068	S	5	0	5	0.0001160281
Paracoccus sp. AK26	2589076	S	5	0	5	0.0001160281
Paracoccus sp. MC1862	2760307	S	5	0	5	0.0001160281
Paracoccus pantotrophus	82367	S	5	0	5	0.0001160281
Paracoccus suum	2259340	S	5	0	5	0.0001160281
Paracoccus liaowanqingii	2560053	S	5	0	5	0.0001160281
Phaeobacter porticola	1844006	S	4	1	5	0.0001160281
Leisingera sp. NJS201	2508306	S	3	2	5	0.0001160281
Roseomonas sp. 546	2768162	S	5	0	5	0.0001160281
Lichenicola cladoniae	1484109	S	5	0	5	0.0001160281
Azospirillum sp. TSA2s	709810	S	4	1	5	0.0001160281
Azospirillum baldaniorum	1064539	S	3	2	5	0.0001160281
Hypericibacter adhaerens	2602016	S	5	0	5	0.0001160281
Ferrovibrio terrae	2594003	S	5	0	5	0.0001160281
Niveispirillum cyanobacteriorum	1612173	S	5	0	5	0.0001160281
Micavibrio aeruginosavorus	349221	S	5	0	5	0.0001160281
Geobacter sp. SVR	2495594	S	5	0	5	0.0001160281
Geobacter sp. FeAm09	2597769	S	5	0	5	0.0001160281
Geobacter sulfurreducens	35554	S	4	1	5	0.0001160281
Desulfuromonas sp. DDH964	1823759	S	5	0	5	0.0001160281
Desulfurivibrio alkaliphilus	427923	S	5	0	5	0.0001160281
Malaciobacter pacificus	1080223	S	5	0	5	0.0001160281
Campylobacter lari	201	S	4	1	5	0.0001160281
Sulfurimonas sp. GYSZ_1	2590022	S	5	0	5	0.0001160281
Silvanigrella aquatica	1915309	S	5	0	5	0.0001160281
Propionibacterium acidifaciens	556499	S	5	0	5	0.0001160281
Acidipropionibacterium acidipropionici	1748	S	4	1	5	0.0001160281
Nocardioides sp. JQ2195	2592334	S	5	0	5	0.0001160281
Nocardioides sp. MC1495	2736757	S	5	0	5	0.0001160281
Nocardioides sp. JS614	196162	S	5	0	5	0.0001160281
Nocardioides marinisabuli	419476	S	5	0	5	0.0001160281
Nocardioides ungokensis	1643322	S	5	0	5	0.0001160281
Luteipulveratus mongoliensis	571913	S	5	0	5	0.0001160281
Yimella sp. cx-51	2770551	S	5	0	5	0.0001160281
Paenarthrobacter aurescens	43663	S	2	3	5	0.0001160281
Arthrobacter sp. ERGS1:01	1704044	S	5	0	5	0.0001160281
Arthrobacter sp. YC-RL1	1652545	S	5	0	5	0.0001160281
Arthrobacter crystallopoietes	37928	S	5	0	5	0.0001160281
Pseudarthrobacter phenanthrenivorans	361575	S	5	0	5	0.0001160281
Glutamicibacter sp. ZJUTW	1155384	S	1	4	5	0.0001160281
Zhihengliuella sp. ISTPL4	2058657	S	4	1	5	0.0001160281
Microbacterium sp. RG1	2489212	S	5	0	5	0.0001160281
Microbacterium sp. Se63.02b	2709304	S	4	1	5	0.0001160281
Microbacterium oxydans	82380	S	4	1	5	0.0001160281
Agromyces flavus	589382	S	5	0	5	0.0001160281
Phycicoccus endophyticus	1690220	S	5	0	5	0.0001160281
Arsenicicoccus sp. oral taxon 190	1658671	S	5	0	5	0.0001160281
Brevibacterium luteolum	199591	S	5	0	5	0.0001160281
Brachybacterium saurashtrense	556288	S	5	0	5	0.0001160281
Cellulomonas flavigena	1711	S	5	0	5	0.0001160281
Serinicoccus profundi	1078471	S	5	0	5	0.0001160281
Serinicoccus hydrothermalis	1758689	S	5	0	5	0.0001160281
Xylanimonas cellulosilytica	186189	S	4	1	5	0.0001160281
Rhodococcus sp. B7740	1564114	S	5	0	5	0.0001160281
Rhodococcus sp. BH4	1807790	S	1	4	5	0.0001160281
Rhodococcus sp. ZPP	2749906	S	1	4	5	0.0001160281
Rhodococcus hoagii	43767	S	4	1	5	0.0001160281
Nocardia nova	37330	S	5	0	5	0.0001160281
Nocardia mangyaensis	2213200	S	5	0	5	0.0001160281
Corynebacterium sp. NML98-0116	702967	S	5	0	5	0.0001160281
Corynebacterium sp. 2019	2675218	S	5	0	5	0.0001160281
Corynebacterium doosanense	1121358	S	5	0	5	0.0001160281
Corynebacterium lactis	1231000	S	5	0	5	0.0001160281
Corynebacterium deserti	1408191	S	5	0	5	0.0001160281
Corynebacterium genitalium	38288	S	5	0	5	0.0001160281
Mycolicibacterium litorale	758802	S	5	0	5	0.0001160281
Mycolicibacterium aubagnense	319707	S	5	0	5	0.0001160281
Mycolicibacterium madagascariense	212765	S	5	0	5	0.0001160281
Mycolicibacterium boenickei	146017	S	2	3	5	0.0001160281
Mycobacterium avium	1764	S	4	1	5	0.0001160281
Mycobacterium intracellulare	1767	S	2	3	5	0.0001160281
Mycobacterium paraintracellulare	1138383	S	1	4	5	0.0001160281
Mycobacterium basiliense	2094119	S	5	0	5	0.0001160281
Mycobacterium ulcerans	1809	S	2	3	5	0.0001160281
Mycolicibacillus koreensis	1069220	S	5	0	5	0.0001160281
Gordonia phthalatica	1136941	S	5	0	5	0.0001160281
Streptomyces sp. CRXT-G-22	2768066	S	5	0	5	0.0001160281
Streptomyces sp. QHH-9511	2684468	S	5	0	5	0.0001160281
Streptomyces sp. RPA4-2	2721244	S	5	0	5	0.0001160281
Streptomyces sp. jing01	2726118	S	5	0	5	0.0001160281
Streptomyces sp. RTd22	1841249	S	5	0	5	0.0001160281
Streptomyces sp. C8S0	2585716	S	5	0	5	0.0001160281
Streptomyces sp. SirexAA-E	862751	S	5	0	5	0.0001160281
Streptomyces sp. NA04227	2742136	S	5	0	5	0.0001160281
Streptomyces sp. SS52	2563602	S	2	3	5	0.0001160281
Streptomyces albulus	68570	S	5	0	5	0.0001160281
Streptomyces seoulensis	73044	S	5	0	5	0.0001160281
Streptomyces rectiverticillatus	173860	S	5	0	5	0.0001160281
Streptomyces niveus	193462	S	5	0	5	0.0001160281
Streptomyces asterosporus	285570	S	5	0	5	0.0001160281
Streptomyces cavourensis	67258	S	5	0	5	0.0001160281
Streptomyces gardneri	66892	S	5	0	5	0.0001160281
Streptomyces lunaelactis	1535768	S	5	0	5	0.0001160281
Streptomyces spongiicola	1690221	S	5	0	5	0.0001160281
Streptomyces glomeroaurantiacus	68210	S	5	0	5	0.0001160281
Streptomyces clavuligerus	1901	S	5	0	5	0.0001160281
Streptomyces albireticuli	1940	S	5	0	5	0.0001160281
Amycolatopsis sp. YIM 10	2653857	S	5	0	5	0.0001160281
Actinosynnema pretiosum	42197	S	2	3	5	0.0001160281
Allokutzneria albata	211114	S	5	0	5	0.0001160281
Micromonospora echinofusca	47858	S	5	0	5	0.0001160281
Micromonospora inositola	47865	S	5	0	5	0.0001160281
Micromonospora krabiensis	307121	S	5	0	5	0.0001160281
Phytohabitans flavus	1076124	S	5	0	5	0.0001160281
Salinispora tropica	168695	S	5	0	5	0.0001160281
Actinomyces sp. oral taxon 414	712122	S	5	0	5	0.0001160281
Actinomyces sp. oral taxon 897	2081702	S	2	3	5	0.0001160281
Actinomadura verrucosospora	46165	S	5	0	5	0.0001160281
Geodermatophilus obscurus	1861	S	5	0	5	0.0001160281
Kineococcus radiotolerans	131568	S	5	0	5	0.0001160281
Epidermidibacterium keratini	1891644	S	5	0	5	0.0001160281
Egibacter rhizosphaerae	1670831	S	5	0	5	0.0001160281
Staphylococcus saprophyticus	29385	S	5	0	5	0.0001160281
Mammaliicoccus sciuri	1296	S	5	0	5	0.0001160281
Bacillus sp. DSL-17	2567941	S	5	0	5	0.0001160281
Bacillus sp. N1-1	2682541	S	5	0	5	0.0001160281
Virgibacillus sp. SK37	403957	S	2	3	5	0.0001160281
Thermobacillus composti	377615	S	5	0	5	0.0001160281
Tumebacillus avium	1903704	S	4	1	5	0.0001160281
Streptococcus pyogenes	1314	S	5	0	5	0.0001160281
Lactococcus cremoris	1359	S	5	0	5	0.0001160281
Lactobacillus iners	147802	S	5	0	5	0.0001160281
Latilactobacillus curvatus	28038	S	5	0	5	0.0001160281
Aerococcus viridans	1377	S	4	1	5	0.0001160281
Clostridium sp. JN-9	2507159	S	5	0	5	0.0001160281
Blautia sp. SC05B48	2479767	S	3	2	5	0.0001160281
Halobacteroides halobius	42422	S	5	0	5	0.0001160281
Longibaculum sp. KGMB06250	2584943	S	1	4	5	0.0001160281
Anabaena cylindrica	1165	S	4	1	5	0.0001160281
Cylindrospermum stagnale	142864	S	3	2	5	0.0001160281
Rivularia sp. PCC 7116	373994	S	5	0	5	0.0001160281
Synechococcus sp. CBW1107	2789857	S	5	0	5	0.0001160281
Geminocystis sp. NIES-3708	1615909	S	5	0	5	0.0001160281
Stanieria cyanosphaera	102116	S	4	1	5	0.0001160281
Mycoplasma gallinaceum	29556	S	5	0	5	0.0001160281
Thermus scotoductus	37636	S	5	0	5	0.0001160281
Sphaerobacter thermophilus	2057	S	5	0	5	0.0001160281
Fimbriimonas ginsengisoli	1005039	S	5	0	5	0.0001160281
Polaribacter sp. SA4-10	754397	S	5	0	5	0.0001160281
Polaribacter sp. G4M1	2808900	S	5	0	5	0.0001160281
Polaribacter sp. KT 15	1896175	S	2	3	5	0.0001160281
Polaribacter reichenbachii	996801	S	5	0	5	0.0001160281
Capnocytophaga gingivalis	1017	S	5	0	5	0.0001160281
Maribacter sp. T28	1836467	S	5	0	5	0.0001160281
Aquimarina sp. AD1	1714848	S	5	0	5	0.0001160281
Aquimarina sp. AD10	1714849	S	5	0	5	0.0001160281
Kordia antarctica	1218801	S	5	0	5	0.0001160281
Antarcticibacterium arcticum	2585771	S	5	0	5	0.0001160281
Croceibacter atlanticus	313588	S	5	0	5	0.0001160281
Chryseobacterium sp. POL2	2713414	S	4	1	5	0.0001160281
Chryseobacterium joostei	112234	S	4	1	5	0.0001160281
Kaistella daneshvariae	2487074	S	5	0	5	0.0001160281
Elizabethkingia meningoseptica	238	S	5	0	5	0.0001160281
Blattabacterium sp. DPU	2715232	S	4	1	5	0.0001160281
Candidatus Sulcia muelleri	336810	S	5	0	5	0.0001160281
Spirosoma montaniterrae	1178516	S	5	0	5	0.0001160281
Hymenobacter sp. NBH84	2596915	S	5	0	5	0.0001160281
Hymenobacter sp. S2-20-2	2761579	S	5	0	5	0.0001160281
Hymenobacter jejuensis	2502781	S	5	0	5	0.0001160281
Hymenobacter baengnokdamensis	2615203	S	3	2	5	0.0001160281
Adhaeribacter radiodurans	2745197	S	5	0	5	0.0001160281
Chryseolinea soli	2321403	S	5	0	5	0.0001160281
Mucilaginibacter sp. F39-2	2728022	S	5	0	5	0.0001160281
Mucilaginibacter paludis	423351	S	5	0	5	0.0001160281
Mucilaginibacter ginkgonis	2682091	S	5	0	5	0.0001160281
Pseudopedobacter saltans	151895	S	4	1	5	0.0001160281
Chitinophaga agri	2703787	S	4	1	5	0.0001160281
Arachidicoccus sp. B3-10	2545455	S	5	0	5	0.0001160281
Prevotella intermedia	28131	S	5	0	5	0.0001160281
Labilibaculum antarcticum	1717717	S	5	0	5	0.0001160281
Ignavibacterium album	591197	S	5	0	5	0.0001160281
Gemmatimonas aurantiaca	173480	S	5	0	5	0.0001160281
Gemmatimonas phototrophica	1379270	S	5	0	5	0.0001160281
Tuwongella immobilis	692036	S	5	0	5	0.0001160281
Gimesia alba	2527973	S	5	0	5	0.0001160281
Stieleria neptunia	2527979	S	5	0	5	0.0001160281
Bremerella volcania	2527984	S	5	0	5	0.0001160281
Singulisphaera acidiphila	466153	S	5	0	5	0.0001160281
Kiritimatiella glycovorans	1307763	S	2	3	5	0.0001160281
Treponema pedis	409322	S	5	0	5	0.0001160281
Brachyspira pilosicoli	52584	S	5	0	5	0.0001160281
Nitrospira moscoviensis	42253	S	5	0	5	0.0001160281
Halorubrum ezzemoulense	337243	S	5	0	5	0.0001160281
Halobonum sp. NJ-3-1	2743089	S	5	0	5	0.0001160281
Halolamina sp. CBA1230	1853690	S	5	0	5	0.0001160281
Natrialba magadii	13769	S	5	0	5	0.0001160281
Methanococcus maripaludis	39152	S	3	2	5	0.0001160281
Candidatus Prometheoarchaeum syntrophicum	2594042	S	5	0	5	0.0001160281
Lactococcus phage TP901-1	35345	S	2	3	5	0.0001160281
Streptococcus virus DT1	90410	S	3	2	5	0.0001160281
Microbacterium phage Arete	2713257	S	1	4	5	0.0001160281
Acidovorax cattleyae	80868	S	3	1	4	0.0000928225
Ralstonia syzygii	28097	S	1	3	4	0.0000928225
Burkholderia sp. RPE67	758796	S	4	0	4	0.0000928225
Burkholderia sp. YI23	1097668	S	4	0	4	0.0000928225
Burkholderia sp. KK1	1855726	S	4	0	4	0.0000928225
Burkholderia glumae	337	S	4	0	4	0.0000928225
Polynucleobacter asymbioticus	576611	S	4	0	4	0.0000928225
Polynucleobacter sp. LimPoW16	1743162	S	4	0	4	0.0000928225
Paraburkholderia ginsengisoli	311231	S	4	0	4	0.0000928225
Paraburkholderia megapolitana	420953	S	4	0	4	0.0000928225
Caballeronia insecticola	758793	S	4	0	4	0.0000928225
Janthinobacterium sp. Marseille	375286	S	4	0	4	0.0000928225
Herbaspirillum hiltneri	341045	S	4	0	4	0.0000928225
Herminiimonas arsenitoxidans	1809410	S	4	0	4	0.0000928225
Glaciimonas sp. PAMC28666	2807626	S	4	0	4	0.0000928225
Thiomonas intermedia	926	S	2	2	4	0.0000928225
Achromobacter sp. B7	2282475	S	4	0	4	0.0000928225
Bordetella sp. N	1746199	S	4	0	4	0.0000928225
Bordetella avium	521	S	4	0	4	0.0000928225
Bordetella genomosp. 13	463040	S	4	0	4	0.0000928225
Bordetella genomosp. 6	463024	S	3	1	4	0.0000928225
Thauera aromatica	59405	S	3	1	4	0.0000928225
Chromobacterium sp. Rain0013	2292447	S	3	1	4	0.0000928225
Chromobacterium haemolyticum	394935	S	1	3	4	0.0000928225
Laribacter hongkongensis	168471	S	4	0	4	0.0000928225
Neisseria bacilliformis	267212	S	4	0	4	0.0000928225
Neisseria animaloris	326522	S	4	0	4	0.0000928225
Vitreoscilla sp. C1	96942	S	4	0	4	0.0000928225
Candidatus Methylopumilus turicensis	1581680	S	4	0	4	0.0000928225
Candidatus Methylopumilus universalis	2588536	S	4	0	4	0.0000928225
Methylobacillus flagellatus	405	S	4	0	4	0.0000928225
Nitrosomonas communis	44574	S	4	0	4	0.0000928225
Nitrosomonas ureae	44577	S	3	1	4	0.0000928225
Sterolibacterium denitrificans	157592	S	4	0	4	0.0000928225
Sulfuritalea hydrogenivorans	748811	S	4	0	4	0.0000928225
Candidatus Nitrotoga sp. AM1P	2559597	S	4	0	4	0.0000928225
Pseudomonas sp. TUM18999	2725477	S	4	0	4	0.0000928225
Pseudomonas sp. MSPm1	2726956	S	4	0	4	0.0000928225
Pseudomonas rhodesiae	76760	S	4	0	4	0.0000928225
Pseudomonas monteilii	76759	S	3	1	4	0.0000928225
Pseudomonas nitroreducens	46680	S	3	1	4	0.0000928225
Pseudomonas resinovorans	53412	S	4	0	4	0.0000928225
Pseudomonas lundensis	86185	S	4	0	4	0.0000928225
Pseudomonas cichorii	36746	S	4	0	4	0.0000928225
Pseudomonas reinekei	395598	S	4	0	4	0.0000928225
Pseudomonas versuta	1788301	S	4	0	4	0.0000928225
Pseudomonas salegens	1434072	S	4	0	4	0.0000928225
Pseudomonas otitidis	319939	S	4	0	4	0.0000928225
Pseudomonas entomophila	312306	S	4	0	4	0.0000928225
Pseudomonas asplenii	53407	S	3	1	4	0.0000928225
Acinetobacter sp. TTH0-4	1646498	S	4	0	4	0.0000928225
Acinetobacter tandoii	202954	S	4	0	4	0.0000928225
Acinetobacter wuhouensis	1879050	S	4	0	4	0.0000928225
Acinetobacter baylyi	202950	S	4	0	4	0.0000928225
Acinetobacter schindleri	108981	S	4	0	4	0.0000928225
Psychrobacter sp. DAB_AL43B	1028416	S	4	0	4	0.0000928225
Enterobacter roggenkampii	1812935	S	2	2	4	0.0000928225
Raoultella ornithinolytica	54291	S	1	3	4	0.0000928225
Cronobacter condimenti	1163710	S	4	0	4	0.0000928225
[Enterobacter] lignolyticus	1334193	S	4	0	4	0.0000928225
Serratia plymuthica	82996	S	4	0	4	0.0000928225
Proteus sp. ZN5	2697019	S	3	1	4	0.0000928225
Providencia stuartii	588	S	1	3	4	0.0000928225
Xenorhabdus bovienii	40576	S	4	0	4	0.0000928225
Pectobacterium carotovorum	554	S	3	1	4	0.0000928225
Brenneria rubrifaciens	55213	S	1	3	4	0.0000928225
Hafnia alvei	569	S	4	0	4	0.0000928225
Stenotrophomonas sp. 364	2691571	S	4	0	4	0.0000928225
Xanthomonas sacchari	56458	S	4	0	4	0.0000928225
Lysobacter soli	453783	S	4	0	4	0.0000928225
Lysobacter alkalisoli	2591633	S	4	0	4	0.0000928225
Luteimonas yindakuii	2565782	S	4	0	4	0.0000928225
Xylella fastidiosa	2371	S	4	0	4	0.0000928225
Pseudolysobacter antarcticus	2511995	S	4	0	4	0.0000928225
Dyella sp. G9	2763498	S	4	0	4	0.0000928225
Shewanella sp. SNU WT4	2590015	S	4	0	4	0.0000928225
Pseudoalteromonas translucida	166935	S	2	2	4	0.0000928225
Halomonas meridiana	29570	S	4	0	4	0.0000928225
Halomonas subglaciescola	29571	S	4	0	4	0.0000928225
Vibrio harveyi	669	S	4	0	4	0.0000928225
Vibrio campbellii	680	S	4	0	4	0.0000928225
Vibrio splendidus	29497	S	4	0	4	0.0000928225
Vibrio kanaloae	170673	S	4	0	4	0.0000928225
Photobacterium ganghwense	320778	S	4	0	4	0.0000928225
Haemophilus influenzae	727	S	2	2	4	0.0000928225
Mannheimia pernigra	111844	S	2	2	4	0.0000928225
Aeromonas schubertii	652	S	4	0	4	0.0000928225
Allochromatium vinosum	1049	S	4	0	4	0.0000928225
Thioalkalivibrio paradoxus	108010	S	4	0	4	0.0000928225
Legionella sp. PC1000	2746060	S	4	0	4	0.0000928225
Halioglobus maricola	2601894	S	4	0	4	0.0000928225
Hydrogenovibrio marinus	28885	S	4	0	4	0.0000928225
Francisella philomiragia	28110	S	2	2	4	0.0000928225
Sinimarinibacterium sp. NLF-5-8	2698684	S	4	0	4	0.0000928225
Bradyrhizobium sp. LCT2	2493093	S	1	3	4	0.0000928225
Bradyrhizobium genosp. B	83627	S	4	0	4	0.0000928225
Bosea sp. PAMC 26642	1792307	S	4	0	4	0.0000928225
Nitrobacter winogradskyi	913	S	4	0	4	0.0000928225
Microvirga sp. VF16	2807101	S	4	0	4	0.0000928225
Rhizobium sp. ADMK78	1813451	S	4	0	4	0.0000928225
Rhizobium bangladeshense	1138189	S	4	0	4	0.0000928225
Ensifer sojae	716925	S	3	1	4	0.0000928225
Mesorhizobium sp. NBSH29	2654249	S	4	0	4	0.0000928225
Mesorhizobium sp. M2A.F.Ca.ET.043.05.1.1	2493671	S	3	1	4	0.0000928225
Mesorhizobium sp. 131-3-5	2744520	S	1	3	4	0.0000928225
Mesorhizobium oceanicum	1670800	S	4	0	4	0.0000928225
Oricola thermophila	2742145	S	4	0	4	0.0000928225
Roseitalea porphyridii	1852022	S	4	0	4	0.0000928225
Devosia sp. I507	2083786	S	4	0	4	0.0000928225
Pseudolabrys taiwanensis	331696	S	4	0	4	0.0000928225
Pseudolabrys sp. FHR47	2562284	S	4	0	4	0.0000928225
Brucella intermedia	94625	S	4	0	4	0.0000928225
Methylocella silvestris	199596	S	4	0	4	0.0000928225
Methylovirgula ligni	569860	S	4	0	4	0.0000928225
Hartmannibacter diazotrophicus	1482074	S	4	0	4	0.0000928225
Pseudorhodoplanes sinuspersici	1235591	S	4	0	4	0.0000928225
Pyruvatibacter mobilis	1712261	S	4	0	4	0.0000928225
Sphingomonas sp. CL5.1	2653203	S	4	0	4	0.0000928225
Sphingomonas sp. sand1-3	2764186	S	4	0	4	0.0000928225
Sphingomonas xanthus	2594473	S	4	0	4	0.0000928225
Novosphingobium aromaticivorans	48935	S	3	1	4	0.0000928225
Novosphingobium pentaromativorans	205844	S	2	2	4	0.0000928225
Sphingorhabdus sp. JK6	2725558	S	4	0	4	0.0000928225
Blastomonas fulva	1550728	S	2	2	4	0.0000928225
Citromicrobium sp. JL477	1634516	S	4	0	4	0.0000928225
Erythrobacter aureus	2182384	S	4	0	4	0.0000928225
Altererythrobacter sp. TH136	2067415	S	4	0	4	0.0000928225
Pelagerythrobacter marensis	543877	S	4	0	4	0.0000928225
Rhodobacter sp. LPB0142	1850250	S	3	1	4	0.0000928225
Sulfitobacter sp. SK011	1389004	S	4	0	4	0.0000928225
Sulfitobacter mediterraneus	83219	S	4	0	4	0.0000928225
Celeribacter indicus	1208324	S	3	1	4	0.0000928225
Marivivens sp. JLT3646	1920883	S	4	0	4	0.0000928225
Roseibacterium elongatum	159346	S	4	0	4	0.0000928225
Paraoceanicella profunda	2579971	S	4	0	4	0.0000928225
Roseicitreum antarcticum	564137	S	4	0	4	0.0000928225
Pseudohalocynthiibacter aestuariivivens	1591409	S	4	0	4	0.0000928225
Brevundimonas sp. MF30-B	2561924	S	4	0	4	0.0000928225
Caulobacter mirabilis	69666	S	4	0	4	0.0000928225
Acetobacter persici	1076596	S	4	0	4	0.0000928225
Acetobacter oryzoeni	2500548	S	2	2	4	0.0000928225
Gluconacetobacter diazotrophicus	33996	S	4	0	4	0.0000928225
Azospirillum oryzae	286727	S	3	1	4	0.0000928225
Magnetospirillum gryphiswaldense	55518	S	4	0	4	0.0000928225
Hypericibacter terrae	2602015	S	4	0	4	0.0000928225
Tistrella mobilis	171437	S	4	0	4	0.0000928225
Skermanella pratensis	2233999	S	4	0	4	0.0000928225
Rickettsia endosymbiont of Ixodes pacificus	1133329	S	4	0	4	0.0000928225
Ehrlichia ruminantium	779	S	4	0	4	0.0000928225
Candidatus Deianiraea vastatrix	2163644	S	4	0	4	0.0000928225
Candidatus Pelagibacter sp. RS40	1977865	S	4	0	4	0.0000928225
Stigmatella aurantiaca	41	S	4	0	4	0.0000928225
Desulfovibrio fairfieldensis	44742	S	4	0	4	0.0000928225
Desulfovibrio carbinolicus	296842	S	3	1	4	0.0000928225
Desulfosarcina alkanivorans	571177	S	4	0	4	0.0000928225
Persicimonas caeni	2292766	S	4	0	4	0.0000928225
Poseidonibacter lekithochrous	1904463	S	4	0	4	0.0000928225
Campylobacter iguaniorum	1244531	S	4	0	4	0.0000928225
Campylobacter coli	195	S	3	1	4	0.0000928225
Sulfurospirillum barnesii	44674	S	4	0	4	0.0000928225
Helicobacter bilis	37372	S	4	0	4	0.0000928225
Bdellovibrio sp. NC01	2220073	S	4	0	4	0.0000928225
Bacteriovorax stolpii	960	S	4	0	4	0.0000928225
Hydrogenophilus thermoluteolus	297	S	4	0	4	0.0000928225
Auraticoccus monumenti	675864	S	4	0	4	0.0000928225
Nocardioides sp. CF8	110319	S	4	0	4	0.0000928225
Nocardioides mesophilus	433659	S	4	0	4	0.0000928225
Nocardioides seonyuensis	2518371	S	4	0	4	0.0000928225
Nocardioides cynanchi	2558918	S	4	0	4	0.0000928225
Friedmanniella luteola	546871	S	4	0	4	0.0000928225
Micropruina glycogenica	75385	S	4	0	4	0.0000928225
Kocuria sp. KD4	2719588	S	4	0	4	0.0000928225
Kocuria sp. TGY1120_3	2711329	S	3	1	4	0.0000928225
Kocuria rosea	1275	S	4	0	4	0.0000928225
Paenarthrobacter sp. YJN-5	2735316	S	2	2	4	0.0000928225
Arthrobacter sp. NEB 688	904039	S	4	0	4	0.0000928225
Rothia kristinae	37923	S	4	0	4	0.0000928225
Pseudarthrobacter sp. BIM B-2242	2772401	S	4	0	4	0.0000928225
Pseudarthrobacter sp. NIBRBAC000502771	2590774	S	2	2	4	0.0000928225
Sinomonas sp. R1AF57	2020377	S	4	0	4	0.0000928225
Microbacterium sp. BH-3-3-3	1906742	S	4	0	4	0.0000928225
Microbacterium sp. ABRD_28	2268461	S	4	0	4	0.0000928225
Microbacterium schleiferi	69362	S	4	0	4	0.0000928225
Microbacterium chocolatum	84292	S	4	0	4	0.0000928225
Microbacterium testaceum	2033	S	4	0	4	0.0000928225
Microbacterium lemovicicum	1072463	S	4	0	4	0.0000928225
Curtobacterium sp. 24E2	2804758	S	4	0	4	0.0000928225
Curtobacterium pusillum	69373	S	4	0	4	0.0000928225
Rathayibacter toxicus	145458	S	4	0	4	0.0000928225
Agromyces sp. HY052	2585717	S	4	0	4	0.0000928225
Agromyces sp. KACC 19306	2592652	S	4	0	4	0.0000928225
Agrococcus jejuensis	399736	S	4	0	4	0.0000928225
Agrococcus carbonis	684552	S	4	0	4	0.0000928225
Agrococcus sp. SGAir0287	2070347	S	4	0	4	0.0000928225
Cryobacterium sp. LW097	1978566	S	4	0	4	0.0000928225
Frondihabitans sp. 762G35	1446794	S	4	0	4	0.0000928225
Frondihabitans sp. PAMC 28766	1795630	S	4	0	4	0.0000928225
Rhodoluna limnophila	232537	S	4	0	4	0.0000928225
Protaetiibacter intestinalis	2419774	S	4	0	4	0.0000928225
Agreia sp. COWG	2773266	S	4	0	4	0.0000928225
Pedococcus dokdonensis	443156	S	4	0	4	0.0000928225
Brevibacterium aurantiacum	273384	S	4	0	4	0.0000928225
Brachybacterium faecium	43669	S	4	0	4	0.0000928225
Cellulomonas fimi	1708	S	4	0	4	0.0000928225
Ornithinimicrobium sp. AMA3305	2283195	S	4	0	4	0.0000928225
Beutenbergia cavernae	84757	S	4	0	4	0.0000928225
Sanguibacter keddieii	60920	S	4	0	4	0.0000928225
Rhodococcus sp. ABRD24	2507582	S	4	0	4	0.0000928225
Rhodococcus sp. SGAir0479	2567884	S	4	0	4	0.0000928225
Rhodococcus sp. 21391	2683591	S	1	3	4	0.0000928225
Rhodococcus sp. S2-17	1990687	S	1	3	4	0.0000928225
Corynebacterium sp. 1959	2675216	S	4	0	4	0.0000928225
Corynebacterium halotolerans	225326	S	4	0	4	0.0000928225
Corynebacterium aquilae	203263	S	4	0	4	0.0000928225
Corynebacterium sanguinis	2594913	S	4	0	4	0.0000928225
Corynebacterium glaucum	187491	S	4	0	4	0.0000928225
Corynebacterium striatum	43770	S	4	0	4	0.0000928225
Corynebacterium aurimucosum	169292	S	4	0	4	0.0000928225
Corynebacterium singulare	161899	S	4	0	4	0.0000928225
Corynebacterium cystitidis	35757	S	4	0	4	0.0000928225
Mycolicibacterium arabiense	1286181	S	4	0	4	0.0000928225
Mycolicibacterium tokaiense	39695	S	4	0	4	0.0000928225
Mycolicibacterium rutilum	370526	S	4	0	4	0.0000928225
Mycolicibacterium phocaicum	319706	S	4	0	4	0.0000928225
Mycolicibacterium frederiksbergense	117567	S	4	0	4	0.0000928225
Mycobacterium sp. WY10	1920667	S	1	3	4	0.0000928225
Mycobacterium sp. PYR15	2051552	S	1	3	4	0.0000928225
Mycobacterium tuberculosis	1773	S	3	1	4	0.0000928225
Gordonia sp. JH63	2698900	S	2	2	4	0.0000928225
Streptomyces sp. WAC 01529	2203205	S	4	0	4	0.0000928225
Streptomyces sp. CdTB01	1725411	S	4	0	4	0.0000928225
Streptomyces griseus	1911	S	4	0	4	0.0000928225
Streptomyces viridosporus	67581	S	4	0	4	0.0000928225
Streptomyces fulvissimus	68202	S	4	0	4	0.0000928225
Streptomyces bathyalis	2710756	S	4	0	4	0.0000928225
Streptomyces lydicus	47763	S	4	0	4	0.0000928225
Streptomyces tsukubensis	83656	S	4	0	4	0.0000928225
Streptomyces phaeolivaceus	2653200	S	4	0	4	0.0000928225
Streptomyces spectabilis	68270	S	4	0	4	0.0000928225
Streptomyces griseochromogenes	68214	S	4	0	4	0.0000928225
Kitasatospora sp. MMS16-BH015	2018025	S	4	0	4	0.0000928225
Amycolatopsis sp. FDAARGOS 1241	2778070	S	4	0	4	0.0000928225
Pseudonocardia autotrophica	2074	S	4	0	4	0.0000928225
Saccharothrix espanaensis	103731	S	4	0	4	0.0000928225
Prauserella marina	530584	S	4	0	4	0.0000928225
Micromonospora sp. HM134	2583243	S	4	0	4	0.0000928225
Micromonospora coxensis	356852	S	4	0	4	0.0000928225
Micromonospora siamensis	299152	S	4	0	4	0.0000928225
Micromonospora coriariae	285665	S	4	0	4	0.0000928225
Actinomyces sp. oral taxon 169	712116	S	3	1	4	0.0000928225
Actinomyces naeslundii	1655	S	4	0	4	0.0000928225
Flaviflexus sp. dk850	2758573	S	4	0	4	0.0000928225
Schaalia sp. JY-X169	2758572	S	4	0	4	0.0000928225
Nonomuraea nitratireducens	2656914	S	4	0	4	0.0000928225
Thermobispora bispora	2006	S	4	0	4	0.0000928225
Nakamurella panacisegetis	1090615	S	4	0	4	0.0000928225
Jiangella alkaliphila	419479	S	4	0	4	0.0000928225
Actinopolyspora erythraea	414996	S	4	0	4	0.0000928225
Euzebya sp. DY32-46	1608957	S	4	0	4	0.0000928225
Baekduia soli	496014	S	4	0	4	0.0000928225
Bacillus wiedmannii	1890302	S	4	0	4	0.0000928225
Bacillus amyloliquefaciens	1390	S	2	2	4	0.0000928225
Bacillus oleronius	38875	S	4	0	4	0.0000928225
Lysinibacillus sphaericus	1421	S	3	1	4	0.0000928225
Alkalihalobacillus clausii	79880	S	4	0	4	0.0000928225
Paenibacillus sp. E222	2748863	S	4	0	4	0.0000928225
Paenibacillus sp. UniB2	2726185	S	4	0	4	0.0000928225
Paenibacillus sp. FSL R7-0331	1536773	S	4	0	4	0.0000928225
Paenibacillus stellifer	169760	S	4	0	4	0.0000928225
Paenibacillus naphthalenovorans	162209	S	4	0	4	0.0000928225
Sporosarcina ureae	1571	S	4	0	4	0.0000928225
Ureibacillus thermophilus	367743	S	4	0	4	0.0000928225
Gemella sanguinis	84135	S	4	0	4	0.0000928225
Streptococcus equi	1336	S	4	0	4	0.0000928225
Streptococcus cristatus	45634	S	4	0	4	0.0000928225
Streptococcus intermedius	1338	S	3	1	4	0.0000928225
Lactobacillus sp. CBA3605	2099788	S	4	0	4	0.0000928225
Lactobacillus crispatus	47770	S	4	0	4	0.0000928225
Leuconostoc sp. C2	979982	S	1	3	4	0.0000928225
Weissella cibaria	137591	S	4	0	4	0.0000928225
Weissella cryptocerci	2506420	S	4	0	4	0.0000928225
Companilactobacillus paralimentarius	83526	S	4	0	4	0.0000928225
Enterococcus wangshanyuanii	2005703	S	4	0	4	0.0000928225
Clostridium cellulovorans	1493	S	4	0	4	0.0000928225
Clostridium taeniosporum	394958	S	4	0	4	0.0000928225
Clostridium drakei	332101	S	4	0	4	0.0000928225
Clostridium saccharobutylicum	169679	S	4	0	4	0.0000928225
Clostridium argentinense	29341	S	4	0	4	0.0000928225
Clostridium beijerinckii	1520	S	2	2	4	0.0000928225
Clostridium diolis	223919	S	1	3	4	0.0000928225
Caloranaerobacter azorensis	116090	S	4	0	4	0.0000928225
Crassaminicella sp. SY095	2599308	S	4	0	4	0.0000928225
Coprococcus comes	410072	S	3	1	4	0.0000928225
[Ruminococcus] torques	33039	S	3	1	4	0.0000928225
Ethanoligenens harbinense	253239	S	4	0	4	0.0000928225
Paeniclostridium sordellii	1505	S	4	0	4	0.0000928225
Desulfosporosinus youngiae	339862	S	4	0	4	0.0000928225
Syntrophobotulus glycolicus	51197	S	4	0	4	0.0000928225
Eubacterium limosum	1736	S	3	1	4	0.0000928225
Thermoanaerobacter brockii	29323	S	1	3	4	0.0000928225
Halocella sp. SP3-1	2382161	S	4	0	4	0.0000928225
Schnuerera ultunensis	45497	S	4	0	4	0.0000928225
Scytonema sp. HK-05	1137095	S	4	0	4	0.0000928225
Dactylococcopsis salina	292566	S	4	0	4	0.0000928225
Leptolyngbya sp. PCC 7376	111781	S	4	0	4	0.0000928225
Gloeothece citriformis	2546356	S	4	0	4	0.0000928225
Moorea producens	1155739	S	4	0	4	0.0000928225
Trichodesmium erythraeum	1206	S	4	0	4	0.0000928225
Gloeobacter kilaueensis	1416614	S	3	1	4	0.0000928225
Mycoplasma bovis	28903	S	4	0	4	0.0000928225
Deinococcus gobiensis	502394	S	4	0	4	0.0000928225
Deinococcus ficus	317577	S	4	0	4	0.0000928225
Flavobacterium sp. xlx-214	2654325	S	4	0	4	0.0000928225
Flavobacterium sp. P2-65	2748320	S	4	0	4	0.0000928225
Flavobacterium album	2175091	S	4	0	4	0.0000928225
Flavobacterium arcticum	1784713	S	4	0	4	0.0000928225
Flavobacterium kingsejongi	1678728	S	4	0	4	0.0000928225
Polaribacter sp. BM10	1529069	S	2	2	4	0.0000928225
Polaribacter sejongensis	985043	S	4	0	4	0.0000928225
Formosa sediminum	2594004	S	4	0	4	0.0000928225
Tenacibaculum sp. SZ-18	754423	S	4	0	4	0.0000928225
Tenacibaculum dicentrarchi	669041	S	4	0	4	0.0000928225
Capnocytophaga sp. oral taxon 864	1316593	S	2	2	4	0.0000928225
Nonlabens sp. MIC269	1476901	S	2	2	4	0.0000928225
Olleya aquimaris	639310	S	3	1	4	0.0000928225
Muricauda sp. 501str8	2698672	S	3	1	4	0.0000928225
Leeuwenhoekiella sp. ZYFB001	2719912	S	4	0	4	0.0000928225
Sediminicola sp. YIK13	1453352	S	4	0	4	0.0000928225
Euzebyella marina	1761453	S	3	1	4	0.0000928225
Psychroserpens sp. NJDZ02	2570561	S	2	2	4	0.0000928225
Chryseobacterium sp. G0201	2487065	S	4	0	4	0.0000928225
Chryseobacterium camelliae	1265445	S	3	1	4	0.0000928225
Chryseobacterium shandongense	1493872	S	3	1	4	0.0000928225
Chryseobacterium nakagawai	1241982	S	2	2	4	0.0000928225
Elizabethkingia sp. JS20170427COW	2583851	S	4	0	4	0.0000928225
Empedobacter brevis	247	S	4	0	4	0.0000928225
Empedobacter stercoris	1628248	S	4	0	4	0.0000928225
Spirosoma sp. CJU-R4	2728024	S	4	0	4	0.0000928225
Hymenobacter russus	2724192	S	4	0	4	0.0000928225
Pontibacter korlensis	400092	S	4	0	4	0.0000928225
Flammeovirga sp. MY04	1191459	S	4	0	4	0.0000928225
Roseivirga pacifica	1267423	S	4	0	4	0.0000928225
Marivirga tractuosa	1006	S	3	1	4	0.0000928225
Pedobacter sp. PACM 27299	1727164	S	4	0	4	0.0000928225
Sphingobacterium sp. ML3W	1538644	S	4	0	4	0.0000928225
Sphingobacterium sp. UDSM-2020	2795738	S	4	0	4	0.0000928225
Sphingobacterium sp. G1-14	2003121	S	1	3	4	0.0000928225
Sphingobacterium mizutaii	1010	S	4	0	4	0.0000928225
Mucilaginibacter ginsenosidivorans	398053	S	4	0	4	0.0000928225
Mucilaginibacter gotjawali	1550579	S	4	0	4	0.0000928225
Mucilaginibacter gossypii	551996	S	3	1	4	0.0000928225
Bacteroides sp. A1C1	2528203	S	1	3	4	0.0000928225
Salinivirga cyanobacteriivorans	1307839	S	4	0	4	0.0000928225
Draconibacterium orientale	1168034	S	4	0	4	0.0000928225
Rhodothermus marinus	29549	S	4	0	4	0.0000928225
Prosthecochloris sp. HL-130-GSB	1974213	S	4	0	4	0.0000928225
Gimesia benthica	2608982	S	2	2	4	0.0000928225
Maioricimonas rarisocia	2528026	S	4	0	4	0.0000928225
Rosistilla carotiformis	2528017	S	3	1	4	0.0000928225
Rhodopirellula baltica	265606	S	4	0	4	0.0000928225
Roseimaritima ulvae	980254	S	4	0	4	0.0000928225
Lignipirellula cremea	2528010	S	4	0	4	0.0000928225
Bythopirellula goksoyri	1400387	S	4	0	4	0.0000928225
Pirellulimonas nuda	2528009	S	4	0	4	0.0000928225
Opitutus terrae	107709	S	4	0	4	0.0000928225
Borrelia turcica	229155	S	4	0	4	0.0000928225
Turneriella parva	29510	S	4	0	4	0.0000928225
Fusobacterium necrophorum	859	S	4	0	4	0.0000928225
Leptotrichia wadei	157687	S	4	0	4	0.0000928225
Granulicella tundricola	940615	S	4	0	4	0.0000928225
Thermotoga caldifontis	1508419	S	1	3	4	0.0000928225
Haloarcula taiwanensis	1932004	S	1	3	4	0.0000928225
Haloterrigena sp. YPL8	1699371	S	4	0	4	0.0000928225
Halopiger xanaduensis	387343	S	4	0	4	0.0000928225
Methanocaldococcus sp. FS406-22	644281	S	4	0	4	0.0000928225
Saccharolobus solfataricus	2287	S	4	0	4	0.0000928225
Flavobacterium phage vB_FspS_snusmum6-1	2686273	S	3	1	4	0.0000928225
Streptococcus virus 7201	112023	S	4	0	4	0.0000928225
Polaribacter virus P12002S	1982246	S	3	1	4	0.0000928225
Cellulophaga virus Cba121	1918193	S	4	0	4	0.0000928225
Curvibacter virus P26059B	2733926	S	4	0	4	0.0000928225
Torque teno virus 24	687363	S	4	0	4	0.0000928225
Burkholderia stagnalis	1503054	S	3	0	3	0.0000696169
Burkholderia cepacia	292	S	3	0	3	0.0000696169
Burkholderia sp. JP2-270	2217913	S	3	0	3	0.0000696169
Burkholderia sp. IDO3	1705310	S	2	1	3	0.0000696169
Burkholderia plantarii	41899	S	3	0	3	0.0000696169
Cupriavidus gilardii	82541	S	1	2	3	0.0000696169
Cupriavidus malaysiensis	367825	S	1	2	3	0.0000696169
Paraburkholderia terricola	169427	S	3	0	3	0.0000696169
Paraburkholderia phenoliruptrix	252970	S	3	0	3	0.0000696169
Paraburkholderia sprentiae	948107	S	3	0	3	0.0000696169
Paraburkholderia caffeinilytica	1761016	S	3	0	3	0.0000696169
Paraburkholderia dokdonella	2211211	S	3	0	3	0.0000696169
Pandoraea oxalativorans	573737	S	3	0	3	0.0000696169
Pandoraea faecigallinarum	656179	S	3	0	3	0.0000696169
Pandoraea sp. XY-2	2518599	S	3	0	3	0.0000696169
Bordetella sp. H567	1697043	S	3	0	3	0.0000696169
Bordetella holmesii	35814	S	3	0	3	0.0000696169
Pusillimonas sp. T7-7	1007105	S	3	0	3	0.0000696169
Castellaniella defragrans	75697	S	3	0	3	0.0000696169
Sutterella megalosphaeroides	2494234	S	3	0	3	0.0000696169
Aromatoleum bremense	76115	S	3	0	3	0.0000696169
Azoarcus sp. DN11	356837	S	2	1	3	0.0000696169
Thauera humireducens	1134435	S	3	0	3	0.0000696169
Chromobacterium vaccinii	1108595	S	3	0	3	0.0000696169
Chromobacterium rhizoryzae	1778675	S	1	2	3	0.0000696169
Jeongeupia sp. HS-3	1009682	S	3	0	3	0.0000696169
Aquitalea denitrificans	519081	S	3	0	3	0.0000696169
Vogesella sp. LIG4	1192162	S	3	0	3	0.0000696169
Neisseria animalis	492	S	3	0	3	0.0000696169
Neisseria mucosa	488	S	2	1	3	0.0000696169
Kingella oralis	505	S	3	0	3	0.0000696169
Crenobacter cavernae	2290923	S	3	0	3	0.0000696169
Methylotenera versatilis	1055487	S	3	0	3	0.0000696169
Methylophilus medardicus	2588534	S	3	0	3	0.0000696169
Denitratisoma oestradiolicum	311182	S	3	0	3	0.0000696169
Usitatibacter rugosus	2732067	S	3	0	3	0.0000696169
Usitatibacter palustris	2732487	S	3	0	3	0.0000696169
Sulfuritortus calidifontis	1914471	S	3	0	3	0.0000696169
Pseudomonas sp. K2W31S-8	2320867	S	3	0	3	0.0000696169
Pseudomonas sp. OIL-1	2706126	S	3	0	3	0.0000696169
Pseudomonas sp. SNU WT1	2518644	S	3	0	3	0.0000696169
Pseudomonas sp. 7SR1	1881017	S	3	0	3	0.0000696169
Pseudomonas sp. TCU-HL1	1856685	S	3	0	3	0.0000696169
Pseudomonas sp. MPC6	2498848	S	3	0	3	0.0000696169
Pseudomonas sp. PDNC002	2811422	S	3	0	3	0.0000696169
Pseudomonas sp. SWI44	2083053	S	2	1	3	0.0000696169
Pseudomonas sp. J380	2605424	S	2	1	3	0.0000696169
Pseudomonas sp. TMW 2.1634	1886807	S	1	2	3	0.0000696169
Pseudomonas sp. CFA	2651048	S	1	2	3	0.0000696169
Pseudomonas trivialis	200450	S	3	0	3	0.0000696169
Pseudomonas mucidolens	46679	S	3	0	3	0.0000696169
Pseudomonas balearica	74829	S	3	0	3	0.0000696169
Pseudomonas xanthomarina	271420	S	3	0	3	0.0000696169
Pseudomonas viridiflava	33069	S	3	0	3	0.0000696169
Pseudomonas asturiensis	1190415	S	3	0	3	0.0000696169
Pseudomonas amygdali	47877	S	2	1	3	0.0000696169
Pseudomonas thivervalensis	86265	S	3	0	3	0.0000696169
Pseudomonas prosekii	1148509	S	3	0	3	0.0000696169
Pseudomonas simiae	321846	S	3	0	3	0.0000696169
Pseudomonas lurida	244566	S	3	0	3	0.0000696169
Pseudomonas psychrotolerans	237610	S	3	0	3	0.0000696169
Pseudomonas rhizosphaerae	216142	S	3	0	3	0.0000696169
Pseudomonas sediminis	1691904	S	3	0	3	0.0000696169
Azotobacter salinestris	69964	S	3	0	3	0.0000696169
Acinetobacter nosocomialis	106654	S	3	0	3	0.0000696169
Acinetobacter sp. WCHAc010034	1879049	S	3	0	3	0.0000696169
Acinetobacter sp. WCHA55	2004646	S	3	0	3	0.0000696169
Acinetobacter sp. SWBY1	2079596	S	2	1	3	0.0000696169
Acinetobacter cumulans	2136182	S	3	0	3	0.0000696169
Acinetobacter dispersus	70348	S	3	0	3	0.0000696169
Psychrobacter sp. P11G3	1699623	S	3	0	3	0.0000696169
Psychrobacter urativorans	45610	S	3	0	3	0.0000696169
Klebsiella sp. FDAARGOS_511	2488567	S	1	2	3	0.0000696169
Enterobacter kobei	208224	S	1	2	3	0.0000696169
Enterobacter sp. SA187	1914861	S	3	0	3	0.0000696169
Citrobacter pasteurii	1563222	S	2	1	3	0.0000696169
Escherichia fergusonii	564	S	3	0	3	0.0000696169
Salmonella bongori	54736	S	3	0	3	0.0000696169
Leclercia sp. 4-9-1-25	2815358	S	3	0	3	0.0000696169
Kosakonia radicincitans	283686	S	3	0	3	0.0000696169
Pseudescherichia vulneris	566	S	3	0	3	0.0000696169
Jejubacter calystegiae	2579935	S	3	0	3	0.0000696169
Phytobacter ursingii	1972431	S	3	0	3	0.0000696169
Pantoea alhagi	1891675	S	3	0	3	0.0000696169
Erwinia amylovora	552	S	3	0	3	0.0000696169
Tatumella citrea	53336	S	3	0	3	0.0000696169
Yersinia ruckeri	29486	S	3	0	3	0.0000696169
Rahnella aceris	2703885	S	2	1	3	0.0000696169
Xenorhabdus hominickii	351679	S	3	0	3	0.0000696169
Candidatus Arsenophonus lipoptenae	634113	S	3	0	3	0.0000696169
Pectobacterium wasabiae	55208	S	3	0	3	0.0000696169
Pectobacterium parmentieri	1905730	S	3	0	3	0.0000696169
Leminorella richardii	158841	S	3	0	3	0.0000696169
Stenotrophomonas sp. SAU14A_NAIMI4_8	2072409	S	1	2	3	0.0000696169
Stenotrophomonas sp. G4	2303750	S	2	1	3	0.0000696169
Stenotrophomonas indicatrix	2045451	S	1	2	3	0.0000696169
Xanthomonas hortorum	56454	S	3	0	3	0.0000696169
Xanthomonas vesicatoria	56460	S	3	0	3	0.0000696169
Lysobacter sp. TY2-98	2290922	S	3	0	3	0.0000696169
Lysobacter sp. H21R4	2781021	S	2	1	3	0.0000696169
Lysobacter gummosus	262324	S	3	0	3	0.0000696169
Lysobacter lycopersici	1324796	S	3	0	3	0.0000696169
Luteimonas granuli	1176533	S	3	0	3	0.0000696169
Thermomonas sp. XSG	2771436	S	3	0	3	0.0000696169
Arenimonas daejeonensis	370777	S	3	0	3	0.0000696169
Rhodanobacter glycinis	582702	S	3	0	3	0.0000696169
Dyella sp. M7H15-1	2501295	S	3	0	3	0.0000696169
Ahniella affigens	2021234	S	3	0	3	0.0000696169
Shewanella sp. MR-7	60481	S	2	1	3	0.0000696169
Shewanella sp. MR-4	60480	S	2	1	3	0.0000696169
Shewanella violacea	60217	S	3	0	3	0.0000696169
Shewanella marisflavi	260364	S	3	0	3	0.0000696169
Pseudoalteromonas tunicata	314281	S	3	0	3	0.0000696169
Pseudoalteromonas undina	43660	S	2	1	3	0.0000696169
Pseudoalteromonas issachenkonii	152297	S	1	2	3	0.0000696169
Alteromonas macleodii	28108	S	3	0	3	0.0000696169
Alteromonas mediterranea	314275	S	3	0	3	0.0000696169
Marinobacter hydrocarbonoclasticus	2743	S	3	0	3	0.0000696169
Glaciecola amylolytica	2489595	S	3	0	3	0.0000696169
Colwellia sp. MT41	58049	S	3	0	3	0.0000696169
Colwellia sp. PAMC 21821	1816219	S	3	0	3	0.0000696169
Colwellia sp. Arc7-D	2161872	S	3	0	3	0.0000696169
Litorilituus sediminis	718192	S	3	0	3	0.0000696169
Psychromonas ingrahamii	357794	S	3	0	3	0.0000696169
Halomonas sp. YLGW01	2773308	S	3	0	3	0.0000696169
Chromohalobacter salexigens	158080	S	3	0	3	0.0000696169
Alcanivorax dieselolei	285091	S	3	0	3	0.0000696169
Alcanivorax sp. N3-2A	2014542	S	3	0	3	0.0000696169
Nitrincola sp. KXZD1103	2614693	S	3	0	3	0.0000696169
Spartinivicinus ruber	2683272	S	3	0	3	0.0000696169
Vibrio metschnikovii	28172	S	3	0	3	0.0000696169
Vibrio nigripulchritudo	28173	S	3	0	3	0.0000696169
Vibrio furnissii	29494	S	3	0	3	0.0000696169
Actinobacillus succinogenes	67854	S	3	0	3	0.0000696169
Aggregatibacter actinomycetemcomitans	714	S	3	0	3	0.0000696169
Glaesserella parasuis	738	S	3	0	3	0.0000696169
Aeromonas sp. CA23	2033032	S	3	0	3	0.0000696169
Thiocystis violascens	73141	S	3	0	3	0.0000696169
Thioalkalivibrio nitratireducens	186931	S	3	0	3	0.0000696169
Thioalkalivibrio sulfidiphilus	1033854	S	3	0	3	0.0000696169
Acidihalobacter yilgarnenesis	2819280	S	3	0	3	0.0000696169
Halorhodospira halochloris	1052	S	3	0	3	0.0000696169
Legionella sp. PC997	2755562	S	3	0	3	0.0000696169
Legionella lansingensis	45067	S	3	0	3	0.0000696169
Microbulbifer sp. THAF38	2587856	S	3	0	3	0.0000696169
Microbulbifer sp. YPW1	2745199	S	3	0	3	0.0000696169
Microbulbifer agarilyticus	260552	S	3	0	3	0.0000696169
Microbulbifer aggregans	1769779	S	3	0	3	0.0000696169
Kineobactrum salinum	2708301	S	3	0	3	0.0000696169
Spongiibacter sp. CSC3.9	2794344	S	3	0	3	0.0000696169
Candidatus Thioglobus sp. NP1	2508687	S	3	0	3	0.0000696169
Sedimenticola thiotaurini	1543721	S	3	0	3	0.0000696169
Frischella perrara	1267021	S	2	1	3	0.0000696169
Rhizobium sp. NXC24	2048897	S	3	0	3	0.0000696169
Rhizobium sp. Khangiran2	1435607	S	2	1	3	0.0000696169
Rhizobium sp. TAL182	2020313	S	1	2	3	0.0000696169
Rhizobium etli	29449	S	3	0	3	0.0000696169
Rhizobium oryzihabitans	2267833	S	2	1	3	0.0000696169
Agrobacterium rubi	28099	S	3	0	3	0.0000696169
Neorhizobium galegae	399	S	3	0	3	0.0000696169
Mesorhizobium sp. J8	2777475	S	3	0	3	0.0000696169
Mesorhizobium sp. M1E.F.Ca.ET.045.02.1.1	2493672	S	3	0	3	0.0000696169
Aminobacter sp. SR38	2774562	S	1	2	3	0.0000696169
Aminobacter aminovorans	83263	S	2	1	3	0.0000696169
Lentilitoribacter sp. Alg239-R112	2305987	S	3	0	3	0.0000696169
Devosia ginsengisoli	400770	S	3	0	3	0.0000696169
Paradevosia shaoguanensis	1335043	S	2	1	3	0.0000696169
Aureimonas sp. LMG 31693	2758041	S	3	0	3	0.0000696169
Aureimonas populi	1701758	S	3	0	3	0.0000696169
Martelella lutilitoris	2583532	S	3	0	3	0.0000696169
Brucella anthropi	529	S	1	2	3	0.0000696169
Labrenzia sp. PHM005	2590016	S	3	0	3	0.0000696169
Stappia sp. ES.058	1881061	S	3	0	3	0.0000696169
Methylocystis parvus	134	S	3	0	3	0.0000696169
Methylocystis sp. SC2	187303	S	3	0	3	0.0000696169
Bartonella apis	1686310	S	3	0	3	0.0000696169
Chelatococcus sp. CO-6	1702325	S	3	0	3	0.0000696169
Lichenihabitans psoromatis	2528642	S	3	0	3	0.0000696169
Sphingomonas sp. HDW15C	2714944	S	3	0	3	0.0000696169
Sphingomonas sediminicola	386874	S	3	0	3	0.0000696169
Sphingobium sp. TKS	1315974	S	2	1	3	0.0000696169
Sphingobium sp. RSMS	520734	S	1	2	3	0.0000696169
Sphingopyxis sp. QXT-31	1357916	S	3	0	3	0.0000696169
Sphingorhabdus sp. M41	1806885	S	3	0	3	0.0000696169
Zymomonas mobilis	542	S	3	0	3	0.0000696169
Erythrobacter sp. THAF29	2587851	S	3	0	3	0.0000696169
Erythrobacter sp. A30-3	2785907	S	2	1	3	0.0000696169
Altererythrobacter epoxidivorans	361183	S	3	0	3	0.0000696169
Qipengyuania sediminis	1532023	S	3	0	3	0.0000696169
Paracoccus sp. H4-D09	2812658	S	3	0	3	0.0000696169
Paracoccus kondratievae	135740	S	3	0	3	0.0000696169
Sulfitobacter sp. BSw21498	664426	S	3	0	3	0.0000696169
Sulfitobacter sp. AM1-D1	1917485	S	2	1	3	0.0000696169
Leisingera sp. NJS204	2508307	S	2	1	3	0.0000696169
Octadecabacter arcticus	53946	S	3	0	3	0.0000696169
Octadecabacter antarcticus	1217908	S	3	0	3	0.0000696169
Salipiger pacificus	311180	S	3	0	3	0.0000696169
Yangia sp. CCB-MM3	1792508	S	3	0	3	0.0000696169
Roseobacter denitrificans	2434	S	3	0	3	0.0000696169
Roseobacter ponti	1891787	S	3	0	3	0.0000696169
Rhodovulum sulfidophilum	35806	S	3	0	3	0.0000696169
Ketogulonicigenium vulgare	92945	S	3	0	3	0.0000696169
Pelagovum pacificum	2588711	S	3	0	3	0.0000696169
Mameliella alba	561184	S	3	0	3	0.0000696169
Monaibacterium sp. ALG8	2715211	S	3	0	3	0.0000696169
Cognatishimia activa	1715691	S	3	0	3	0.0000696169
Yoonia vestfoldensis	245188	S	3	0	3	0.0000696169
Oceanicola sp. D3	2587163	S	3	0	3	0.0000696169
Pseudorhodobacter turbinis	2500533	S	3	0	3	0.0000696169
Brevundimonas sp. AJA228-03	2752515	S	3	0	3	0.0000696169
Caulobacter sp. K31	366602	S	3	0	3	0.0000696169
Caulobacter rhizosphaerae	2010972	S	3	0	3	0.0000696169
Asticcacaulis excentricus	78587	S	3	0	3	0.0000696169
Acetobacter orientalis	146474	S	3	0	3	0.0000696169
Acetobacter aceti	435	S	3	0	3	0.0000696169
Gluconobacter thailandicus	257438	S	1	2	3	0.0000696169
Acidibrevibacterium fodinaquatile	1969806	S	3	0	3	0.0000696169
Azospirillum sp. TSH100	652764	S	3	0	3	0.0000696169
Azospirillum sp. TSH58	664962	S	2	1	3	0.0000696169
Azospirillum humicireducens	1226968	S	3	0	3	0.0000696169
Rhodospirillum centenum	34018	S	3	0	3	0.0000696169
Magnetospira sp. QH-2	1288970	S	3	0	3	0.0000696169
Rickettsia bellii	33990	S	3	0	3	0.0000696169
Candidatus Phycorickettsia trachydisci	2115978	S	3	0	3	0.0000696169
Neorickettsia helminthoeca	33994	S	3	0	3	0.0000696169
Candidatus Pelagibacter sp. FZCC0015	2268451	S	3	0	3	0.0000696169
Glycocaulis alkaliphilus	1434191	S	3	0	3	0.0000696169
Cystobacter fuscus	43	S	3	0	3	0.0000696169
Geobacter uraniireducens	351604	S	3	0	3	0.0000696169
Geobacter bremensis	60035	S	2	1	3	0.0000696169
Geoalkalibacter subterraneus	483547	S	3	0	3	0.0000696169
Desulfovibrio sp. IOR2	2583823	S	3	0	3	0.0000696169
Desulfovibrio sulfodismutans	63561	S	3	0	3	0.0000696169
Pseudodesulfovibrio profundus	57320	S	3	0	3	0.0000696169
Desulfolutivibrio sulfoxidireducens	2773299	S	3	0	3	0.0000696169
Desulfonema limicola	45656	S	3	0	3	0.0000696169
Desulfarculus baarsii	453230	S	3	0	3	0.0000696169
Arcobacter nitrofigilis	28199	S	3	0	3	0.0000696169
Arcobacter ellisii	913109	S	3	0	3	0.0000696169
Arcobacter cloacae	1054034	S	3	0	3	0.0000696169
Arcobacter aquimarinus	1315211	S	3	0	3	0.0000696169
Malaciobacter canalis	1912871	S	2	1	3	0.0000696169
Campylobacter sp. RM8964	1660074	S	3	0	3	0.0000696169
Candidatus Campylobacter infans	2561898	S	3	0	3	0.0000696169
Campylobacter showae	204	S	3	0	3	0.0000696169
Campylobacter ureolyticus	827	S	3	0	3	0.0000696169
Helicobacter cetorum	138563	S	3	0	3	0.0000696169
Sulfurimonas autotrophica	202747	S	3	0	3	0.0000696169
Nitratiruptor sp. SB155-2	387092	S	1	2	3	0.0000696169
Microlunatus sp. KUDC0627	2596828	S	3	0	3	0.0000696169
Microlunatus sp. Gsoil 973	2672569	S	3	0	3	0.0000696169
Raineyella sp. CBA3103	2662261	S	3	0	3	0.0000696169
Brevilactibacter sp. MC1595	2819349	S	3	0	3	0.0000696169
Nocardioides sp. dk3136	2575373	S	3	0	3	0.0000696169
Nocardioides sp. WS12	2486272	S	3	0	3	0.0000696169
Nocardioides sp. HDW12B	2714939	S	3	0	3	0.0000696169
Nocardioides sp. 603	2483798	S	3	0	3	0.0000696169
Nocardioides daphniae	402297	S	3	0	3	0.0000696169
Nocardioides dokdonensis	450734	S	3	0	3	0.0000696169
Kribbella qitaiheensis	1544730	S	3	0	3	0.0000696169
Actinopolymorpha singaporensis	117157	S	3	0	3	0.0000696169
Arthrobacter sp. PAMC25564	2565366	S	3	0	3	0.0000696169
Arthrobacter sp. PM3	2017685	S	3	0	3	0.0000696169
Arthrobacter sp. U41	1849032	S	3	0	3	0.0000696169
Rothia amarae	169480	S	3	0	3	0.0000696169
Rothia terrae	396015	S	3	0	3	0.0000696169
Neomicrococcus aestuarii	556325	S	3	0	3	0.0000696169
Microbacterium sp. A18JL241	2782166	S	3	0	3	0.0000696169
Microbacterium sp. CBA3102	2603598	S	3	0	3	0.0000696169
Microbacterium sp. XT11	367477	S	3	0	3	0.0000696169
Microbacterium sp. WY121	2782168	S	3	0	3	0.0000696169
Microbacterium sp. TPU 3598	1938334	S	3	0	3	0.0000696169
Microbacterium sp. JZ31	1906274	S	3	0	3	0.0000696169
Microbacterium lushaniae	2614639	S	3	0	3	0.0000696169
Microbacterium caowuchunii	2614638	S	3	0	3	0.0000696169
Microbacterium protaetiae	2509458	S	3	0	3	0.0000696169
Curtobacterium sp. MR_MD2014	1561023	S	3	0	3	0.0000696169
Curtobacterium sp. SGAir0471	2070337	S	3	0	3	0.0000696169
Curtobacterium sp. Csp2	2495430	S	1	2	3	0.0000696169
Rathayibacter sp. VKM Ac-2759	2609252	S	3	0	3	0.0000696169
Rathayibacter sp. VKM Ac-2805	2609258	S	1	2	3	0.0000696169
Agromyces sp. G127AT	2781962	S	3	0	3	0.0000696169
Agromyces protaetiae	2509455	S	3	0	3	0.0000696169
Leucobacter triazinivorans	1784719	S	3	0	3	0.0000696169
Leucobacter muris	1935379	S	3	0	3	0.0000696169
Leucobacter sp. CX169	2813744	S	3	0	3	0.0000696169
Cryobacterium soli	2220095	S	3	0	3	0.0000696169
Plantibacter sp. M259	2583822	S	3	0	3	0.0000696169
Herbiconiux sp. SALV-R1	2735133	S	3	0	3	0.0000696169
Gryllotalpicola protaetiae	2419771	S	3	0	3	0.0000696169
Phycicoccus sp. HDW14	2714941	S	3	0	3	0.0000696169
Brevibacterium sp. PAMC23299	2762330	S	1	2	3	0.0000696169
Brevibacterium oceani	358099	S	3	0	3	0.0000696169
Brachybacterium sp. P6-10-X1	1903186	S	3	0	3	0.0000696169
Brachybacterium vulturis	2017484	S	3	0	3	0.0000696169
Dermabacter vaginalis	1630135	S	3	0	3	0.0000696169
Cellulomonas sp. Y8	2591145	S	3	0	3	0.0000696169
Cellulomonas sp. JZ18	2654191	S	3	0	3	0.0000696169
Oerskovia sp. KBS0722	1179673	S	3	0	3	0.0000696169
Pseudactinotalea sp. HY158	2654547	S	3	0	3	0.0000696169
Ornithinimicrobium sp. HY006	2508882	S	3	0	3	0.0000696169
Cellulosimicrobium sp. BI34T	2587808	S	3	0	3	0.0000696169
Cellulosimicrobium sp. JZ28	1906273	S	2	1	3	0.0000696169
Georgenia faecalis	2483799	S	3	0	3	0.0000696169
Miniimonas sp. S16	2171623	S	3	0	3	0.0000696169
Dermatophilus congolensis	1863	S	3	0	3	0.0000696169
Rhodococcus sp. P-2	2795031	S	3	0	3	0.0000696169
Rhodococcus sp. R79	2811421	S	3	0	3	0.0000696169
Rhodococcus ruber	1830	S	3	0	3	0.0000696169
Rhodococcus koreensis	99653	S	3	0	3	0.0000696169
Rhodococcus jostii	132919	S	3	0	3	0.0000696169
Rhodococcus triatomae	300028	S	3	0	3	0.0000696169
Nocardia sp. CS682	1047172	S	3	0	3	0.0000696169
Corynebacterium sp. sy039	2599641	S	3	0	3	0.0000696169
Corynebacterium sp. ZJ-599	2709394	S	3	0	3	0.0000696169
Corynebacterium vitaeruminis	38305	S	3	0	3	0.0000696169
Corynebacterium timonense	441500	S	3	0	3	0.0000696169
Corynebacterium bovis	36808	S	3	0	3	0.0000696169
Corynebacterium imitans	156978	S	3	0	3	0.0000696169
Corynebacterium simulans	146827	S	3	0	3	0.0000696169
Corynebacterium macginleyi	38290	S	3	0	3	0.0000696169
Corynebacterium choanis	1862358	S	3	0	3	0.0000696169
Corynebacterium diphtheriae	1717	S	3	0	3	0.0000696169
Mycolicibacterium sp. LJ126	2761578	S	3	0	3	0.0000696169
Mycolicibacterium chubuense	1800	S	3	0	3	0.0000696169
Mycolicibacterium fortuitum	1766	S	3	0	3	0.0000696169
Mycolicibacterium sarraceniae	1534348	S	3	0	3	0.0000696169
Mycolicibacterium anyangense	1431246	S	3	0	3	0.0000696169
Mycolicibacterium sediminis	1286180	S	3	0	3	0.0000696169
Mycolicibacterium insubricum	444597	S	3	0	3	0.0000696169
Mycolicibacterium fluoranthenivorans	258505	S	3	0	3	0.0000696169
Mycolicibacterium goodii	134601	S	3	0	3	0.0000696169
Mycolicibacterium doricum	126673	S	3	0	3	0.0000696169
Mycolicibacterium mucogenicum	56689	S	3	0	3	0.0000696169
Mycolicibacterium moriokaense	39691	S	3	0	3	0.0000696169
Mycolicibacterium poriferae	39694	S	1	2	3	0.0000696169
Mycobacterium sp. MS1601	1936029	S	3	0	3	0.0000696169
Mycobacterium marseillense	701042	S	3	0	3	0.0000696169
Mycobacterium shigaense	722731	S	3	0	3	0.0000696169
Mycobacterium dioxanotrophicus	482462	S	3	0	3	0.0000696169
Mycobacterium grossiae	1552759	S	3	0	3	0.0000696169
Mycobacterium branderi	43348	S	3	0	3	0.0000696169
Mycobacterium conspicuum	44010	S	3	0	3	0.0000696169
Mycobacterium lacus	169765	S	3	0	3	0.0000696169
Mycobacterium marinum	1781	S	1	2	3	0.0000696169
Mycolicibacter minnesotensis	1118379	S	3	0	3	0.0000696169
Dietzia sp. oral taxon 368	712270	S	3	0	3	0.0000696169
Dietzia sp. DQ12-45-1b	912801	S	1	2	3	0.0000696169
Dietzia timorensis	499555	S	3	0	3	0.0000696169
Streptomyces sp. CMB-StM0423	2059884	S	3	0	3	0.0000696169
Streptomyces sp. JB150	2714844	S	3	0	3	0.0000696169
Streptomyces sp. GS7	2692234	S	3	0	3	0.0000696169
Streptomyces sp. P3	2135430	S	3	0	3	0.0000696169
Streptomyces sp. DSM 40868	2721173	S	3	0	3	0.0000696169
Streptomyces sp. TLI_053	1855352	S	3	0	3	0.0000696169
Streptomyces sp. PBH53	1577075	S	3	0	3	0.0000696169
Streptomyces sp. CRPJ-33	2768068	S	3	0	3	0.0000696169
Streptomyces sp. Z423-1	2730915	S	3	0	3	0.0000696169
Streptomyces sp. XC 2026	2782004	S	3	0	3	0.0000696169
Streptomyces sp. CB04723	2748873	S	3	0	3	0.0000696169
Streptomyces sp. CLI2509	1984801	S	1	2	3	0.0000696169
Streptomyces formicae	1616117	S	3	0	3	0.0000696169
Streptomyces rimosus	1927	S	3	0	3	0.0000696169
Streptomyces pluripotens	1355015	S	3	0	3	0.0000696169
Streptomyces pactum	68249	S	3	0	3	0.0000696169
Streptomyces xinghaiensis	1038928	S	3	0	3	0.0000696169
Streptomyces coeruleorubidus	116188	S	3	0	3	0.0000696169
Streptomyces glaucescens	1907	S	3	0	3	0.0000696169
Streptomyces koyangensis	188770	S	3	0	3	0.0000696169
Streptomyces albus	1888	S	3	0	3	0.0000696169
Streptomyces nojiriensis	66374	S	3	0	3	0.0000696169
Streptomyces aquilus	2548456	S	3	0	3	0.0000696169
Streptomyces chromofuscus	42881	S	3	0	3	0.0000696169
Streptomyces mobaraensis	35621	S	3	0	3	0.0000696169
Streptomyces tirandamycinicus	2174846	S	3	0	3	0.0000696169
Streptomyces fagopyri	2662397	S	3	0	3	0.0000696169
Streptomyces dengpaensis	2049881	S	3	0	3	0.0000696169
Streptomyces griseoviridis	45398	S	3	0	3	0.0000696169
Amycolatopsis sp. AA4	1896961	S	3	0	3	0.0000696169
Amycolatopsis methanolica	1814	S	3	0	3	0.0000696169
Saccharopolyspora coralli	2665642	S	3	0	3	0.0000696169
Saccharopolyspora pogona	333966	S	2	1	3	0.0000696169
Saccharomonospora marina	632569	S	3	0	3	0.0000696169
Alloactinosynnema sp. L-07	1653480	S	3	0	3	0.0000696169
Micromonospora sp. 28ISP2-46	2749844	S	3	0	3	0.0000696169
Micromonospora rifamycinica	291594	S	3	0	3	0.0000696169
Micromonospora narathiwatensis	299146	S	3	0	3	0.0000696169
Micromonospora viridifaciens	1881	S	3	0	3	0.0000696169
Actinoplanes sp. OR16	946334	S	2	1	3	0.0000696169
Actinomyces sp. Chiba101	1851395	S	3	0	3	0.0000696169
Trueperella sp. 19M2397	2733571	S	1	2	3	0.0000696169
Winkia sp. C64	2692125	S	3	0	3	0.0000696169
Streptosporangium roseum	2001	S	3	0	3	0.0000696169
Actinomadura sp. WMMB 499	1219491	S	3	0	3	0.0000696169
Thermomonospora curvata	2020	S	3	0	3	0.0000696169
Nocardiopsis gilva	280236	S	3	0	3	0.0000696169
Streptomonospora sp. M2	2498135	S	3	0	3	0.0000696169
Candidatus Planktophila dulcis	1884914	S	3	0	3	0.0000696169
Candidatus Nanopelagicus limnes	1884634	S	2	1	3	0.0000696169
Bifidobacterium adolescentis	1680	S	3	0	3	0.0000696169
Bifidobacterium dentium	1689	S	3	0	3	0.0000696169
Candidatus Frankia datiscae	2716812	S	3	0	3	0.0000696169
Olsenella timonensis	1805478	S	3	0	3	0.0000696169
Olsenella sp. oral taxon 807	712411	S	3	0	3	0.0000696169
Staphylococcus sp. M0911	2025492	S	2	1	3	0.0000696169
Staphylococcus simiae	308354	S	3	0	3	0.0000696169
Staphylococcus succinus	61015	S	3	0	3	0.0000696169
Staphylococcus pseudoxylosus	2282419	S	3	0	3	0.0000696169
Staphylococcus pseudintermedius	283734	S	3	0	3	0.0000696169
Macrococcus canis	1855823	S	3	0	3	0.0000696169
Macrococcus bohemicus	1903056	S	2	1	3	0.0000696169
Bacillus sp. FJAT-45348	2011012	S	3	0	3	0.0000696169
Bacillus sp. V3	2795526	S	3	0	3	0.0000696169
Bacillus licheniformis	1402	S	2	1	3	0.0000696169
Bacillus cohnii	33932	S	3	0	3	0.0000696169
Virgibacillus dokdonensis	302167	S	1	2	3	0.0000696169
Lysinibacillus timonensis	2086577	S	3	0	3	0.0000696169
Peribacillus simplex	1478	S	3	0	3	0.0000696169
Anoxybacillus amylolyticus	294699	S	1	2	3	0.0000696169
Pontibacillus sp. HMF3514	2692425	S	3	0	3	0.0000696169
Halobacillus litoralis	45668	S	3	0	3	0.0000696169
Radiobacillus deserti	2594883	S	3	0	3	0.0000696169
Paenibacillus sp. RUD330	2023772	S	3	0	3	0.0000696169
Paenibacillus sp. FSL R7-0273	1536772	S	3	0	3	0.0000696169
Paenibacillus sp. IHBB 10380	1566358	S	3	0	3	0.0000696169
Paenibacillus sabinae	365617	S	3	0	3	0.0000696169
Paenibacillus albus	2495582	S	3	0	3	0.0000696169
Cohnella sp. LGH	1619153	S	3	0	3	0.0000696169
Jeotgalibacillus malaysiensis	1508404	S	3	0	3	0.0000696169
Alicyclobacillus ferrooxydans	471514	S	3	0	3	0.0000696169
Gemella haemolysans	1379	S	3	0	3	0.0000696169
Laceyella sacchari	37482	S	3	0	3	0.0000696169
Streptococcus sp. LPB0220	2610896	S	3	0	3	0.0000696169
Streptococcus australis	113107	S	3	0	3	0.0000696169
Streptococcus chenjunshii	2173853	S	3	0	3	0.0000696169
Streptococcus equinus	1335	S	3	0	3	0.0000696169
Streptococcus suis	1307	S	3	0	3	0.0000696169
Streptococcus gallolyticus	315405	S	3	0	3	0.0000696169
Lactococcus garvieae	1363	S	3	0	3	0.0000696169
Lactococcus raffinolactis	1366	S	3	0	3	0.0000696169
Lactococcus sp. LG1267	2816910	S	1	2	3	0.0000696169
Lactobacillus terrae	2269374	S	3	0	3	0.0000696169
Lactiplantibacillus argentoratensis	271881	S	1	2	3	0.0000696169
Levilactobacillus brevis	1580	S	3	0	3	0.0000696169
Secundilactobacillus paracollinoides	240427	S	3	0	3	0.0000696169
Enterococcus thailandicus	417368	S	3	0	3	0.0000696169
Vagococcus hydrophili	2714947	S	3	0	3	0.0000696169
Carnobacterium inhibens	147709	S	3	0	3	0.0000696169
Jeotgalibaca sp. PTS2502	1903686	S	3	0	3	0.0000696169
Aerococcus urinaeequi	51665	S	3	0	3	0.0000696169
Clostridium sp. DL-VIII	641107	S	3	0	3	0.0000696169
Clostridium sp. BNL1100	755731	S	3	0	3	0.0000696169
Clostridium sp. AWRP	2212991	S	3	0	3	0.0000696169
Clostridium gasigenes	94869	S	3	0	3	0.0000696169
Clostridium acetobutylicum	1488	S	3	0	3	0.0000696169
Clostridium butyricum	1492	S	3	0	3	0.0000696169
Clostridium estertheticum	238834	S	3	0	3	0.0000696169
Clostridium carboxidivorans	217159	S	3	0	3	0.0000696169
Clostridium aceticum	84022	S	3	0	3	0.0000696169
Clostridium septicum	1504	S	3	0	3	0.0000696169
Clostridium tyrobutyricum	1519	S	3	0	3	0.0000696169
Sarcina sp. JB2	2726954	S	3	0	3	0.0000696169
Coprococcus sp. ART55/1	751585	S	3	0	3	0.0000696169
Anaerocolumna cellulosilytica	433286	S	3	0	3	0.0000696169
Roseburia hominis	301301	S	2	1	3	0.0000696169
Lacrimispora sphenoides	29370	S	3	0	3	0.0000696169
Herbinix luporum	1679721	S	3	0	3	0.0000696169
Lachnoanaerobaculum umeaense	617123	S	3	0	3	0.0000696169
Ruminococcus bicirculans	1160721	S	3	0	3	0.0000696169
Ruminococcus sp. JE7A12	2564099	S	3	0	3	0.0000696169
Flavonifractor plautii	292800	S	3	0	3	0.0000696169
Filifactor alocis	143361	S	3	0	3	0.0000696169
Acetoanaerobium sticklandii	1511	S	3	0	3	0.0000696169
Thermaerobacter marianensis	73919	S	3	0	3	0.0000696169
Aminipila butyrica	433296	S	3	0	3	0.0000696169
Heliorestis convoluta	356322	S	3	0	3	0.0000696169
Symbiobacterium thermophilum	2734	S	3	0	3	0.0000696169
Biomaibacter acetigenes	2316383	S	3	0	3	0.0000696169
Selenomonas sp. oral taxon 920	1884263	S	3	0	3	0.0000696169
Phascolarctobacterium sp. Marseille-Q4147	2823317	S	3	0	3	0.0000696169
Keratinibaculum paraultunense	1278232	S	3	0	3	0.0000696169
Gudongella oleilytica	1582259	S	3	0	3	0.0000696169
Turicibacter sanguinis	154288	S	3	0	3	0.0000696169
Nostoc sp. ATCC 53789	76335	S	2	1	3	0.0000696169
Nostoc punctiforme	272131	S	2	1	3	0.0000696169
Calothrix sp. 336/3	1337936	S	3	0	3	0.0000696169
Calothrix sp. NIES-3974	2005462	S	3	0	3	0.0000696169
Tolypothrix sp. PCC 7910	2099387	S	2	1	3	0.0000696169
Synechococcus sp. CBW1004	1353136	S	3	0	3	0.0000696169
Synechococcus sp. PCC 7336	195250	S	3	0	3	0.0000696169
Synechococcus sp. LTW-R	2751170	S	3	0	3	0.0000696169
Synechococcus sp. PCC 7002	32049	S	1	2	3	0.0000696169
Prochlorococcus sp. MIT 0801	1501269	S	1	2	3	0.0000696169
Pseudanabaena sp. PCC 7367	82654	S	3	0	3	0.0000696169
Cyanobacterium aponinum	379064	S	3	0	3	0.0000696169
Gloeobacter violaceus	33072	S	2	1	3	0.0000696169
Mycoplasma mycoides	2102	S	2	1	3	0.0000696169
Mycoplasma alkalescens	45363	S	3	0	3	0.0000696169
Spiroplasma monobiae	2136	S	3	0	3	0.0000696169
Spiroplasma poulsonii	2138	S	3	0	3	0.0000696169
Spiroplasma litorale	216942	S	3	0	3	0.0000696169
Spiroplasma kunkelii	47834	S	1	2	3	0.0000696169
Entomoplasma luminosum	214888	S	3	0	3	0.0000696169
Acholeplasma axanthum	29552	S	3	0	3	0.0000696169
Acholeplasma brassicae	61635	S	3	0	3	0.0000696169
Deinococcus geothermalis	68909	S	3	0	3	0.0000696169
Thermus thermophilus	274	S	2	1	3	0.0000696169
Oceanithermus profundus	187137	S	3	0	3	0.0000696169
Dehalogenimonas formicexedens	1839801	S	2	1	3	0.0000696169
Caldilinea aerophila	133453	S	3	0	3	0.0000696169
Candidatus Promineofilum breve	1806508	S	3	0	3	0.0000696169
Flavobacterium pallidum	2172098	S	3	0	3	0.0000696169
Flavobacterium magnum	2162713	S	3	0	3	0.0000696169
Flavobacterium alkalisoli	2602769	S	3	0	3	0.0000696169
Polaribacter sp. MED152	313598	S	3	0	3	0.0000696169
Winogradskyella sp. PG-2	754409	S	3	0	3	0.0000696169
Maribacter cobaltidurans	1178778	S	2	1	3	0.0000696169
Nonlabens dokdonensis	328515	S	3	0	3	0.0000696169
Nonlabens spongiae	331648	S	3	0	3	0.0000696169
Cellulophaga algicola	59600	S	3	0	3	0.0000696169
Cellulophaga sp. L1A9	2686362	S	3	0	3	0.0000696169
Lacinutrix sp. 5H-3-7-4	983544	S	3	0	3	0.0000696169
Antarcticibacterium flavum	2058175	S	3	0	3	0.0000696169
Muricauda lutaonensis	516051	S	3	0	3	0.0000696169
Aequorivita sp. KX20305	2803865	S	3	0	3	0.0000696169
Siansivirga zeaxanthinifaciens	762954	S	3	0	3	0.0000696169
Flavivirga eckloniae	1803846	S	3	0	3	0.0000696169
Flagellimonas maritima	1383885	S	3	0	3	0.0000696169
Galbibacter sp. BG1	1170699	S	3	0	3	0.0000696169
Zobellia galactanivorans	63186	S	3	0	3	0.0000696169
Chryseobacterium sp. JV274	1932669	S	3	0	3	0.0000696169
Chryseobacterium sp. cx-624	2758037	S	3	0	3	0.0000696169
Chryseobacterium sp. G0186	2487064	S	2	1	3	0.0000696169
Chryseobacterium balustinum	246	S	3	0	3	0.0000696169
Apibacter sp. B3706	2656760	S	2	1	3	0.0000696169
Dyadobacter sp. Q3-56	2747268	S	3	0	3	0.0000696169
Hymenobacter sp. TS19	2735321	S	3	0	3	0.0000696169
Hymenobacter qilianensis	1385715	S	3	0	3	0.0000696169
Pontibacter sp. SGAir0037	2571030	S	3	0	3	0.0000696169
Pontibacter pudoricolor	2694930	S	3	0	3	0.0000696169
Algoriphagus machipongonensis	388413	S	3	0	3	0.0000696169
Belliella baltica	232259	S	3	0	3	0.0000696169
Aquiflexum balticum	280473	S	3	0	3	0.0000696169
Pedobacter cryoconitis	188932	S	3	0	3	0.0000696169
Sphingobacterium hotanense	649196	S	3	0	3	0.0000696169
Mucilaginibacter mallensis	652787	S	3	0	3	0.0000696169
Mucilaginibacter mali	2740462	S	3	0	3	0.0000696169
Niabella soli	446683	S	3	0	3	0.0000696169
Prevotella denticola	28129	S	3	0	3	0.0000696169
Prevotella jejuni	1177574	S	3	0	3	0.0000696169
Alloprevotella sp. E39	2133944	S	3	0	3	0.0000696169
Phocaeicola salanitronis	376805	S	3	0	3	0.0000696169
Alistipes finegoldii	214856	S	3	0	3	0.0000696169
Parabacteroides goldsteinii	328812	S	3	0	3	0.0000696169
Dysgonomonas sp. HDW5B	2714927	S	2	1	3	0.0000696169
Tenuifilum thalassicum	2590900	S	3	0	3	0.0000696169
Alkalitalea saponilacus	889453	S	3	0	3	0.0000696169
Saprospira grandis	1008	S	3	0	3	0.0000696169
Chlorobium phaeobacteroides	1096	S	3	0	3	0.0000696169
Chlorobium chlorochromatii	337090	S	3	0	3	0.0000696169
Gimesia maris	122	S	3	0	3	0.0000696169
Gimesia aquarii	2527964	S	3	0	3	0.0000696169
Gimesia algae	2527971	S	3	0	3	0.0000696169
Gimesia fumaroli	2527976	S	3	0	3	0.0000696169
Planctopirus limnophila	120	S	2	1	3	0.0000696169
Planctopirus ephydatiae	2528019	S	2	1	3	0.0000696169
Crateriforma conspicua	2527996	S	3	0	3	0.0000696169
Thalassoglobus polymorphus	2527994	S	3	0	3	0.0000696169
Botrimarina mediterranea	2528022	S	3	0	3	0.0000696169
Isosphaera pallida	128	S	3	0	3	0.0000696169
Anaerohalosphaera lusitana	1936003	S	3	0	3	0.0000696169
Candidatus Kuenenia stuttgartiensis	174633	S	3	0	3	0.0000696169
Coraliomargarita akajimensis	395922	S	3	0	3	0.0000696169
Methylacidiphilum sp. IT5	2795384	S	2	1	3	0.0000696169
Parachlamydia acanthamoebae	83552	S	3	0	3	0.0000696169
Borrelia coriaceae	144	S	3	0	3	0.0000696169
Treponema sp. OMZ 804	120683	S	3	0	3	0.0000696169
Treponema primitia	88058	S	3	0	3	0.0000696169
Brachyspira hyodysenteriae	159	S	3	0	3	0.0000696169
Brachyspira hampsonii	1287055	S	3	0	3	0.0000696169
Ilyobacter polytropus	167642	S	3	0	3	0.0000696169
Pseudoleptotrichia goodfellowii	157692	S	3	0	3	0.0000696169
Acidobacterium capsulatum	33075	S	3	0	3	0.0000696169
Acidisarcina polymorpha	2211140	S	3	0	3	0.0000696169
Chloracidobacterium thermophilum	458033	S	3	0	3	0.0000696169
Thermosipho sp. 1070	1437364	S	1	2	3	0.0000696169
Marinitoga piezophila	149715	S	1	2	3	0.0000696169
Defluviitoga tunisiensis	1006576	S	3	0	3	0.0000696169
Candidatus Saccharimonas aalborgensis	1332188	S	3	0	3	0.0000696169
Candidatus Babela massiliensis	673862	S	3	0	3	0.0000696169
Thermovirga lienii	336261	S	3	0	3	0.0000696169
Caldimicrobium thiodismutans	1653476	S	3	0	3	0.0000696169
Halorubrum sp. PV6	634157	S	3	0	3	0.0000696169
Halogeometricum borinquense	60847	S	3	0	3	0.0000696169
Natronomonas moolapensis	416273	S	3	0	3	0.0000696169
Halosimplex pelagicum	869886	S	3	0	3	0.0000696169
Haloterrigena sp. KZCA68	2816475	S	3	0	3	0.0000696169
Methanosarcina siciliae	38027	S	3	0	3	0.0000696169
Methanofollis liminatans	2201	S	3	0	3	0.0000696169
Methanobrevibacter ruminantium	83816	S	3	0	3	0.0000696169
Methanobrevibacter millerae	230361	S	3	0	3	0.0000696169
Nitrosarchaeum sp. AC2	2259673	S	3	0	3	0.0000696169
Conexivisphaera calida	1874277	S	2	1	3	0.0000696169
Lactococcus phage 63302	2029670	S	2	1	3	0.0000696169
Pseudomonas virus PaMx25	1982241	S	1	2	3	0.0000696169
Edwardsiella phage PEi20	1608310	S	3	0	3	0.0000696169
Burkholderia virus BcepNY3	446807	S	3	0	3	0.0000696169
Only Syngen Nebraska virus 5	1917232	S	2	1	3	0.0000696169
Yellowstone lake phycodnavirus 3	1586715	S	3	0	3	0.0000696169
Acanthamoeba polyphaga mimivirus	212035	S	1	2	3	0.0000696169
Beihai picorna-like virus 119	1922548	S	3	0	3	0.0000696169
Pandoravirus salinus	1349410	S	3	0	3	0.0000696169
Delftia sp. HK171	1920191	S	1	1	2	0.0000464113
Ralstonia insidiosa	190721	S	2	0	2	0.0000464113
Burkholderia territorii	1503055	S	2	0	2	0.0000464113
Burkholderia stabilis	95485	S	2	0	2	0.0000464113
Burkholderia metallica	488729	S	2	0	2	0.0000464113
Burkholderia sp. BDU8	1385592	S	2	0	2	0.0000464113
Burkholderia sp. MS389	2811789	S	2	0	2	0.0000464113
Cupriavidus neocaledonicus	1040979	S	2	0	2	0.0000464113
Polynucleobacter wuianus	1743168	S	2	0	2	0.0000464113
Polynucleobacter paneuropaeus	2527775	S	2	0	2	0.0000464113
Paraburkholderia sp. SOS3	1926494	S	2	0	2	0.0000464113
Paraburkholderia phytofirmans	261302	S	2	0	2	0.0000464113
Paraburkholderia terrae	311230	S	1	1	2	0.0000464113
Pandoraea apista	93218	S	2	0	2	0.0000464113
Pandoraea pulmonicola	93221	S	2	0	2	0.0000464113
Mycoavidus sp. B2-EB	2651972	S	2	0	2	0.0000464113
Ephemeroptericola cinctiostellae	2268024	S	2	0	2	0.0000464113
Herbaspirillum sp. meg3	2025949	S	2	0	2	0.0000464113
Undibacterium sp. YM2	2058625	S	2	0	2	0.0000464113
Achromobacter sp. MFA1 R4	1881016	S	2	0	2	0.0000464113
Achromobacter insolitus	217204	S	2	0	2	0.0000464113
Bordetella petrii	94624	S	2	0	2	0.0000464113
Pusillimonas thiosulfatoxidans	2028345	S	2	0	2	0.0000464113
Kerstersia gyiorum	206506	S	2	0	2	0.0000464113
Sutterella faecalis	2584944	S	2	0	2	0.0000464113
Azoarcus sp. KH32C	748247	S	2	0	2	0.0000464113
Chromobacterium phragmitis	2202141	S	2	0	2	0.0000464113
Iodobacter fluviatilis	537	S	2	0	2	0.0000464113
Iodobacter sp. H11R3	2496266	S	2	0	2	0.0000464113
Aquitalea magnusonii	332411	S	2	0	2	0.0000464113
Chitinibacter fontanus	1737446	S	2	0	2	0.0000464113
Chitinibacter sp. 2T18	2739434	S	2	0	2	0.0000464113
Microvirgula aerodenitrificans	57480	S	2	0	2	0.0000464113
Deefgea sp. D17	2739061	S	2	0	2	0.0000464113
Neisseria subflava	28449	S	2	0	2	0.0000464113
Kingella denitrificans	502	S	2	0	2	0.0000464113
Kingella kingae	504	S	2	0	2	0.0000464113
Simonsiella muelleri	72	S	2	0	2	0.0000464113
Methylophilus sp. TWE2	1662285	S	2	0	2	0.0000464113
Nitrosospira multiformis	1231	S	2	0	2	0.0000464113
Sulfuriferula plumbiphila	171865	S	2	0	2	0.0000464113
Sulfuriferula sp. AH1	1985873	S	2	0	2	0.0000464113
Sulfuricella denitrificans	649841	S	2	0	2	0.0000464113
Thiobacillus denitrificans	36861	S	2	0	2	0.0000464113
Candidatus Profftella armatura (Diaphorina cf. continua)	2661583	S	2	0	2	0.0000464113
Pseudomonas sp. StFLB209	1028989	S	2	0	2	0.0000464113
Pseudomonas sp. DG56-2	2320270	S	2	0	2	0.0000464113
Pseudomonas sp. ATCC 13867	1294143	S	2	0	2	0.0000464113
Pseudomonas sp. LBUM920	2126069	S	2	0	2	0.0000464113
Pseudomonas sp. C27(2019)	2604941	S	2	0	2	0.0000464113
Pseudomonas sp. LPB0260	2614442	S	2	0	2	0.0000464113
Pseudomonas sp. DTU12.3	2073078	S	2	0	2	0.0000464113
Pseudomonas sp. SCB32	2653853	S	2	0	2	0.0000464113
Pseudomonas sp. BIGb0427	2724470	S	2	0	2	0.0000464113
Pseudomonas sp. R5-89-07	658644	S	2	0	2	0.0000464113
Pseudomonas sp. R32	1573704	S	2	0	2	0.0000464113
Pseudomonas sp. IB20	1702250	S	2	0	2	0.0000464113
Pseudomonas sp. CMR5c	658630	S	2	0	2	0.0000464113
Pseudomonas sp. ABC1	2748080	S	2	0	2	0.0000464113
Pseudomonas sp. RtIB026	2749999	S	2	0	2	0.0000464113
Pseudomonas sp. LAB-08	143813	S	2	0	2	0.0000464113
Pseudomonas sp. DY-1	1755504	S	2	0	2	0.0000464113
Pseudomonas sp. PONIH3	1636610	S	1	1	2	0.0000464113
Pseudomonas migulae	78543	S	2	0	2	0.0000464113
Pseudomonas saudiphocaensis	1499686	S	2	0	2	0.0000464113
Pseudomonas allokribbensis	2774460	S	2	0	2	0.0000464113
Pseudomonas litoralis	797277	S	2	0	2	0.0000464113
Pseudomonas cremoricolorata	157783	S	2	0	2	0.0000464113
Pseudomonas graminis	158627	S	2	0	2	0.0000464113
Pseudomonas palleroniana	191390	S	2	0	2	0.0000464113
Pseudomonas frederiksbergensis	104087	S	2	0	2	0.0000464113
Pseudomonas glycinae	1785145	S	1	1	2	0.0000464113
Pseudomonas soli	1306993	S	1	1	2	0.0000464113
Oblitimonas alkaliphila	1697053	S	2	0	2	0.0000464113
Acinetobacter calcoaceticus	471	S	2	0	2	0.0000464113
Acinetobacter sp. TGL-Y2	1407071	S	2	0	2	0.0000464113
Acinetobacter sp. ACNIH1	1636603	S	2	0	2	0.0000464113
Acinetobacter sp. NEB149	2725684	S	1	1	2	0.0000464113
Acinetobacter gyllenbergii	134534	S	2	0	2	0.0000464113
Acinetobacter shaoyimingii	2715164	S	2	0	2	0.0000464113
Acinetobacter piscicola	2006115	S	2	0	2	0.0000464113
Acinetobacter chinensis	2004650	S	2	0	2	0.0000464113
Moraxella bovoculi	386891	S	2	0	2	0.0000464113
Psychrobacter sp.	56811	S	2	0	2	0.0000464113
Psychrobacter sp. YP14	2203895	S	1	1	2	0.0000464113
Psychrobacter sp. P11G5	1699624	S	1	1	2	0.0000464113
Psychrobacter arenosus	256326	S	2	0	2	0.0000464113
Klebsiella oxytoca	571	S	2	0	2	0.0000464113
Enterobacter cancerogenus	69218	S	2	0	2	0.0000464113
Enterobacter chengduensis	2494701	S	2	0	2	0.0000464113
Citrobacter cronae	1748967	S	1	1	2	0.0000464113
Leclercia sp. J807	2681307	S	2	0	2	0.0000464113
Cronobacter sakazakii	28141	S	2	0	2	0.0000464113
Cronobacter malonaticus	413503	S	2	0	2	0.0000464113
Kosakonia cowanii	208223	S	2	0	2	0.0000464113
Kosakonia pseudosacchari	1646340	S	2	0	2	0.0000464113
Enterobacteriaceae endosymbiont of Plateumaris pusilla	2675795	S	2	0	2	0.0000464113
Enterobacteriaceae endosymbiont of Donacia vulgaris	2675789	S	2	0	2	0.0000464113
Blochmannia endosymbiont of Camponotus nipponensis	2681986	S	1	1	2	0.0000464113
Candidatus Hamiltonella defensa	138072	S	2	0	2	0.0000464113
Pluralibacter gergoviae	61647	S	2	0	2	0.0000464113
Kluyvera intermedia	61648	S	2	0	2	0.0000464113
Yokenella regensburgei	158877	S	2	0	2	0.0000464113
Pantoea sp. SO10	2575375	S	2	0	2	0.0000464113
Pantoea ananatis	553	S	2	0	2	0.0000464113
Candidatus Pantoea carbekii	1235990	S	2	0	2	0.0000464113
Erwinia persicina	55211	S	2	0	2	0.0000464113
Mixta gaviniae	665914	S	2	0	2	0.0000464113
Mixta intestinalis	1615494	S	2	0	2	0.0000464113
Serratia odorifera	618	S	2	0	2	0.0000464113
Serratia proteamaculans	28151	S	2	0	2	0.0000464113
Serratia symbiotica	138074	S	2	0	2	0.0000464113
Yersinia mollaretii	33060	S	2	0	2	0.0000464113
Yersinia aleksiciae	263819	S	2	0	2	0.0000464113
Gibbsiella quercinecans	929813	S	2	0	2	0.0000464113
Rouxiella badensis	1646377	S	2	0	2	0.0000464113
Proteus vulgaris	585	S	2	0	2	0.0000464113
Providencia rustigianii	158850	S	2	0	2	0.0000464113
Providencia heimbachae	333962	S	2	0	2	0.0000464113
Providencia rettgeri	587	S	1	1	2	0.0000464113
Xenorhabdus doucetiae	351671	S	2	0	2	0.0000464113
Arsenophonus nasoniae	638	S	2	0	2	0.0000464113
Photorhabdus thracensis	230089	S	2	0	2	0.0000464113
Photorhabdus laumondii	2218628	S	2	0	2	0.0000464113
Pectobacterium atrosepticum	29471	S	2	0	2	0.0000464113
Pectobacterium brasiliense	180957	S	2	0	2	0.0000464113
Dickeya dadantii	204038	S	2	0	2	0.0000464113
Dickeya zeae	204042	S	2	0	2	0.0000464113
Dickeya fangzhongdai	1778540	S	2	0	2	0.0000464113
Obesumbacterium proteus	82983	S	2	0	2	0.0000464113
Candidatus Sodalis pierantonius	1486991	S	2	0	2	0.0000464113
Stenotrophomonas sp. ESTM1D_MKCIP4_1	2072414	S	2	0	2	0.0000464113
Stenotrophomonas sp. NA06056	2742129	S	2	0	2	0.0000464113
Xanthomonas theicola	56464	S	2	0	2	0.0000464113
Lysobacter sp. H23M41	2781023	S	1	1	2	0.0000464113
Lysobacter arenosi	2795387	S	2	0	2	0.0000464113
Luteimonas sp. JM171	1896164	S	2	0	2	0.0000464113
Luteimonas sp. MC1825	2761107	S	2	0	2	0.0000464113
Thermomonas sp. SY21	2202149	S	2	0	2	0.0000464113
Rhodanobacter sp. FDAARGOS 1247	2778082	S	2	0	2	0.0000464113
Dyella thiooxydans	445710	S	2	0	2	0.0000464113
Dyella caseinilytica	1849581	S	2	0	2	0.0000464113
Shewanella sp. Arc9-LZ	2698686	S	2	0	2	0.0000464113
Shewanella sp. MEBiC00475	2575361	S	1	1	2	0.0000464113
Shewanella benthica	43661	S	2	0	2	0.0000464113
Shewanella khirikhana	1965282	S	2	0	2	0.0000464113
Shewanella psychrophila	225848	S	2	0	2	0.0000464113
Shewanella polaris	2588449	S	1	1	2	0.0000464113
Pseudoalteromonas sp. Bsw20308	283699	S	1	1	2	0.0000464113
Pseudoalteromonas spongiae	298657	S	2	0	2	0.0000464113
Pseudoalteromonas rubra	43658	S	2	0	2	0.0000464113
Pseudoalteromonas piscicida	43662	S	2	0	2	0.0000464113
Pseudoalteromonas ulvae	107327	S	2	0	2	0.0000464113
Pseudoalteromonas prydzensis	182141	S	2	0	2	0.0000464113
Pseudoalteromonas phenolica	161398	S	2	0	2	0.0000464113
Psychrosphaera sp. MTZ26	2820710	S	2	0	2	0.0000464113
Paraglaciecola sp. L3A3	2686358	S	2	0	2	0.0000464113
Paraglaciecola psychrophila	326544	S	2	0	2	0.0000464113
Colwellia sp. 20A7	2689569	S	2	0	2	0.0000464113
Thalassotalea sp. PS06	2594005	S	2	0	2	0.0000464113
Moritella yayanosii	69539	S	2	0	2	0.0000464113
Moritella marina	90736	S	2	0	2	0.0000464113
Halomonas sp. A40-4	2785909	S	2	0	2	0.0000464113
Halomonas aestuarii	1897729	S	2	0	2	0.0000464113
Halomonas titanicae	664683	S	1	1	2	0.0000464113
Candidatus Carsonella ruddii	114186	S	2	0	2	0.0000464113
Candidatus Portiera aleyrodidarum	91844	S	2	0	2	0.0000464113
Kushneria marisflavi	157779	S	2	0	2	0.0000464113
Kushneria konosiri	698828	S	2	0	2	0.0000464113
Halotalea alkalilenta	376489	S	2	0	2	0.0000464113
Pistricoccus aurantiacus	1883414	S	2	0	2	0.0000464113
Alcanivorax xenomutans	1094342	S	2	0	2	0.0000464113
Alcanivorax pacificus	1306787	S	2	0	2	0.0000464113
Neptunomonas japonica	417574	S	2	0	2	0.0000464113
Reinekea forsetii	1336806	S	2	0	2	0.0000464113
Gynuella sunshinyii	1445505	S	2	0	2	0.0000464113
Vibrio taketomensis	2572923	S	2	0	2	0.0000464113
Vibrio spartinae	1918945	S	2	0	2	0.0000464113
Vibrio aphrogenes	1891186	S	2	0	2	0.0000464113
Vibrio cidicii	1763883	S	2	0	2	0.0000464113
Vibrio tritonius	1435069	S	2	0	2	0.0000464113
Vibrio mimicus	674	S	2	0	2	0.0000464113
Vibrio cincinnatiensis	675	S	2	0	2	0.0000464113
Vibrio fluvialis	676	S	2	0	2	0.0000464113
Aliivibrio fischeri	668	S	2	0	2	0.0000464113
Mannheimia varigena	85404	S	2	0	2	0.0000464113
Bisgaardia hudsonensis	109472	S	2	0	2	0.0000464113
Rodentibacter sp. DSM 111151	2778911	S	2	0	2	0.0000464113
Aeromonas salmonicida	645	S	2	0	2	0.0000464113
Aeromonas simiae	218936	S	2	0	2	0.0000464113
Succinivibrio dextrinosolvens	83771	S	2	0	2	0.0000464113
Rheinheimera sp. F8	1763998	S	2	0	2	0.0000464113
Nitrosococcus oceani	1229	S	2	0	2	0.0000464113
Candidatus Nitrosacidococcus tergens	553981	S	2	0	2	0.0000464113
Acidihalobacter ferrooxydans	1765967	S	2	0	2	0.0000464113
Alkalilimnicola ehrlichii	351052	S	2	0	2	0.0000464113
Aquisalimonas sp. 2447	2740807	S	2	0	2	0.0000464113
Thiohalobacter thiocyanaticus	585455	S	2	0	2	0.0000464113
Halothiobacillus sp. LS2	1860122	S	2	0	2	0.0000464113
Granulosicoccus antarcticus	437505	S	2	0	2	0.0000464113
Sulfurivermis fontis	1972068	S	2	0	2	0.0000464113
Legionella sp. TUM19329	2708020	S	2	0	2	0.0000464113
Legionella hackeliae	449	S	2	0	2	0.0000464113
Legionella geestiana	45065	S	2	0	2	0.0000464113
Legionella sainthelensi	28087	S	2	0	2	0.0000464113
Legionella cherrii	28084	S	2	0	2	0.0000464113
Legionella spiritensis	452	S	2	0	2	0.0000464113
Halioglobus japonicus	930805	S	2	0	2	0.0000464113
Congregibacter litoralis	393662	S	2	0	2	0.0000464113
Cellvibrio sp. KY-YJ-3	454662	S	2	0	2	0.0000464113
Cellvibrio sp. PSBB023	1945512	S	2	0	2	0.0000464113
Teredinibacter purpureus	2731756	S	2	0	2	0.0000464113
Agarilytica rhodophyticola	1737490	S	2	0	2	0.0000464113
Thiomicrorhabdus aquaedulcis	2211106	S	2	0	2	0.0000464113
Thiomicrospira sp. S5	1803865	S	2	0	2	0.0000464113
Francisella halioticida	549298	S	2	0	2	0.0000464113
Beggiatoa leptomitoformis	288004	S	2	0	2	0.0000464113
Methylomonas sp. LL1	2785785	S	2	0	2	0.0000464113
Methylomonas methanica	421	S	2	0	2	0.0000464113
Methylococcus capsulatus	414	S	2	0	2	0.0000464113
Methylomicrobium album	39775	S	2	0	2	0.0000464113
Methylocaldum marinum	1432792	S	2	0	2	0.0000464113
Methylovulum psychrotolerans	1704499	S	2	0	2	0.0000464113
Bathymodiolus septemdierum thioautotrophic gill symbiont	113267	S	2	0	2	0.0000464113
Candidatus Vesicomyosocius sp. SY067_SCS001	2732590	S	1	1	2	0.0000464113
Candidatus Thioglobus singularis	1427364	S	2	0	2	0.0000464113
Steroidobacter denitrificans	465721	S	2	0	2	0.0000464113
Immundisolibacter cernigliae	1810504	S	2	0	2	0.0000464113
Bradyrhizobium zhanjiangense	1325107	S	2	0	2	0.0000464113
Nitrobacter hamburgensis	912	S	2	0	2	0.0000464113
Rhizobium sp. BG4	2613770	S	2	0	2	0.0000464113
Rhizobium sp. CIAT894	2020312	S	2	0	2	0.0000464113
Rhizobium sp. 11515TR	2028343	S	2	0	2	0.0000464113
Rhizobium sp. TCK	136098	S	1	1	2	0.0000464113
Rhizobium sp. NIBRBAC000502774	2590777	S	1	1	2	0.0000464113
Rhizobium binae	1138190	S	2	0	2	0.0000464113
Rhizobium indicum	2583231	S	2	0	2	0.0000464113
Rhizobium jaguaris	1312183	S	2	0	2	0.0000464113
Rhizobium pseudoryzae	379684	S	2	0	2	0.0000464113
Neorhizobium sp. SOG26	2060726	S	2	0	2	0.0000464113
Sinorhizobium americanum	194963	S	2	0	2	0.0000464113
Ensifer alkalisoli	1752398	S	2	0	2	0.0000464113
Ensifer sp. PDNC004	2811423	S	2	0	2	0.0000464113
Candidatus Liberibacter africanus	34020	S	2	0	2	0.0000464113
Mesorhizobium sp. M1D.F.Ca.ET.043.01.1.1	2493669	S	2	0	2	0.0000464113
Mesorhizobium sp. M7D.F.Ca.US.005.01.1.1	2493678	S	2	0	2	0.0000464113
Mesorhizobium sp. M9A.F.Ca.ET.002.03.1.2	2493668	S	2	0	2	0.0000464113
Mesorhizobium sp. DCY119	2108445	S	2	0	2	0.0000464113
Mesorhizobium sp. 8	2584466	S	2	0	2	0.0000464113
Mesorhizobium sp. M2A.F.Ca.ET.043.02.1.1	2493670	S	1	1	2	0.0000464113
Mesorhizobium huakuii	28104	S	2	0	2	0.0000464113
Mesorhizobium japonicum	2066070	S	2	0	2	0.0000464113
Nitratireductor sp. OM-1	1756988	S	2	0	2	0.0000464113
Phyllobacterium zundukense	1867719	S	2	0	2	0.0000464113
Phyllobacterium sp. 628	2718938	S	2	0	2	0.0000464113
Devosia sp. MC521	2759954	S	2	0	2	0.0000464113
Rhodomicrobium vannielii	1069	S	2	0	2	0.0000464113
Rhodoplanes sp. Z2-YC6860	674703	S	2	0	2	0.0000464113
Maritalea myrionectae	454601	S	2	0	2	0.0000464113
Pelagibacterium halotolerans	531813	S	2	0	2	0.0000464113
Methyloligella sp. GL2	2742204	S	2	0	2	0.0000464113
Youhaiella tibetensis	1447062	S	2	0	2	0.0000464113
Ancylobacter pratisalsi	1745854	S	2	0	2	0.0000464113
Brucella sp. 09RB8910	1844051	S	1	1	2	0.0000464113
Brucella sp. 2280	2592625	S	1	1	2	0.0000464113
Labrenzia sp. CP4	1674922	S	1	1	2	0.0000464113
Pseudovibrio sp. FO-BEG1	911045	S	2	0	2	0.0000464113
Methylocystis rosea	173366	S	2	0	2	0.0000464113
Bartonella sp. HY038	2759660	S	2	0	2	0.0000464113
Bartonella alsatica	52764	S	2	0	2	0.0000464113
Bartonella elizabethae	807	S	1	1	2	0.0000464113
Nordella sp. HKS 07	2712222	S	2	0	2	0.0000464113
Candidatus Hodgkinia cicadicola	573658	S	2	0	2	0.0000464113
Cohaesibacter sp. ES.047	1798205	S	2	0	2	0.0000464113
Sphingomonas sp. HDW15B	2714943	S	2	0	2	0.0000464113
Sphingomonas lutea	1045317	S	2	0	2	0.0000464113
Sphingomonas rhizophila	2071607	S	2	0	2	0.0000464113
Sphingobium sp. PAMC28499	2565554	S	2	0	2	0.0000464113
Sphingobium cloacae	120107	S	1	1	2	0.0000464113
Parasphingopyxis algicola	2026624	S	2	0	2	0.0000464113
Erythrobacter sp. HL-111	1798193	S	2	0	2	0.0000464113
Erythrobacter mangrovi	2739433	S	2	0	2	0.0000464113
Porphyrobacter sp. HT-58-2	2023229	S	2	0	2	0.0000464113
Tsuneonella mangrovi	1982042	S	2	0	2	0.0000464113
Altererythrobacter sp. ZODW24	2185142	S	2	0	2	0.0000464113
Altererythrobacter atlanticus	1267766	S	2	0	2	0.0000464113
Paracoccus aminovorans	34004	S	2	0	2	0.0000464113
Sulfitobacter sp. SK012	1389005	S	2	0	2	0.0000464113
Sulfitobacter sp. D7	1968541	S	2	0	2	0.0000464113
Sulfitobacter pontiacus	60137	S	1	1	2	0.0000464113
Celeribacter marinus	1397108	S	2	0	2	0.0000464113
Roseovarius sp. THAF8	2587846	S	1	1	2	0.0000464113
Leisingera methylohalidivorans	133924	S	2	0	2	0.0000464113
Leisingera aquaemixtae	1396826	S	2	0	2	0.0000464113
Salipiger profundus	1229727	S	2	0	2	0.0000464113
Marinovum algicola	42444	S	2	0	2	0.0000464113
Thioclava electrotropha	1549850	S	1	1	2	0.0000464113
Boseongicola sp. CCM32	2552942	S	2	0	2	0.0000464113
Epibacterium mobile	379347	S	2	0	2	0.0000464113
Profundibacter amoris	2171755	S	2	0	2	0.0000464113
Rhodobaca barguzinensis	441209	S	2	0	2	0.0000464113
Brevundimonas diminuta	293	S	1	1	2	0.0000464113
Caulobacter henricii	69395	S	2	0	2	0.0000464113
Phenylobacterium parvum	2201350	S	2	0	2	0.0000464113
Komagataeibacter europaeus	33995	S	1	1	2	0.0000464113
Komagataeibacter nataicola	265960	S	1	1	2	0.0000464113
Neokomagataea tanensis	661191	S	2	0	2	0.0000464113
Azospirillum lipoferum	193	S	2	0	2	0.0000464113
Azospirillum thiophilum	528244	S	2	0	2	0.0000464113
Azospirillum ramasamyi	682998	S	2	0	2	0.0000464113
Magnetospirillum sp. ME-1	1639348	S	2	0	2	0.0000464113
Thalassospira marina	2048283	S	2	0	2	0.0000464113
Thalassospira indica	1891279	S	1	1	2	0.0000464113
Thalassospira sp. A40-3	2785908	S	1	1	2	0.0000464113
Pararhodospirillum photometricum	1084	S	2	0	2	0.0000464113
Indioceanicola profundi	2220096	S	2	0	2	0.0000464113
Rickettsia akari	786	S	1	1	2	0.0000464113
Rickettsia prowazekii	782	S	2	0	2	0.0000464113
Orientia tsutsugamushi	784	S	2	0	2	0.0000464113
Ehrlichia canis	944	S	2	0	2	0.0000464113
Wolbachia endosymbiont of Dirofilaria (Dirofilaria) immitis	1812115	S	2	0	2	0.0000464113
Candidatus Midichloria mitochondrii	234827	S	2	0	2	0.0000464113
Phreatobacter stygius	1940610	S	2	0	2	0.0000464113
Phreatobacter sp. NMCR1094	2570229	S	2	0	2	0.0000464113
Hyphomonas sp. Mor2	1906738	S	2	0	2	0.0000464113
Candidatus Pelagibacter sp. RS39	1977864	S	2	0	2	0.0000464113
Candidatus Fonsibacter ubiquis	1925548	S	2	0	2	0.0000464113
Candidatus Paracaedibacter acanthamoebae	91604	S	2	0	2	0.0000464113
Magnetococcus marinus	1124597	S	2	0	2	0.0000464113
Myxococcus stipitatus	83455	S	2	0	2	0.0000464113
Myxococcus hansupus	1297742	S	2	0	2	0.0000464113
Myxococcus sp. SCHIC003	2813577	S	2	0	2	0.0000464113
Geobacter sp. M18	443143	S	2	0	2	0.0000464113
Geobacter sp. M21	443144	S	1	1	2	0.0000464113
Geobacter bemidjiensis	225194	S	1	1	2	0.0000464113
Desulfovibrio gigas	879	S	2	0	2	0.0000464113
Desulfovibrio carbinoliphilus	345370	S	2	0	2	0.0000464113
Candidatus Desulfovibrio trichonymphae	1725232	S	2	0	2	0.0000464113
Pseudodesulfovibrio cashew	2678688	S	2	0	2	0.0000464113
Desulfomicrobium baculatum	899	S	2	0	2	0.0000464113
Desulfosarcina ovata	83564	S	2	0	2	0.0000464113
Desulfosarcina widdelii	947919	S	2	0	2	0.0000464113
Desulfococcus multivorans	897	S	2	0	2	0.0000464113
Desulfococcus oleovorans	181663	S	2	0	2	0.0000464113
Desulfobacter hydrogenophilus	2291	S	2	0	2	0.0000464113
Desulfobacter postgatei	2293	S	2	0	2	0.0000464113
Desulfobacca acetoxidans	60893	S	2	0	2	0.0000464113
Candidatus Desulfofervidus auxilii	1621989	S	2	0	2	0.0000464113
Aliarcobacter skirrowii	28200	S	2	0	2	0.0000464113
Arcobacter defluvii	873191	S	2	0	2	0.0000464113
Arcobacter anaerophilus	877500	S	2	0	2	0.0000464113
Arcobacter suis	1278212	S	2	0	2	0.0000464113
Malaciobacter halophilus	197482	S	2	0	2	0.0000464113
Malaciobacter molluscorum	1032072	S	2	0	2	0.0000464113
Pseudoarcobacter acticola	1849015	S	2	0	2	0.0000464113
Halarcobacter ebronensis	1462615	S	2	0	2	0.0000464113
Campylobacter sp. RM6914	1032243	S	2	0	2	0.0000464113
Campylobacter avium	522485	S	2	0	2	0.0000464113
Campylobacter lanienae	75658	S	2	0	2	0.0000464113
Campylobacter corcagiensis	1448857	S	2	0	2	0.0000464113
Campylobacter sputorum	206	S	2	0	2	0.0000464113
Campylobacter pinnipediorum	1965231	S	2	0	2	0.0000464113
Campylobacter curvus	200	S	2	0	2	0.0000464113
Campylobacter concisus	199	S	2	0	2	0.0000464113
Sulfurimonas sp. B2	2590551	S	2	0	2	0.0000464113
Nitratifractor salsuginis	269261	S	2	0	2	0.0000464113
Nitratiruptor labii	2706014	S	2	0	2	0.0000464113
Bdellovibrio sp. ZAP7	2231053	S	2	0	2	0.0000464113
Halobacteriovorax marinus	97084	S	2	0	2	0.0000464113
Halobacteriovorax sp. BALOs_7	2109558	S	2	0	2	0.0000464113
Tessaracoccus flavus	1610493	S	2	0	2	0.0000464113
Acidipropionibacterium virtanenii	2057246	S	2	0	2	0.0000464113
Propionimicrobium sp. Marseille-P3275	1871034	S	2	0	2	0.0000464113
Nocardioides sp. HY056	2500546	S	2	0	2	0.0000464113
Nocardioides sp. ZJ1313	2685869	S	2	0	2	0.0000464113
Nocardioides sp. HDW12A	2714938	S	2	0	2	0.0000464113
Nocardioides baekrokdamisoli	1804624	S	2	0	2	0.0000464113
Nocardioides houyundeii	2045452	S	2	0	2	0.0000464113
Nocardioides sambongensis	2589074	S	2	0	2	0.0000464113
Aeromicrobium sp. A1-2	2107713	S	2	0	2	0.0000464113
Aeromicrobium marinum	219314	S	2	0	2	0.0000464113
Aeromicrobium choanae	1736691	S	2	0	2	0.0000464113
Aeromicrobium yanjiei	2662028	S	2	0	2	0.0000464113
Kribbella flavida	182640	S	2	0	2	0.0000464113
Kocuria flava	446860	S	2	0	2	0.0000464113
Kocuria indica	1049583	S	2	0	2	0.0000464113
Micrococcus sp. A1	404583	S	1	1	2	0.0000464113
Arthrobacter sp. QXT-31	1357915	S	2	0	2	0.0000464113
Arthrobacter citreus	1670	S	2	0	2	0.0000464113
Pseudarthrobacter sp. YJ56	2697569	S	2	0	2	0.0000464113
Pseudarthrobacter chlorophenolicus	85085	S	2	0	2	0.0000464113
Pseudarthrobacter equi	728066	S	2	0	2	0.0000464113
Glutamicibacter protophormiae	37930	S	2	0	2	0.0000464113
Glutamicibacter arilaitensis	256701	S	2	0	2	0.0000464113
Renibacterium salmoninarum	1646	S	2	0	2	0.0000464113
Psychromicrobium lacuslunae	1618207	S	2	0	2	0.0000464113
Microbacterium sp. HY82	2708079	S	2	0	2	0.0000464113
Microbacterium sediminis	904291	S	2	0	2	0.0000464113
Microbacterium oryzae	743009	S	2	0	2	0.0000464113
Microbacterium pygmaeum	370764	S	2	0	2	0.0000464113
Curtobacterium sp. BH-2-1-1	1905847	S	2	0	2	0.0000464113
Rathayibacter sp. VKM Ac-2760	2609253	S	2	0	2	0.0000464113
Rathayibacter rathayi	33887	S	2	0	2	0.0000464113
Rathayibacter tanaceti	1671680	S	2	0	2	0.0000464113
Agromyces sp. LHK192	2498704	S	2	0	2	0.0000464113
Agromyces aureus	453304	S	2	0	2	0.0000464113
Agromyces badenianii	2080742	S	2	0	2	0.0000464113
Leifsonia shinshuensis	150026	S	2	0	2	0.0000464113
Rhodoluna lacicola	529884	S	2	0	2	0.0000464113
Plantibacter sp. PA-3-X8	2480625	S	2	0	2	0.0000464113
Salinibacterium sp. dk2585	2603292	S	2	0	2	0.0000464113
Salinibacterium sp. ZJ70	2708084	S	2	0	2	0.0000464113
Salinibacterium sp. ZJ450	2708338	S	2	0	2	0.0000464113
Aurantimicrobium sp. MWH-Mo1	1987356	S	2	0	2	0.0000464113
Aurantimicrobium sp. MWH-Uga1	2079575	S	2	0	2	0.0000464113
Marisediminicola antarctica	674079	S	2	0	2	0.0000464113
Microcella alkaliphila	279828	S	2	0	2	0.0000464113
Lysinimonas sp. KACC 19322	2592654	S	2	0	2	0.0000464113
Glaciihabitans sp. INWT7	2596912	S	2	0	2	0.0000464113
Mycetocola sp. JXN-3	2116510	S	2	0	2	0.0000464113
Tetrasphaera sp. HKS02	1813880	S	2	0	2	0.0000464113
Brevibacterium sp. YB235	1496080	S	2	0	2	0.0000464113
Brachybacterium avium	2017485	S	2	0	2	0.0000464113
Cellulomonas gilvus	11	S	2	0	2	0.0000464113
Cellulomonas taurus	2729175	S	2	0	2	0.0000464113
Actinotalea sp. JY-7876	2758442	S	2	0	2	0.0000464113
Serinicoccus marinus	247333	S	2	0	2	0.0000464113
Serinicoccus chungangensis	767452	S	2	0	2	0.0000464113
Ornithinimicrobium sp. H23M54	2594265	S	2	0	2	0.0000464113
Ornithinimicrobium flavum	1288636	S	2	0	2	0.0000464113
Ornithinimicrobium pratense	2593973	S	2	0	2	0.0000464113
Cellulosimicrobium sp. 72-3	2731680	S	1	1	2	0.0000464113
Cellulosimicrobium cellulans	1710	S	2	0	2	0.0000464113
Isoptericola variabilis	139208	S	2	0	2	0.0000464113
Ruania sp. HY168	2603206	S	2	0	2	0.0000464113
Sanguibacter sp. HDW7	2714931	S	2	0	2	0.0000464113
Austwickia chelonae	100225	S	2	0	2	0.0000464113
Rhodococcus sp. X156	2499145	S	2	0	2	0.0000464113
Rhodococcus sp. W8901	2742603	S	2	0	2	0.0000464113
Nocardia yunnanensis	2382165	S	2	0	2	0.0000464113
Corynebacterium sp. 1864	2820399	S	2	0	2	0.0000464113
Corynebacterium sp. Marseille-Q3630	2754725	S	2	0	2	0.0000464113
Corynebacterium pseudotuberculosis	1719	S	2	0	2	0.0000464113
Corynebacterium geronticis	2079234	S	2	0	2	0.0000464113
Corynebacterium uterequi	1072256	S	2	0	2	0.0000464113
Corynebacterium mustelae	571915	S	2	0	2	0.0000464113
Corynebacterium humireducens	1223514	S	2	0	2	0.0000464113
Corynebacterium renale	1724	S	2	0	2	0.0000464113
Corynebacterium provencense	1737425	S	2	0	2	0.0000464113
Corynebacterium argentoratense	42817	S	2	0	2	0.0000464113
Corynebacterium atypicum	191610	S	2	0	2	0.0000464113
Corynebacterium liangguodongii	2079535	S	2	0	2	0.0000464113
Corynebacterium efficiens	152794	S	2	0	2	0.0000464113
Corynebacterium terpenotabidum	89154	S	2	0	2	0.0000464113
Corynebacterium ulcerans	65058	S	2	0	2	0.0000464113
Corynebacterium minutissimum	38301	S	2	0	2	0.0000464113
Corynebacterium propinquum	43769	S	2	0	2	0.0000464113
Mycolicibacterium sp. Z-34	2736649	S	2	0	2	0.0000464113
Mycolicibacterium alvei	67081	S	2	0	2	0.0000464113
Mycolicibacterium thermoresistibile	1797	S	2	0	2	0.0000464113
Mycolicibacterium helvum	1534349	S	2	0	2	0.0000464113
Mycolicibacterium gadium	1794	S	2	0	2	0.0000464113
Mycolicibacterium aichiense	1799	S	2	0	2	0.0000464113
Mycolicibacterium fallax	1793	S	2	0	2	0.0000464113
Mycobacterium sp. DL440	2675523	S	2	0	2	0.0000464113
Mycobacterium kubicae	120959	S	2	0	2	0.0000464113
Mycobacterium florentinum	292462	S	2	0	2	0.0000464113
Mycobacterium kansasii	1768	S	2	0	2	0.0000464113
Mycobacterium gallinarum	39689	S	2	0	2	0.0000464113
Mycobacterium xenopi	1789	S	2	0	2	0.0000464113
Mycobacteroides immunogenum	83262	S	2	0	2	0.0000464113
Hoyosella subflava	639313	S	2	0	2	0.0000464113
Gordonia sp. HY186	2597659	S	2	0	2	0.0000464113
Tomitella sp. HY188	2597660	S	2	0	2	0.0000464113
Tomitella sp. HY172	2760083	S	2	0	2	0.0000464113
Streptomyces sp. ID38640	1265399	S	2	0	2	0.0000464113
Streptomyces sp. CRXT-Y-14	2768069	S	2	0	2	0.0000464113
Streptomyces sp. HF10	2692233	S	2	0	2	0.0000464113
Streptomyces sp. CB01881	2078691	S	2	0	2	0.0000464113
Streptomyces sp. M2	646637	S	2	0	2	0.0000464113
Streptomyces sp. SYP-A7193	2662065	S	2	0	2	0.0000464113
Streptomyces sp. fd1-xmd	1812480	S	2	0	2	0.0000464113
Streptomyces sp. S4.7	2705439	S	2	0	2	0.0000464113
Streptomyces sp. ADI95-16	1522758	S	2	0	2	0.0000464113
Streptomyces sp. NHF165	2175864	S	2	0	2	0.0000464113
Streptomyces sp. INR7	2607753	S	2	0	2	0.0000464113
Streptomyces sp. ZYC-3	2797636	S	2	0	2	0.0000464113
Streptomyces sp. SGAir0924	2109593	S	1	1	2	0.0000464113
Streptomyces sp. S501	2420135	S	1	1	2	0.0000464113
Streptomyces hygroscopicus	1912	S	9	-7	2	0.0000464113
Streptomyces sp. M54	2759525	S	2	0	2	0.0000464113
Streptomyces katrae	68223	S	2	0	2	0.0000464113
Streptomyces cyanogenus	80860	S	2	0	2	0.0000464113
Streptomyces alboniger	132473	S	2	0	2	0.0000464113
Streptomyces armeniacus	83291	S	2	0	2	0.0000464113
Streptomyces vinaceus	1960	S	2	0	2	0.0000464113
Streptomyces violaceusniger	68280	S	2	0	2	0.0000464113
Streptomyces broussonetiae	2686304	S	2	0	2	0.0000464113
Streptomyces incarnatus	665007	S	2	0	2	0.0000464113
Streptomyces gilvosporeus	553510	S	2	0	2	0.0000464113
Streptomyces paludis	2282738	S	2	0	2	0.0000464113
Streptomyces kanamyceticus	1967	S	2	0	2	0.0000464113
Streptomyces leeuwenhoekii	1437453	S	2	0	2	0.0000464113
Streptomyces alboflavus	67267	S	2	0	2	0.0000464113
Streptomyces nigra	1827580	S	2	0	2	0.0000464113
Streptomyces fodineus	1904616	S	2	0	2	0.0000464113
Streptomyces capitiformicae	2014920	S	2	0	2	0.0000464113
Amycolatopsis orientalis	31958	S	2	0	2	0.0000464113
Pseudonocardia dioxanivorans	240495	S	2	0	2	0.0000464113
Saccharopolyspora spinosa	60894	S	2	0	2	0.0000464113
Saccharomonospora cyanea	40989	S	2	0	2	0.0000464113
Saccharomonospora xinjiangensis	75294	S	2	0	2	0.0000464113
Micromonospora sp. WMMA2032	2039870	S	2	0	2	0.0000464113
Micromonospora echinospora	1877	S	2	0	2	0.0000464113
Micromonospora tulbaghiae	479978	S	2	0	2	0.0000464113
Micromonospora zamorensis	709883	S	2	0	2	0.0000464113
Micromonospora craniellae	2294034	S	2	0	2	0.0000464113
Salinispora arenicola	168697	S	2	0	2	0.0000464113
Verrucosispora sp. NA02020	2742132	S	2	0	2	0.0000464113
Actinomyces sp. ZJ750	2744574	S	2	0	2	0.0000464113
Actinomyces sp. HMT897	2789424	S	1	1	2	0.0000464113
Actinomyces radicidentis	111015	S	2	0	2	0.0000464113
Actinomyces qiguomingii	2057800	S	2	0	2	0.0000464113
Actinomyces procaprae	2560010	S	2	0	2	0.0000464113
Actinomyces marmotae	2737173	S	2	0	2	0.0000464113
Trueperella bialowiezensis	312285	S	2	0	2	0.0000464113
Flaviflexus salsibiostraticola	1282737	S	2	0	2	0.0000464113
Nocardiopsis dassonvillei	2014	S	2	0	2	0.0000464113
Nocardiopsis alba	53437	S	2	0	2	0.0000464113
Thermobifida fusca	2021	S	2	0	2	0.0000464113
Candidatus Planktophila lacus	1884913	S	2	0	2	0.0000464113
Candidatus Nanopelagicus abundans	1884916	S	2	0	2	0.0000464113
Bifidobacterium pullorum	78448	S	2	0	2	0.0000464113
Bifidobacterium thermophilum	33905	S	2	0	2	0.0000464113
Frankia casuarinae	106370	S	2	0	2	0.0000464113
Nakamurella sp. PAMC28650	2762325	S	2	0	2	0.0000464113
Blastococcus saxobsidens	138336	S	2	0	2	0.0000464113
Coriobacterium glomerans	33871	S	2	0	2	0.0000464113
Gordonibacter pamelaeae	471189	S	2	0	2	0.0000464113
Slackia heliotrinireducens	84110	S	2	0	2	0.0000464113
Eggerthella sp. YY7918	502558	S	1	1	2	0.0000464113
Egicoccus halophilus	1670830	S	2	0	2	0.0000464113
Staphylococcus felis	46127	S	2	0	2	0.0000464113
Staphylococcus arlettae	29378	S	2	0	2	0.0000464113
Staphylococcus nepalensis	214473	S	2	0	2	0.0000464113
Staphylococcus schleiferi	1295	S	2	0	2	0.0000464113
Mammaliicoccus lentus	42858	S	2	0	2	0.0000464113
Mammaliicoccus vitulinus	71237	S	2	0	2	0.0000464113
Mammaliicoccus fleurettii	150056	S	2	0	2	0.0000464113
Salinicoccus halodurans	407035	S	2	0	2	0.0000464113
Bacillus pseudomycoides	64104	S	2	0	2	0.0000464113
Bacillus cytotoxicus	580165	S	2	0	2	0.0000464113
Bacillus sp. M4U3P1	2592382	S	2	0	2	0.0000464113
Bacillus sp. HD4P25	2779776	S	2	0	2	0.0000464113
Bacillus sp. X1(2014)	1565991	S	2	0	2	0.0000464113
Bacillus altitudinis	293387	S	2	0	2	0.0000464113
Bacillus marisflavi	189381	S	2	0	2	0.0000464113
Virgibacillus sp. Bac332	2419842	S	2	0	2	0.0000464113
Virgibacillus necropolis	163877	S	2	0	2	0.0000464113
Lysinibacillus fusiformis	28031	S	2	0	2	0.0000464113
Alkalihalobacillus miscanthi	2598861	S	2	0	2	0.0000464113
Peribacillus muralis	264697	S	2	0	2	0.0000464113
Peribacillus butanolivorans	421767	S	2	0	2	0.0000464113
Pontibacillus sp. ALD_SL1	2777185	S	2	0	2	0.0000464113
Metabacillus sp. KUDC1714	2745198	S	2	0	2	0.0000464113
Cytobacillus oceanisediminis	665099	S	2	0	2	0.0000464113
Weizmannia coagulans	1398	S	2	0	2	0.0000464113
Pradoshia sp. D12	2651284	S	2	0	2	0.0000464113
Oceanobacillus kimchii	746691	S	2	0	2	0.0000464113
Paenibacillus sp. JDR-2	324057	S	2	0	2	0.0000464113
Paenibacillus sp. PAMC21692	2762320	S	2	0	2	0.0000464113
Paenibacillus sp. JZ16	1906272	S	2	0	2	0.0000464113
Paenibacillus sp. BIHB4019	1870819	S	2	0	2	0.0000464113
Paenibacillus sp. FSL H7-0737	1536775	S	2	0	2	0.0000464113
Paenibacillus xylanexedens	528191	S	2	0	2	0.0000464113
Paenibacillus ihbetae	1870820	S	2	0	2	0.0000464113
Paenibacillus psychroresistens	1778678	S	2	0	2	0.0000464113
Paenibacillus uliginis	683737	S	2	0	2	0.0000464113
Paenibacillus borealis	160799	S	2	0	2	0.0000464113
Paenibacillus xylanilyticus	248903	S	2	0	2	0.0000464113
Paenibacillus durus	44251	S	2	0	2	0.0000464113
Paenibacillus swuensis	1178515	S	2	0	2	0.0000464113
Brevibacillus sp. FJAT-54423	2796470	S	2	0	2	0.0000464113
Brevibacillus brevis	1393	S	2	0	2	0.0000464113
Brevibacillus laterosporus	1465	S	1	1	2	0.0000464113
Aneurinibacillus soli	1500254	S	2	0	2	0.0000464113
Saccharibacillus brassicae	2583377	S	2	0	2	0.0000464113
Planococcus rifietoensis	200991	S	2	0	2	0.0000464113
Kurthia sp. 11kri321	1750719	S	2	0	2	0.0000464113
Alicyclobacillus acidocaldarius	405212	S	2	0	2	0.0000464113
Kyrpidia spormannii	2055160	S	2	0	2	0.0000464113
Exiguobacterium mexicanum	340146	S	2	0	2	0.0000464113
Brochothrix thermosphacta	2756	S	2	0	2	0.0000464113
Streptococcus sp. HSISM1	1316408	S	2	0	2	0.0000464113
Streptococcus sp. 1643	2576376	S	2	0	2	0.0000464113
Streptococcus marmotae	1825069	S	2	0	2	0.0000464113
Streptococcus parauberis	1348	S	2	0	2	0.0000464113
Lactobacillus amylovorus	1604	S	2	0	2	0.0000464113
Lactobacillus kullabergensis	1218493	S	2	0	2	0.0000464113
Leuconostoc pseudomesenteroides	33968	S	2	0	2	0.0000464113
Limosilactobacillus frumenti	104955	S	2	0	2	0.0000464113
Weissella paramesenteroides	1249	S	2	0	2	0.0000464113
Companilactobacillus ginsenosidimutans	1007676	S	2	0	2	0.0000464113
Pediococcus acidilactici	1254	S	2	0	2	0.0000464113
Latilactobacillus sakei	1599	S	2	0	2	0.0000464113
Lentilactobacillus hilgardii	1588	S	2	0	2	0.0000464113
Amylolactobacillus amylophilus	1603	S	2	0	2	0.0000464113
Acetilactobacillus jinshanensis	1720083	S	2	0	2	0.0000464113
Enterococcus avium	33945	S	2	0	2	0.0000464113
Enterococcus casseliflavus	37734	S	2	0	2	0.0000464113
Enterococcus gallinarum	1353	S	1	1	2	0.0000464113
Enterococcus sp. FDAARGOS_375	2060307	S	1	1	2	0.0000464113
Vagococcus teuberi	519472	S	2	0	2	0.0000464113
Vagococcus zengguangii	2571750	S	2	0	2	0.0000464113
Vagococcus sp. CF-49	2562451	S	2	0	2	0.0000464113
Melissococcus plutonius	33970	S	2	0	2	0.0000464113
Marinilactibacillus sp. 15R	1911586	S	2	0	2	0.0000464113
Clostridium sp. CT4	2320868	S	2	0	2	0.0000464113
Clostridium scatologenes	1548	S	2	0	2	0.0000464113
Clostridium cochlearium	1494	S	2	0	2	0.0000464113
Clostridium baratii	1561	S	2	0	2	0.0000464113
Geosporobacter ferrireducens	1424294	S	2	0	2	0.0000464113
Anaerostipes rhamnosivorans	1229621	S	2	0	2	0.0000464113
Butyrivibrio proteoclasticus	43305	S	2	0	2	0.0000464113
[Clostridium] scindens	29347	S	2	0	2	0.0000464113
Pseudobutyrivibrio xylanivorans	185007	S	2	0	2	0.0000464113
Ruminiclostridium herbifermentans	2488810	S	2	0	2	0.0000464113
Acetivibrio saccincola	1677857	S	2	0	2	0.0000464113
Ruthenibacterium lactatiformans	1550024	S	2	0	2	0.0000464113
Acutalibacter muris	1796620	S	2	0	2	0.0000464113
Thermoclostridium stercorarium	1510	S	1	1	2	0.0000464113
Paraclostridium bifermentans	1490	S	2	0	2	0.0000464113
Desulfitobacterium dehalogenans	36854	S	2	0	2	0.0000464113
Desulfitobacterium metallireducens	142877	S	2	0	2	0.0000464113
Thermoanaerosceptrum fracticalcis	1712410	S	2	0	2	0.0000464113
Acetobacterium woodii	33952	S	1	1	2	0.0000464113
Alkalibacter sp. ES005	2815577	S	2	0	2	0.0000464113
Monoglobus pectinilyticus	1981510	S	2	0	2	0.0000464113
Syntrophothermus lipocalidus	86170	S	2	0	2	0.0000464113
Caldicellulosiruptor lactoaceticus	52766	S	1	1	2	0.0000464113
Thermodesulfobium narugense	184064	S	1	1	2	0.0000464113
Mahella australiensis	252966	S	2	0	2	0.0000464113
Halothermothrix orenii	31909	S	2	0	2	0.0000464113
Pelosinus fermentans	365349	S	2	0	2	0.0000464113
Veillonella dispar	39778	S	2	0	2	0.0000464113
Megasphaera stantonii	2144175	S	2	0	2	0.0000464113
Phascolarctobacterium faecium	33025	S	2	0	2	0.0000464113
Anaerococcus mediterraneensis	1870984	S	2	0	2	0.0000464113
Peptoniphilus harei	54005	S	2	0	2	0.0000464113
Parvimonas micra	33033	S	2	0	2	0.0000464113
Tissierellia sp. JN-28	2507161	S	2	0	2	0.0000464113
Gottschalkia acidurici	1556	S	2	0	2	0.0000464113
Sedimentibacter sp. zth1	2816908	S	2	0	2	0.0000464113
Ezakiella massiliensis	1852374	S	2	0	2	0.0000464113
Amedibacterium intestinale	2583452	S	2	0	2	0.0000464113
Nostoc sp. 'Peltigera membranacea cyanobiont' N6	1261031	S	2	0	2	0.0000464113
Nostoc sp. NIES-4103	2005458	S	2	0	2	0.0000464113
Nostoc sphaeroides	446679	S	2	0	2	0.0000464113
Nostoc piscinale	224012	S	1	1	2	0.0000464113
Calothrix sp. PCC 7507	99598	S	2	0	2	0.0000464113
Calothrix parietina	32054	S	2	0	2	0.0000464113
Scytonema sp. NIES-4073	2005464	S	2	0	2	0.0000464113
Synechococcus sp. PCC 7003	374981	S	2	0	2	0.0000464113
Synechococcus sp. CB0101	232348	S	2	0	2	0.0000464113
Synechococcus sp. MVIR-18-1	1386941	S	1	1	2	0.0000464113
Synechococcus lividus	33070	S	2	0	2	0.0000464113
Cyanobium sp. NIES-981	1851505	S	2	0	2	0.0000464113
Leptolyngbya sp. O-77	1080068	S	1	1	2	0.0000464113
Leptolyngbya boryana	1184	S	2	0	2	0.0000464113
Pseudanabaena sp. ABRG5-3	685565	S	2	0	2	0.0000464113
Geminocystis sp. NIES-3709	1617448	S	2	0	2	0.0000464113
Chondrocystis sp. NIES-4102	2005460	S	2	0	2	0.0000464113
Gloeothece verrucosa	2546359	S	2	0	2	0.0000464113
Halothece sp. PCC 7418	65093	S	2	0	2	0.0000464113
[Phormidium] sp. ETS-05	222819	S	2	0	2	0.0000464113
cyanobacterium endosymbiont of Epithemia turgida	718217	S	1	1	2	0.0000464113
Mycoplasma sp. Zaradi2	547987	S	2	0	2	0.0000464113
Mycoplasma sp. Pen4	640330	S	2	0	2	0.0000464113
Mycoplasma mobile	2118	S	2	0	2	0.0000464113
Mycoplasma hyosynoviae	29559	S	2	0	2	0.0000464113
Mycoplasma phocidae	142651	S	2	0	2	0.0000464113
Mycoplasma penetrans	28227	S	2	0	2	0.0000464113
Mycoplasma salivarium	2124	S	2	0	2	0.0000464113
Mycoplasma pulmonis	2107	S	2	0	2	0.0000464113
Mycoplasma canis	29555	S	2	0	2	0.0000464113
Ureaplasma parvum	134821	S	2	0	2	0.0000464113
Spiroplasma corruscae	216934	S	2	0	2	0.0000464113
Spiroplasma eriocheiris	315358	S	2	0	2	0.0000464113
Spiroplasma floricola	216937	S	2	0	2	0.0000464113
Spiroplasma taiwanense	2145	S	2	0	2	0.0000464113
Spiroplasma gladiatoris	2143	S	2	0	2	0.0000464113
Spiroplasma apis	2137	S	2	0	2	0.0000464113
Mesoplasma florum	2151	S	1	1	2	0.0000464113
Candidatus Phytoplasma luffae	35773	S	2	0	2	0.0000464113
Deinococcus maricopensis	309887	S	2	0	2	0.0000464113
Deinococcus swuensis	1182571	S	2	0	2	0.0000464113
Thermus sp. CCB_US3_UF1	1111069	S	2	0	2	0.0000464113
Roseiflexus sp. RS-1	357808	S	2	0	2	0.0000464113
Brevefilum fermentans	1986204	S	2	0	2	0.0000464113
Polaribacter sp. SM13	2818493	S	2	0	2	0.0000464113
Formosa sp. Hel1_33_131	1336794	S	2	0	2	0.0000464113
Formosa sp. Hel3_A1_48	1336795	S	2	0	2	0.0000464113
Myroides profundi	480520	S	2	0	2	0.0000464113
Myroides phaeus	702745	S	2	0	2	0.0000464113
Myroides fluvii	2572594	S	2	0	2	0.0000464113
Winogradskyella sp. PC-19	754417	S	2	0	2	0.0000464113
Winogradskyella forsetii	2686077	S	2	0	2	0.0000464113
Capnocytophaga sp. oral taxon 878	1316596	S	2	0	2	0.0000464113
Capnocytophaga sp. oral taxon 323	1705617	S	1	1	2	0.0000464113
Capnocytophaga sp. oral taxon 902	2748316	S	1	1	2	0.0000464113
Capnocytophaga stomatis	1848904	S	2	0	2	0.0000464113
Maribacter sp. MJ134	2496865	S	2	0	2	0.0000464113
Nonlabens sp. Hel1_33_55	1336802	S	2	0	2	0.0000464113
Nonlabens sp. MB-3u-79	2058134	S	2	0	2	0.0000464113
Nonlabens ponticola	2496866	S	2	0	2	0.0000464113
Cellulophaga lytica	979	S	2	0	2	0.0000464113
Gramella forsetii	411153	S	2	0	2	0.0000464113
Gramella fulva	2126553	S	2	0	2	0.0000464113
Psychroflexus torquis	57029	S	2	0	2	0.0000464113
Muricauda ruestringensis	111501	S	2	0	2	0.0000464113
Aequorivita sp. H23M31	2494375	S	2	0	2	0.0000464113
Wenyingzhuangia fucanilytica	1790137	S	2	0	2	0.0000464113
Seonamhaeicola sp. S2-3	1936081	S	2	0	2	0.0000464113
Dokdonia sp. 4H-3-7-5	983548	S	2	0	2	0.0000464113
Arenibacter algicola	616991	S	2	0	2	0.0000464113
Gillisia sp. Hel1_33_143	1336796	S	2	0	2	0.0000464113
Chryseobacterium sp. StRB126	878220	S	2	0	2	0.0000464113
Chryseobacterium sp. 3008163	2478663	S	2	0	2	0.0000464113
Blattabacterium punctulatus	164514	S	1	1	2	0.0000464113
Spirosoma sp. PL0136	2710596	S	2	0	2	0.0000464113
Spirosoma aerolatum	1211326	S	2	0	2	0.0000464113
Spirosoma taeanense	2735870	S	2	0	2	0.0000464113
Leadbetterella byssophila	316068	S	2	0	2	0.0000464113
Hymenobacter sp. DG25B	1385664	S	2	0	2	0.0000464113
Hymenobacter oligotrophus	2319843	S	2	0	2	0.0000464113
Pontibacter actiniarum	323450	S	2	0	2	0.0000464113
Pontibacter akesuensis	388950	S	2	0	2	0.0000464113
Echinicola vietnamensis	390884	S	2	0	2	0.0000464113
Echinicola rosea	1807691	S	2	0	2	0.0000464113
Cyclobacterium amurskyense	320787	S	1	1	2	0.0000464113
Candidatus Cardinium hertigii	247481	S	2	0	2	0.0000464113
Cardinium endosymbiont of Encarsia pergandiella	249402	S	1	1	2	0.0000464113
Candidatus Amoebophilus asiaticus	281120	S	2	0	2	0.0000464113
Pedobacter sp.	1411316	S	2	0	2	0.0000464113
Sphingobacterium psychroaquaticum	561061	S	2	0	2	0.0000464113
Mucilaginibacter sp. 14171R-50	2703789	S	2	0	2	0.0000464113
Mucilaginibacter xinganensis	1234841	S	2	0	2	0.0000464113
Olivibacter sp. SDN3	2764720	S	2	0	2	0.0000464113
Chitinophaga caeni	2029983	S	2	0	2	0.0000464113
Chitinophaga alhagiae	2203219	S	2	0	2	0.0000464113
Bacteroides sp. HF-5287	2650157	S	2	0	2	0.0000464113
Bacteroides eggerthii	28111	S	2	0	2	0.0000464113
Bacteroides heparinolyticus	28113	S	2	0	2	0.0000464113
Bacteroides caccae	47678	S	2	0	2	0.0000464113
Bacteroides cellulosilyticus	246787	S	2	0	2	0.0000464113
Bacteroides caecimuris	1796613	S	2	0	2	0.0000464113
Prevotella sp. WR041	2801997	S	2	0	2	0.0000464113
Prevotella ruminicola	839	S	2	0	2	0.0000464113
Prevotella copri	165179	S	2	0	2	0.0000464113
Alistipes shahii	328814	S	2	0	2	0.0000464113
Alistipes megaguti	2364787	S	2	0	2	0.0000464113
Proteiniphilum saccharofermentans	1642647	S	2	0	2	0.0000464113
Petrimonas mucosa	1642646	S	2	0	2	0.0000464113
Porphyromonas asaccharolytica	28123	S	2	0	2	0.0000464113
Barnesiella viscericola	397865	S	2	0	2	0.0000464113
Coprobacter sp. 2CBH44	2751153	S	2	0	2	0.0000464113
Butyricimonas faecalis	2093856	S	1	1	2	0.0000464113
Duncaniella dubosii	2518971	S	1	1	2	0.0000464113
Draconibacterium sp. M1	2706887	S	2	0	2	0.0000464113
Chlorobaculum parvum	274539	S	2	0	2	0.0000464113
Gimesia chilikensis	2605989	S	2	0	2	0.0000464113
Polystyrenella longa	2528007	S	2	0	2	0.0000464113
Calycomorphotria hydatis	2528027	S	2	0	2	0.0000464113
Pirellula staleyi	125	S	2	0	2	0.0000464113
Mariniblastus fucicola	980251	S	2	0	2	0.0000464113
Sedimentisphaera salicampi	1941349	S	2	0	2	0.0000464113
Sedimentisphaera cyanobacteriorum	1940790	S	1	1	2	0.0000464113
Phycisphaera mikurensis	547188	S	2	0	2	0.0000464113
Poriferisphaera corsica	2528020	S	2	0	2	0.0000464113
Ereboglobus luteus	1796921	S	2	0	2	0.0000464113
Methylacidimicrobium sp. B4	2796139	S	1	1	2	0.0000464113
Chlamydia sp. S15-834C	1967783	S	2	0	2	0.0000464113
Chlamydia suis	83559	S	2	0	2	0.0000464113
Simkania negevensis	83561	S	2	0	2	0.0000464113
Candidatus Vampirococcus archaeovorus	1930593	S	2	0	2	0.0000464113
Borreliella mayonii	1674146	S	2	0	2	0.0000464113
Treponema phagedenis	162	S	2	0	2	0.0000464113
Treponema parvum	138851	S	2	0	2	0.0000464113
Spirochaeta africana	46355	S	2	0	2	0.0000464113
Leptotrichia trevisanii	109328	S	2	0	2	0.0000464113
Acidobacterium sp. 4Y35	2763107	S	2	0	2	0.0000464113
Granulicella sp. WH15	2602070	S	2	0	2	0.0000464113
Edaphobacter sp. 12200R-103	2703788	S	2	0	2	0.0000464113
Edaphobacter sp. 4G125	2763071	S	2	0	2	0.0000464113
Tepiditoga spiralis	2108365	S	2	0	2	0.0000464113
Kosmotoga pacifica	1330330	S	2	0	2	0.0000464113
Candidatus Nanosynbacter lyticus	2093824	S	2	0	2	0.0000464113
Cloacibacillus porcorum	1197717	S	2	0	2	0.0000464113
Dictyoglomus turgidum	513050	S	2	0	2	0.0000464113
Halorubrum trapanicum	29284	S	2	0	2	0.0000464113
Haloquadratum walsbyi	293091	S	2	0	2	0.0000464113
Halobellus limi	699433	S	2	0	2	0.0000464113
Natronomonas sp. YPL13	1710540	S	2	0	2	0.0000464113
Halosimplex litoreum	1198301	S	2	0	2	0.0000464113
Halobacterium hubeiense	1407499	S	2	0	2	0.0000464113
Halodesulfurarchaeum formicicum	1873524	S	2	0	2	0.0000464113
Haloterrigena longa	370324	S	2	0	2	0.0000464113
Natrinema pellirubrum	69525	S	2	0	2	0.0000464113
Halobiforma lacisalsi	229731	S	2	0	2	0.0000464113
Halovivax sp. KZCA124	2817025	S	2	0	2	0.0000464113
Methanothrix soehngenii	2223	S	2	0	2	0.0000464113
Methanocorpusculum labreanum	83984	S	2	0	2	0.0000464113
Methanofervidicoccus sp. A16	2607662	S	2	0	2	0.0000464113
Methanosphaera sp. BMS	1789762	S	2	0	2	0.0000464113
Thermococcus eurythermalis	1505907	S	1	1	2	0.0000464113
Candidatus Nitrosopumilus koreensis	1510466	S	2	0	2	0.0000464113
Candidatus Nitrosotalea okcheonensis	1903276	S	2	0	2	0.0000464113
Candidatus Nitrosopelagicus brevis	1410606	S	2	0	2	0.0000464113
Acidianus ambivalens	2283	S	2	0	2	0.0000464113
Stygiolobus azoricus	41675	S	2	0	2	0.0000464113
Metallosphaera hakonensis	79601	S	2	0	2	0.0000464113
Pseudomonas phage PS-1	1573458	S	2	0	2	0.0000464113
Streptococcus virus Sfi19	72638	S	1	1	2	0.0000464113
Propionibacterium virus Kubed	1982256	S	2	0	2	0.0000464113
Propionibacterium virus MrAK	1982258	S	1	1	2	0.0000464113
Mycobacterium phage ThulaThula	2599880	S	2	0	2	0.0000464113
Streptococcus virus ALQ132	682370	S	2	0	2	0.0000464113
Mycobacterium phage Doug	2592659	S	1	1	2	0.0000464113
Mycobacterium phage EleanorGeorge	2301563	S	1	1	2	0.0000464113
Burkholderia virus AH2	2560359	S	2	0	2	0.0000464113
Cellulophaga phage phi14:2	1327990	S	2	0	2	0.0000464113
Rhodoferax phage P26218	1636270	S	2	0	2	0.0000464113
Pseudomonas phage O4	1784982	S	2	0	2	0.0000464113
Pseudomonas phage vB_PaeP_Tr60_Ab31	1449437	S	1	1	2	0.0000464113
Pseudoalteromonas phage H101	1654919	S	2	0	2	0.0000464113
Burkholderia phage BcepSaruman	2530032	S	2	0	2	0.0000464113
Bordetella virus PHB04	2734129	S	2	0	2	0.0000464113
Iodobacter virus PLPE	2560530	S	2	0	2	0.0000464113
Synechococcus phage S-SM2	444860	S	2	0	2	0.0000464113
Aureococcus anophagefferens virus	1474867	S	2	0	2	0.0000464113
Torque teno mini virus 18	1859149	S	2	0	2	0.0000464113
Pandoravirus inopinatum	1605721	S	2	0	2	0.0000464113
Peridroma alphabaculovirus	1346829	S	2	0	2	0.0000464113
Burkholderia anthina	179879	S	1	0	1	0.0000232056
Burkholderia seminalis	488731	S	1	0	1	0.0000232056
Burkholderia lata	482957	S	1	0	1	0.0000232056
Burkholderia pyrrocinia	60550	S	1	0	1	0.0000232056
Burkholderia oklahomensis	342113	S	1	0	1	0.0000232056
Burkholderia sp. MSMB617WGS	1637831	S	1	0	1	0.0000232056
Burkholderia sp. MSMB0852	1637841	S	1	0	1	0.0000232056
Burkholderia sp. LA-2-3-30-S1-D2	1637862	S	1	0	1	0.0000232056
Burkholderia sp. PAMC 28687	1795874	S	1	0	1	0.0000232056
Polynucleobacter acidiphobus	556053	S	1	0	1	0.0000232056
Paraburkholderia sp. PGU16	2735433	S	1	0	1	0.0000232056
Paraburkholderia phymatum	148447	S	1	0	1	0.0000232056
Paraburkholderia caledonica	134536	S	1	0	1	0.0000232056
Pandoraea norimbergensis	93219	S	1	0	1	0.0000232056
Pandoraea vervacti	656178	S	1	0	1	0.0000232056
Pandoraea fibrosis	1891094	S	1	0	1	0.0000232056
Janthinobacterium sp. 17J80-10	2497863	S	1	0	1	0.0000232056
Oxalobacter formigenes	847	S	1	0	1	0.0000232056
Methylibium sp. T29	1430884	S	1	0	1	0.0000232056
Bordetella trematum	123899	S	1	0	1	0.0000232056
Alcaligenes sp. SORT26	2813780	S	1	0	1	0.0000232056
Oligella ureolytica	90244	S	1	0	1	0.0000232056
Oligella urethralis	90245	S	1	0	1	0.0000232056
Taylorella asinigenitalis	84590	S	1	0	1	0.0000232056
Sutterella wadsworthensis	40545	S	1	0	1	0.0000232056
Turicimonas muris	1796652	S	1	0	1	0.0000232056
Rugosibacter aromaticivorans	1565605	S	1	0	1	0.0000232056
Azoarcus sp. M9-3-2	2016596	S	1	0	1	0.0000232056
Thauera chlorobenzoica	96773	S	1	0	1	0.0000232056
Thauera hydrothermalis	2184083	S	1	0	1	0.0000232056
Aquitalea aquatilis	1537400	S	1	0	1	0.0000232056
Neisseria sp. ZJ785	2709396	S	1	0	1	0.0000232056
Neisseria wadsworthii	607711	S	1	0	1	0.0000232056
Eikenella corrodens	539	S	1	0	1	0.0000232056
Conchiformibius steedae	153493	S	1	0	1	0.0000232056
Chitinolyticbacter meiyuanensis	682798	S	1	0	1	0.0000232056
Candidatus Methylopumilus rimovensis	2588535	S	1	0	1	0.0000232056
Nitrosomonas europaea	915	S	1	0	1	0.0000232056
Nitrosomonas stercoris	1444684	S	1	0	1	0.0000232056
Nitrosospira briensis	35799	S	1	0	1	0.0000232056
Nitrosospira lacus	1288494	S	1	0	1	0.0000232056
Gallionella capsiferriformans	370405	S	1	0	1	0.0000232056
Sideroxydans lithotrophicus	63745	S	1	0	1	0.0000232056
Ferriphaselus amnicola	1188319	S	1	0	1	0.0000232056
Candidatus Kinetoplastibacterium desouzaii	994692	S	1	0	1	0.0000232056
Candidatus Kinetoplastibacterium oncopeltii	994696	S	1	0	1	0.0000232056
Pseudomonas sp. s211(2017)	2045200	S	1	0	1	0.0000232056
Pseudomonas sp. RU47	2005388	S	1	0	1	0.0000232056
Pseudomonas sp. A214	1855331	S	1	0	1	0.0000232056
Pseudomonas sp. S-6-2	1931241	S	1	0	1	0.0000232056
Pseudomonas sp. Z003-0.4C(8344-21)	1855380	S	1	0	1	0.0000232056
Pseudomonas sp. HLS-6	2049589	S	1	0	1	0.0000232056
Pseudomonas sp. ACM7	2052956	S	1	0	1	0.0000232056
Pseudomonas sp. S09G 359	2054919	S	1	0	1	0.0000232056
Pseudomonas sp. R2A2	2213057	S	1	0	1	0.0000232056
Pseudomonas sp. LG1E9	2219057	S	1	0	1	0.0000232056
Pseudomonas sp. gcc21	2726989	S	1	0	1	0.0000232056
Pseudomonas sp. SK	2729423	S	1	0	1	0.0000232056
Pseudomonas sp. ADAK13	2730847	S	1	0	1	0.0000232056
Pseudomonas sp. ADAK22	2730851	S	1	0	1	0.0000232056
Pseudomonas sp. B11D7D	2735906	S	1	0	1	0.0000232056
Pseudomonas sp. IzPS59	2774459	S	1	0	1	0.0000232056
Pseudomonas sp. Tri1	2823875	S	1	0	1	0.0000232056
Pseudomonas sp. BIOMIG1BAC	1758730	S	1	0	1	0.0000232056
Pseudomonas sp. R4-35-07	658643	S	1	0	1	0.0000232056
Pseudomonas sp. S49	1573720	S	1	0	1	0.0000232056
Pseudomonas sp. S35	1573719	S	1	0	1	0.0000232056
Pseudomonas sp. URMO17WK12:I11	1283291	S	1	0	1	0.0000232056
Pseudomonas sp. R84	1573712	S	1	0	1	0.0000232056
Pseudomonas corrugata	47879	S	1	0	1	0.0000232056
Pseudomonas mediterranea	183795	S	1	0	1	0.0000232056
Pseudomonas poae	200451	S	1	0	1	0.0000232056
Pseudomonas cedrina	651740	S	1	0	1	0.0000232056
Pseudomonas multiresinivorans	95301	S	1	0	1	0.0000232056
Pseudomonas luteola	47886	S	1	0	1	0.0000232056
Pseudomonas coronafaciens	53409	S	1	0	1	0.0000232056
Pseudomonas xinjiangensis	487184	S	1	0	1	0.0000232056
Pseudomonas lalkuanensis	2604832	S	1	0	1	0.0000232056
Pseudomonas knackmussii	65741	S	1	0	1	0.0000232056
Pseudomonas silesiensis	1853130	S	1	0	1	0.0000232056
Pseudomonas umsongensis	198618	S	1	0	1	0.0000232056
Pseudomonas lactis	1615674	S	1	0	1	0.0000232056
Pseudomonas alcaliphila	101564	S	1	0	1	0.0000232056
Pseudomonas antarctica	219572	S	1	0	1	0.0000232056
Pseudomonas alkylphenolica	237609	S	1	0	1	0.0000232056
Pseudomonas sabulinigri	472181	S	1	0	1	0.0000232056
Pseudomonas arsenicoxydans	702115	S	1	0	1	0.0000232056
Pseudomonas agarici	46677	S	1	0	1	0.0000232056
Pseudomonas pohangensis	364197	S	1	0	1	0.0000232056
Pseudomonas extremaustralis	359110	S	1	0	1	0.0000232056
Pseudomonas guangdongensis	1245526	S	1	0	1	0.0000232056
Pseudomonas sihuiensis	1274359	S	1	0	1	0.0000232056
Candidatus Pseudomonas adelgestsugas	1302376	S	1	0	1	0.0000232056
Pseudomonas oryzae	1392877	S	1	0	1	0.0000232056
Entomomonas sp. F2A	2785331	S	1	0	1	0.0000232056
Acinetobacter sp. Marseille-Q1620	2714110	S	1	0	1	0.0000232056
Acinetobacter sp. C16S1	2609668	S	1	0	1	0.0000232056
Acinetobacter sp. YH12138	2601122	S	1	0	1	0.0000232056
Acinetobacter defluvii	1871111	S	1	0	1	0.0000232056
Acinetobacter equi	1324350	S	1	0	1	0.0000232056
Acinetobacter soli	487316	S	1	0	1	0.0000232056
Acinetobacter lanii	2715163	S	1	0	1	0.0000232056
Acinetobacter towneri	202956	S	1	0	1	0.0000232056
Moraxella bovis	476	S	1	0	1	0.0000232056
Psychrobacter sp. P11F6	1699621	S	1	0	1	0.0000232056
Psychrobacter arcticus	334543	S	1	0	1	0.0000232056
Aquirhabdus parva	2283318	S	1	0	1	0.0000232056
Klebsiella quasipneumoniae	1463165	S	1	0	1	0.0000232056
Klebsiella huaxiensis	2153354	S	1	0	1	0.0000232056
Klebsiella africana	2489010	S	1	0	1	0.0000232056
Enterobacter sp. JUb54	2724468	S	1	0	1	0.0000232056
Enterobacter soli	885040	S	1	0	1	0.0000232056
Citrobacter freundii complex sp. CFNIH2	2066049	S	1	0	1	0.0000232056
Citrobacter sp. BDA59-3	2781952	S	1	0	1	0.0000232056
Citrobacter sp. RHB25-C09	2742624	S	1	0	1	0.0000232056
Citrobacter tructae	2562449	S	1	0	1	0.0000232056
Escherichia albertii	208962	S	1	0	1	0.0000232056
Raoultella planticola	575	S	1	0	1	0.0000232056
Cronobacter dublinensis	413497	S	1	0	1	0.0000232056
Kosakonia sacchari	1158459	S	1	0	1	0.0000232056
Kosakonia sp. SMBL-WEM22	2725560	S	1	0	1	0.0000232056
Lelliottia nimipressuralis	69220	S	1	0	1	0.0000232056
Enterobacteriaceae endosymbiont of Macroplea mutica	2675791	S	1	0	1	0.0000232056
Enterobacteriaceae endosymbiont of Macroplea appendiculata	2675790	S	1	0	1	0.0000232056
Blochmannia endosymbiont of Camponotus (Colobopsis) obliquus	1505597	S	1	0	1	0.0000232056
Candidatus Blochmannia vafer	251535	S	1	0	1	0.0000232056
Candidatus Annandia adelgestsuga	1302411	S	1	0	1	0.0000232056
Cedecea lapagei	158823	S	1	0	1	0.0000232056
Kluyvera ascorbata	51288	S	1	0	1	0.0000232056
Kluyvera genomosp. 3	2774055	S	1	0	1	0.0000232056
Candidatus Riesia pediculicola	401619	S	1	0	1	0.0000232056
Candidatus Riesia pediculischaeffi	428411	S	1	0	1	0.0000232056
Buttiauxella agrestis	82977	S	1	0	1	0.0000232056
Buttiauxella sp. 3AFRM03	2479367	S	1	0	1	0.0000232056
Candidatus Ishikawaella capsulata	168169	S	1	0	1	0.0000232056
Shimwellia blattae	563	S	1	0	1	0.0000232056
Atlantibacter hermannii	565	S	1	0	1	0.0000232056
Metakosakonia sp. MRY16-398	2487150	S	1	0	1	0.0000232056
Shigella dysenteriae	622	S	1	0	1	0.0000232056
Pantoea sp. At-9b	592316	S	1	0	1	0.0000232056
Pantoea sp. 201603H	2479547	S	1	0	1	0.0000232056
Pantoea sp. CCBC3-3-1	2490851	S	1	0	1	0.0000232056
Pantoea rwandensis	1076550	S	1	0	1	0.0000232056
Tatumella sp. TA1	2487345	S	1	0	1	0.0000232056
Wigglesworthia glossinidia	51229	S	1	0	1	0.0000232056
Serratia sp. FGI94	671990	S	1	0	1	0.0000232056
Serratia sp. FDAARGOS_506	2420306	S	1	0	1	0.0000232056
Serratia rubidaea	61652	S	1	0	1	0.0000232056
Serratia grimesii	82995	S	1	0	1	0.0000232056
Yersinia aldovae	29483	S	1	0	1	0.0000232056
Yersinia frederiksenii	29484	S	1	0	1	0.0000232056
Yersinia pseudotuberculosis	633	S	1	0	1	0.0000232056
Yersinia hibernica	2339259	S	1	0	1	0.0000232056
Nissabacter sp. SGAir0207	2126321	S	1	0	1	0.0000232056
Proteus penneri	102862	S	1	0	1	0.0000232056
Proteus hauseri	183417	S	1	0	1	0.0000232056
Xenorhabdus poinarii	40577	S	1	0	1	0.0000232056
Xenorhabdus budapestensis	290110	S	1	0	1	0.0000232056
Arsenophonus endosymbiont of Aleurodicus dispersus	235559	S	1	0	1	0.0000232056
Morganella morganii	582	S	1	0	1	0.0000232056
Pectobacterium polaris	2042057	S	1	0	1	0.0000232056
Dickeya chrysanthemi	556	S	1	0	1	0.0000232056
Lonsdalea britannica	1082704	S	1	0	1	0.0000232056
Edwardsiella tarda	636	S	1	0	1	0.0000232056
Plesiomonas shigelloides	703	S	1	0	1	0.0000232056
Stenotrophomonas sp. YAU14D1_LEIMI4_1	2072407	S	1	0	1	0.0000232056
Stenotrophomonas sp. ZAC14A_NAIMI4_1	2072412	S	1	0	1	0.0000232056
Stenotrophomonas sp. WZN-1	2005046	S	1	0	1	0.0000232056
Stenotrophomonas sp. Pemsol	2040586	S	1	0	1	0.0000232056
Xanthomonas sp. SI	2724123	S	1	0	1	0.0000232056
Xanthomonas cassavae	56450	S	1	0	1	0.0000232056
Xanthomonas axonopodis	53413	S	1	0	1	0.0000232056
Xanthomonas fragariae	48664	S	1	0	1	0.0000232056
Xanthomonas albilineans	29447	S	1	0	1	0.0000232056
Lysobacter sp. CW239	2762611	S	1	0	1	0.0000232056
Lysobacter solisilvae	2763317	S	1	0	1	0.0000232056
Thermomonas sp. HDW16	2714945	S	1	0	1	0.0000232056
Xylella taiwanensis	1444770	S	1	0	1	0.0000232056
Dyella japonica	231455	S	1	0	1	0.0000232056
Luteibacter rhizovicinus	242606	S	1	0	1	0.0000232056
Frateuria aurantia	81475	S	1	0	1	0.0000232056
Shewanella donghaensis	238836	S	1	0	1	0.0000232056
Shewanella maritima	2520507	S	1	0	1	0.0000232056
Shewanella litorisediminis	1173586	S	1	0	1	0.0000232056
Shewanella loihica	359303	S	1	0	1	0.0000232056
Shewanella sediminis	271097	S	1	0	1	0.0000232056
Shewanella denitrificans	192073	S	1	0	1	0.0000232056
Shewanella livingstonensis	150120	S	1	0	1	0.0000232056
Shewanella pealeana	70864	S	1	0	1	0.0000232056
Parashewanella tropica	2547970	S	1	0	1	0.0000232056
Pseudoalteromonas sp. SM1988	2744479	S	1	0	1	0.0000232056
Pseudoalteromonas sp. R3	1709477	S	1	0	1	0.0000232056
Pseudoalteromonas piratica	1348114	S	1	0	1	0.0000232056
Pseudoalteromonas viridis	339617	S	1	0	1	0.0000232056
Pseudoalteromonas aliena	247523	S	1	0	1	0.0000232056
Pseudoalteromonas carrageenovora	227	S	1	0	1	0.0000232056
Pseudoalteromonas xiamenensis	882626	S	1	0	1	0.0000232056
Pseudoalteromonas shioyasakiensis	1190813	S	1	0	1	0.0000232056
Pseudoalteromonas luteoviolacea	43657	S	1	0	1	0.0000232056
Pseudoalteromonas espejiana	28107	S	1	0	1	0.0000232056
Psychrosphaera aestuarii	1266052	S	1	0	1	0.0000232056
Alteromonas sp. RKMC-009	2267264	S	1	0	1	0.0000232056
Alteromonas pelagimontana	1858656	S	1	0	1	0.0000232056
Marinobacter sp. BSs20148	490759	S	1	0	1	0.0000232056
Marinobacter sp. CP1	1671721	S	1	0	1	0.0000232056
Marinobacter sp. NP-4(2019)	2488665	S	1	0	1	0.0000232056
Marinobacter sp. LPB0319	2769486	S	1	0	1	0.0000232056
Marinobacter salarius	1420917	S	1	0	1	0.0000232056
Marinobacter salinus	1874317	S	1	0	1	0.0000232056
Paraglaciecola sp. L1A13	2686359	S	1	0	1	0.0000232056
Glaciecola nitratireducens	300231	S	1	0	1	0.0000232056
Agarivorans gilvus	680279	S	1	0	1	0.0000232056
Lacimicrobium alkaliphilum	1526571	S	1	0	1	0.0000232056
Hydrocarboniclastica marina	2259620	S	1	0	1	0.0000232056
Colwellia sp. PAMC 20917	1816218	S	1	0	1	0.0000232056
Colwellia sp. Arc7-635	2497879	S	1	0	1	0.0000232056
Colwellia beringensis	1967665	S	1	0	1	0.0000232056
Thalassotalea sp. HSM 43	2552945	S	1	0	1	0.0000232056
Thalassotalea crassostreae	1763536	S	1	0	1	0.0000232056
Ferrimonas balearica	44012	S	1	0	1	0.0000232056
Ferrimonas lipolytica	2724191	S	1	0	1	0.0000232056
Halomonas sp. GFAJ-1	1118153	S	1	0	1	0.0000232056
Halomonas sp. SH5A2	2749040	S	1	0	1	0.0000232056
Halomonas sp. MCCC 1A13316	2733487	S	1	0	1	0.0000232056
Halomonas sp. PGE1	2730360	S	1	0	1	0.0000232056
Halomonas sp. Y2R2	2562282	S	1	0	1	0.0000232056
Halomonas venusta	44935	S	1	0	1	0.0000232056
Halomonas hydrothermalis	115561	S	1	0	1	0.0000232056
Halomonas beimenensis	475662	S	1	0	1	0.0000232056
Halomonas chromatireducens	507626	S	1	0	1	0.0000232056
Halomonas socia	1081866	S	1	0	1	0.0000232056
Zymobacter palmae	33074	S	1	0	1	0.0000232056
Cobetia sp. cqz5-12	2609415	S	1	0	1	0.0000232056
Marinomonas sp. FW-1	2071621	S	1	0	1	0.0000232056
Bermanella marisrubri	207949	S	1	0	1	0.0000232056
Kangiella koreensis	261964	S	1	0	1	0.0000232056
Endozoicomonas montiporae	1027273	S	1	0	1	0.0000232056
Vibrio natriegens	691	S	1	0	1	0.0000232056
Vibrio rotiferianus	190895	S	1	0	1	0.0000232056
Vibrio jasicida	766224	S	1	0	1	0.0000232056
Vibrio sp. Sal10	2777577	S	1	0	1	0.0000232056
Vibrio sp. SM1977	2662262	S	1	0	1	0.0000232056
Vibrio scophthalmi	45658	S	1	0	1	0.0000232056
Vibrio zhugei	2479546	S	1	0	1	0.0000232056
Vibrio atlanticus	693153	S	1	0	1	0.0000232056
Vibrio navarrensis	29495	S	1	0	1	0.0000232056
Vibrio gazogenes	687	S	1	0	1	0.0000232056
Vibrio mediterranei	689	S	1	0	1	0.0000232056
Vibrio metoecus	1481663	S	1	0	1	0.0000232056
Salinivibrio kushneri	1908198	S	1	0	1	0.0000232056
Paraphotobacterium marinum	1755811	S	1	0	1	0.0000232056
Mannheimia granulomatis	85402	S	1	0	1	0.0000232056
Mannheimia sp. USDA-ARS-USMARC-1261	1432056	S	1	0	1	0.0000232056
Actinobacillus equuli	718	S	1	0	1	0.0000232056
Aggregatibacter aphrophilus	732	S	1	0	1	0.0000232056
Aggregatibacter segnis	739	S	1	0	1	0.0000232056
Otariodibacter oris	1032623	S	1	0	1	0.0000232056
Aeromonas jandaei	650	S	1	0	1	0.0000232056
Aeromonas media	651	S	1	0	1	0.0000232056
Aeromonas encheleia	73010	S	1	0	1	0.0000232056
Tolumonas auensis	43948	S	1	0	1	0.0000232056
Oceanimonas sp. GK1	511062	S	1	0	1	0.0000232056
Oceanisphaera avium	1903694	S	1	0	1	0.0000232056
Dongshaea marina	2047966	S	1	0	1	0.0000232056
Rheinheimera sp. D18	2545632	S	1	0	1	0.0000232056
Thermochromatium tepidum	1050	S	1	0	1	0.0000232056
Marichromatium purpuratum	37487	S	1	0	1	0.0000232056
Thioflavicoccus mobilis	80679	S	1	0	1	0.0000232056
Thioalkalivibrio sp. K90mix	396595	S	1	0	1	0.0000232056
Acidihalobacter aeolianus	2792603	S	1	0	1	0.0000232056
Halorhodospira halophila	1053	S	1	0	1	0.0000232056
Spiribacter salinus	1335746	S	1	0	1	0.0000232056
Spiribacter sp. 2438	2666185	S	1	0	1	0.0000232056
Ectothiorhodospira haloalkaliphila	421628	S	1	0	1	0.0000232056
Thiohalobacter sp. COW1	2795687	S	1	0	1	0.0000232056
Wenzhouxiangella sp. AB-CW3	2771012	S	1	0	1	0.0000232056
Guyparkeria halophila	47960	S	1	0	1	0.0000232056
Legionella sp. MW5194	2662448	S	1	0	1	0.0000232056
Legionella oakridgensis	29423	S	1	0	1	0.0000232056
Legionella adelaidensis	45056	S	1	0	1	0.0000232056
Legionella israelensis	454	S	1	0	1	0.0000232056
Legionella fallonii	96230	S	1	0	1	0.0000232056
Legionella clemsonensis	1867846	S	1	0	1	0.0000232056
Coxiella burnetii	777	S	1	0	1	0.0000232056
Aquicella siphonis	254247	S	1	0	1	0.0000232056
Microbulbifer sp. A4B17	359370	S	1	0	1	0.0000232056
Microbulbifer sp. ALW1	1516059	S	1	0	1	0.0000232056
Microbulbifer sp. SH-1	2681547	S	1	0	1	0.0000232056
Microbulbifer thermotolerans	252514	S	1	0	1	0.0000232056
Halioglobus pacificus	930806	S	1	0	1	0.0000232056
Oceanicoccus sagamiensis	716816	S	1	0	1	0.0000232056
Hydrogenovibrio thermophilus	265883	S	1	0	1	0.0000232056
Thiomicrorhabdus indica	2267253	S	1	0	1	0.0000232056
Thiomicrorhabdus sediminis	2580412	S	1	0	1	0.0000232056
Thiomicrorhabdus xiamenensis	2739063	S	1	0	1	0.0000232056
Thiosulfativibrio zosterae	2675053	S	1	0	1	0.0000232056
Thiosulfatimonas sediminis	2675054	S	1	0	1	0.0000232056
Francisella persica	954	S	1	0	1	0.0000232056
Francisella orientalis	299583	S	1	0	1	0.0000232056
Francisella hispaniensis	622488	S	1	0	1	0.0000232056
Francisella frigiditurris	1542390	S	1	0	1	0.0000232056
Francisella sp. Scap27	2589986	S	1	0	1	0.0000232056
Allofrancisella guangzhouensis	594679	S	1	0	1	0.0000232056
Thiothrix sp.	1032	S	1	0	1	0.0000232056
Thiothrix sp. Ku-5	2735563	S	1	0	1	0.0000232056
Thiothrix unzii	111769	S	1	0	1	0.0000232056
Methylomonas sp. LW13	107637	S	1	0	1	0.0000232056
Methylomonas sp. DH-1	1727196	S	1	0	1	0.0000232056
Methylomonas denitrificans	1538553	S	1	0	1	0.0000232056
Methylococcus sp. EFPC2	2812648	S	1	0	1	0.0000232056
Methylotuvimicrobium buryatense	95641	S	1	0	1	0.0000232056
Candidatus Ruthia magnifica	386487	S	1	0	1	0.0000232056
Candidatus Ruthia endofausta	2738852	S	1	0	1	0.0000232056
Candidatus Thioglobus autotrophicus	1705394	S	1	0	1	0.0000232056
Candidatus Nardonella dryophthoridicola	1971485	S	1	0	1	0.0000232056
endosymbiont of Pachyrhynchus infernalis	1971488	S	1	0	1	0.0000232056
Gallaecimonas mangrovi	2291597	S	1	0	1	0.0000232056
Candidatus Azoamicus ciliaticola	2652803	S	1	0	1	0.0000232056
Dichelobacter nodosus	870	S	1	0	1	0.0000232056
Cardiobacterium hominis	2718	S	1	0	1	0.0000232056
Salinisphaera sp. LB1	2183911	S	1	0	1	0.0000232056
endosymbiont of unidentified scaly snail isolate Monju	1248727	S	1	0	1	0.0000232056
Bradyrhizobium sp. CCGE-LA001	1223566	S	1	0	1	0.0000232056
Rhizobium sp. NXC14	1981173	S	1	0	1	0.0000232056
Rhizobium sp. NZLR1	2731096	S	1	0	1	0.0000232056
Rhizobium lentis	1138194	S	1	0	1	0.0000232056
Rhizobium flavum	1335061	S	1	0	1	0.0000232056
Rhizobium rhizoryzae	451876	S	1	0	1	0.0000232056
Candidatus Liberibacter americanus	309868	S	1	0	1	0.0000232056
Ciceribacter thiooxidans	1969821	S	1	0	1	0.0000232056
Georhizobium profundi	2341112	S	1	0	1	0.0000232056
Mesorhizobium sp. L-2-11	2744521	S	1	0	1	0.0000232056
Mesorhizobium sp. 113-3-3	2744516	S	1	0	1	0.0000232056
Mesorhizobium sp. NZP2077	2483404	S	1	0	1	0.0000232056
Mesorhizobium sp. M6A.T.Cr.TU.016.01.1.1	2493677	S	1	0	1	0.0000232056
Mesorhizobium sp. M3A.F.Ca.ET.080.04.2.1	2493676	S	1	0	1	0.0000232056
Mesorhizobium australicum	536018	S	1	0	1	0.0000232056
Mesorhizobium erdmanii	1777866	S	1	0	1	0.0000232056
Devosia sp. 1566	2499144	S	1	0	1	0.0000232056
Devosia sp. D6-9	2664417	S	1	0	1	0.0000232056
Devosia sp. G19	2801335	S	1	0	1	0.0000232056
Blastochloris viridis	1079	S	1	0	1	0.0000232056
Methyloceanibacter caenitepidi	1384459	S	1	0	1	0.0000232056
Methyloceanibacter sp. wino2	2170729	S	1	0	1	0.0000232056
Caenibius tardaugens	169176	S	1	0	1	0.0000232056
Martelella endophytica	1486262	S	1	0	1	0.0000232056
Brucella pseudogrignonensis	419475	S	1	0	1	0.0000232056
Brucella pituitosa	571256	S	1	0	1	0.0000232056
Labrenzia sp. THAF82	2587861	S	1	0	1	0.0000232056
Labrenzia alexandrii	388408	S	1	0	1	0.0000232056
Methylocystis heyeri	391905	S	1	0	1	0.0000232056
Methylosinus sp. C49	2699395	S	1	0	1	0.0000232056
Beijerinckia indica	533	S	1	0	1	0.0000232056
Bartonella birtlesii	111504	S	1	0	1	0.0000232056
Bartonella schoenbuchensis	165694	S	1	0	1	0.0000232056
Bartonella bovis	155194	S	1	0	1	0.0000232056
Bartonella bacilliformis	774	S	1	0	1	0.0000232056
Breoghania sp. L-A4	2304600	S	1	0	1	0.0000232056
Sphingomonas sp. JE1	1628059	S	1	0	1	0.0000232056
Sphingomonas sp. ERG5	1381597	S	1	0	1	0.0000232056
Sphingomonas sp. MK52	2711156	S	1	0	1	0.0000232056
Sphingomonas sp.	28214	S	1	0	1	0.0000232056
Sphingomonas ginsengisoli An et al. 2013	363835	S	1	0	1	0.0000232056
Sphingomonas daechungensis	1176646	S	1	0	1	0.0000232056
Sphingobium sp. EP60837	1855519	S	1	0	1	0.0000232056
Sphingobium sp. CAP-1	2676077	S	1	0	1	0.0000232056
Sphingobium barthaii	1054037	S	1	0	1	0.0000232056
Parasphingorhabdus sp. JHSY0214	2806553	S	1	0	1	0.0000232056
Erythrobacter sp. KY5	2011159	S	1	0	1	0.0000232056
Altererythrobacter sp. BO-6	2604537	S	1	0	1	0.0000232056
Croceicoccus sp. YJ47	2798724	S	1	0	1	0.0000232056
Qipengyuania seohaensis	266951	S	1	0	1	0.0000232056
Aurantiacibacter gangjinensis	502682	S	1	0	1	0.0000232056
Paraurantiacibacter namhicola	645517	S	1	0	1	0.0000232056
Sphingosinicella sp. UDD2	2771430	S	1	0	1	0.0000232056
Sulfitobacter sp. THAF37	2587855	S	1	0	1	0.0000232056
Sulfitobacter guttiformis	74349	S	1	0	1	0.0000232056
Celeribacter ethanolicus	1758178	S	1	0	1	0.0000232056
Roseovarius sp. TM1035	391613	S	1	0	1	0.0000232056
Roseovarius sp. THAF9	2587847	S	1	0	1	0.0000232056
Roseovarius faecimaris	2494550	S	1	0	1	0.0000232056
Phaeobacter inhibens	221822	S	1	0	1	0.0000232056
Phaeobacter piscinae	1580596	S	1	0	1	0.0000232056
Octadecabacter sp. SW4	2602067	S	1	0	1	0.0000232056
Octadecabacter temperatus	1458307	S	1	0	1	0.0000232056
Rhodovulum sp. MB263	308754	S	1	0	1	0.0000232056
Ketogulonicigenium robustum	92947	S	1	0	1	0.0000232056
Pseudopuniceibacterium antarcticum	2613965	S	1	0	1	0.0000232056
Qingshengfaniella alkalisoli	2599296	S	1	0	1	0.0000232056
Parasedimentitalea marina	2483033	S	1	0	1	0.0000232056
Pontivivens sp. MT2928	2789856	S	1	0	1	0.0000232056
Pseudooceanicola algae	1537215	S	1	0	1	0.0000232056
Halocynthiibacter arcticus	1579316	S	1	0	1	0.0000232056
Planktomarina temperata	1284658	S	1	0	1	0.0000232056
Thalassobius gelatinovorus	53501	S	1	0	1	0.0000232056
Dinoroseobacter shibae	215813	S	1	0	1	0.0000232056
Antarctobacter heliothermus	74033	S	1	0	1	0.0000232056
Acetobacter pasteurianus	438	S	1	0	1	0.0000232056
Acetobacter tropicalis	104102	S	1	0	1	0.0000232056
Acetobacter ascendens	481146	S	1	0	1	0.0000232056
Acetobacter sp. KACC 21233	2592655	S	1	0	1	0.0000232056
Komagataeibacter hansenii	436	S	1	0	1	0.0000232056
Komagataeibacter oboediens	65958	S	1	0	1	0.0000232056
Gluconobacter sphaericus	574987	S	1	0	1	0.0000232056
Kozakia baliensis	153496	S	1	0	1	0.0000232056
Swingsia samuiensis	1293412	S	1	0	1	0.0000232056
Oecophyllibacter saccharovorans	2558360	S	1	0	1	0.0000232056
Magnetospirillum magneticum	84159	S	1	0	1	0.0000232056
Defluviicoccus vanus	111831	S	1	0	1	0.0000232056
Haematospirillum jordaniae	1549855	S	1	0	1	0.0000232056
Terasakiella sp. SH-1	2560057	S	1	0	1	0.0000232056
Rickettsia typhi	785	S	1	0	1	0.0000232056
Ehrlichia sp. HF	391036	S	1	0	1	0.0000232056
Neorickettsia sennetsu	951	S	1	0	1	0.0000232056
Wolbachia endosymbiont of Ctenocephalides felis wCfeT	2732593	S	1	0	1	0.0000232056
Wolbachia endosymbiont of Dipetalonema caudispina	1812112	S	1	0	1	0.0000232056
Candidatus Fokinia solitaria	1802984	S	1	0	1	0.0000232056
Candidatus Pelagibacter sp. HIMB1321	1388755	S	1	0	1	0.0000232056
Candidatus Pelagibacter giovannonii	2563896	S	1	0	1	0.0000232056
Hyphobacterium sp. CCMP332	2749086	S	1	0	1	0.0000232056
endosymbiont of Acanthamoeba sp. UWC8	86106	S	1	0	1	0.0000232056
Candidatus Nucleicultrix amoebiphila	1509244	S	1	0	1	0.0000232056
Kordiimonas pumila	2161677	S	1	0	1	0.0000232056
Luteithermobacter gelatinilyticus	2582913	S	1	0	1	0.0000232056
Vulgatibacter incomptus	1391653	S	1	0	1	0.0000232056
Geobacter pickeringii	345632	S	1	0	1	0.0000232056
Syntrophotalea carbinolica	19	S	1	0	1	0.0000232056
Syntrophotalea acetylenica	29542	S	1	0	1	0.0000232056
Syntrophotalea acetylenivorans	1842532	S	1	0	1	0.0000232056
Desulfovibrio sp. 86	2666132	S	1	0	1	0.0000232056
Desulfovibrio desulfuricans	876	S	1	0	1	0.0000232056
Desulfovibrio piger	901	S	1	0	1	0.0000232056
Desulfovibrio marinus	370038	S	1	0	1	0.0000232056
Pseudodesulfovibrio mercurii	641491	S	1	0	1	0.0000232056
Pseudodesulfovibrio indicus	1716143	S	1	0	1	0.0000232056
Maridesulfovibrio salexigens	880	S	1	0	1	0.0000232056
Maridesulfovibrio hydrothermalis	191026	S	1	0	1	0.0000232056
Desulfocurvibacter africanus	873	S	1	0	1	0.0000232056
Desulfomicrobium orale	132132	S	1	0	1	0.0000232056
Desulfohalobium retbaense	45663	S	1	0	1	0.0000232056
Desulfobacterium autotrophicum	2296	S	1	0	1	0.0000232056
Desulfobacula toluolica	28223	S	1	0	1	0.0000232056
Desulfobulbus oligotrophicus	1909699	S	1	0	1	0.0000232056
Desulfopila sp. IMCC35005	2569541	S	1	0	1	0.0000232056
Syntrophus aciditrophicus	316277	S	1	0	1	0.0000232056
Desulfoglaeba alkanexedens	361111	S	1	0	1	0.0000232056
Aliarcobacter thereius	544718	S	1	0	1	0.0000232056
Aliarcobacter trophiarum	708186	S	1	0	1	0.0000232056
Aliarcobacter lanthieri	1355374	S	1	0	1	0.0000232056
Aliarcobacter faecis	1564138	S	1	0	1	0.0000232056
[Arcobacter] porcinus	1935204	S	1	0	1	0.0000232056
Arcobacter venerupis	1054033	S	1	0	1	0.0000232056
Arcobacter sp. FWKO B	2593672	S	1	0	1	0.0000232056
Malaciobacter marinus	505249	S	1	0	1	0.0000232056
Campylobacter sp. RM16704	1500960	S	1	0	1	0.0000232056
Campylobacter sp. RM12175	1660076	S	1	0	1	0.0000232056
Campylobacter sp. RM16192	1660080	S	1	0	1	0.0000232056
Campylobacter hepaticus	1813019	S	1	0	1	0.0000232056
Campylobacter geochelonis	1780362	S	1	0	1	0.0000232056
Campylobacter blaseri	2042961	S	1	0	1	0.0000232056
Campylobacter volucris	1031542	S	1	0	1	0.0000232056
Campylobacter insulaenigrae	260714	S	1	0	1	0.0000232056
Campylobacter canadensis	449520	S	1	0	1	0.0000232056
Campylobacter cuniculorum	374106	S	1	0	1	0.0000232056
Campylobacter upsaliensis	28080	S	1	0	1	0.0000232056
Campylobacter mucosalis	202	S	1	0	1	0.0000232056
Campylobacter hyointestinalis	198	S	1	0	1	0.0000232056
Sulfurospirillum sp. UCH001	1581011	S	1	0	1	0.0000232056
Helicobacter cholecystus	45498	S	1	0	1	0.0000232056
Helicobacter sp. MIT 01-6242	222136	S	1	0	1	0.0000232056
Helicobacter apodemus	135569	S	1	0	1	0.0000232056
Helicobacter suis	104628	S	1	0	1	0.0000232056
Helicobacter typhlonius	76936	S	1	0	1	0.0000232056
Helicobacter pullorum	35818	S	1	0	1	0.0000232056
Helicobacter mustelae	217	S	1	0	1	0.0000232056
Helicobacter felis	214	S	1	0	1	0.0000232056
Wolinella succinogenes	844	S	1	0	1	0.0000232056
Sulfurimonas sp. S2-6	2590020	S	1	0	1	0.0000232056
Sulfurimonas gotlandica	1176482	S	1	0	1	0.0000232056
Candidatus Sulfurimonas baltica	2740404	S	1	0	1	0.0000232056
Hydrogenimonas urashimensis	2740515	S	1	0	1	0.0000232056
Nautilia sp. PV-1	2579250	S	1	0	1	0.0000232056
Caminibacter mediatlanticus	291048	S	1	0	1	0.0000232056
Bdellovibrio exovorus	453816	S	1	0	1	0.0000232056
Acidithiobacillus ferrooxidans	920	S	1	0	1	0.0000232056
Acidithiobacillus caldus	33059	S	1	0	1	0.0000232056
Mariprofundus ferrinatatus	1921087	S	1	0	1	0.0000232056
Propionibacterium australiense	119981	S	1	0	1	0.0000232056
Microlunatus soli	630515	S	1	0	1	0.0000232056
Tessaracoccus aquimaris	1332264	S	1	0	1	0.0000232056
Propioniciclava sp. HDW11	2714937	S	1	0	1	0.0000232056
Pseudopropionibacterium propionicum	1750	S	1	0	1	0.0000232056
Nocardioides sp. S-713	2760089	S	1	0	1	0.0000232056
Aeromicrobium sp. zg-629	2663859	S	1	0	1	0.0000232056
Aeromicrobium erythreum	2041	S	1	0	1	0.0000232056
Micrococcus sp. V7	404582	S	1	0	1	0.0000232056
Arthrobacter sp. FB24	290399	S	1	0	1	0.0000232056
Arthrobacter sp. UKPF54-2	2600159	S	1	0	1	0.0000232056
Arthrobacter sp. KBS0702	2578107	S	1	0	1	0.0000232056
Arthrobacter sp. 24S4-2	2575374	S	1	0	1	0.0000232056
Arthrobacter sp. PAMC 25486	1494608	S	1	0	1	0.0000232056
Arthrobacter sp. Chr15	447032	S	1	0	1	0.0000232056
Arthrobacter sp. 31.31	347202	S	1	0	1	0.0000232056
Arthrobacter sp.	1667	S	1	0	1	0.0000232056
Arthrobacter dokdonellae	2211210	S	1	0	1	0.0000232056
Rothia nasimurium	85336	S	1	0	1	0.0000232056
Rothia aeria	172042	S	1	0	1	0.0000232056
Pseudarthrobacter sp. NIBRBAC000502772	2590775	S	1	0	1	0.0000232056
Glutamicibacter creatinolyticus	162496	S	1	0	1	0.0000232056
Auritidibacter sp. NML130574	2170745	S	1	0	1	0.0000232056
Microbacterium sp. LKL04	912630	S	1	0	1	0.0000232056
Microbacterium sp. A18JL200	2782167	S	1	0	1	0.0000232056
Microbacterium sp. HY60	2769067	S	1	0	1	0.0000232056
Microbacterium sp. Nx66	2766784	S	1	0	1	0.0000232056
Microbacterium sp. YJN-G	2763257	S	1	0	1	0.0000232056
Microbacterium sp. 1S1	2606451	S	1	0	1	0.0000232056
Microbacterium sp. 4R-513	2567934	S	1	0	1	0.0000232056
Microbacterium amylolyticum	936337	S	1	0	1	0.0000232056
Microbacterium endophyticum	1526412	S	1	0	1	0.0000232056
Microbacterium wangchenii	2541726	S	1	0	1	0.0000232056
Microbacterium hydrocarbonoxydans	273678	S	1	0	1	0.0000232056
Curtobacterium sp. YC1	2795488	S	1	0	1	0.0000232056
Rathayibacter tritici	33888	S	1	0	1	0.0000232056
Rathayibacter iranicus	59737	S	1	0	1	0.0000232056
Rathayibacter festucae	110937	S	1	0	1	0.0000232056
Leucobacter coleopterorum	2714933	S	1	0	1	0.0000232056
Leucobacter viscericola	2714935	S	1	0	1	0.0000232056
Leifsonia sp. 21MFCrub1.1	1798223	S	1	0	1	0.0000232056
Cryobacterium arcticum	670052	S	1	0	1	0.0000232056
Plantibacter flavus	150123	S	1	0	1	0.0000232056
Salinibacterium sp. UTAS2018	2508880	S	1	0	1	0.0000232056
Protaetiibacter sp. SSC-01	2759943	S	1	0	1	0.0000232056
Diaminobutyricimonas sp. LJ205	2683590	S	1	0	1	0.0000232056
Pontimonas salivibrio	1159327	S	1	0	1	0.0000232056
Brevibacterium sp. WO024	2697563	S	1	0	1	0.0000232056
Brevibacterium sp. 'Marine'	2725563	S	1	0	1	0.0000232056
Brevibacterium sandarakinum	629680	S	1	0	1	0.0000232056
Cellulomonas sp. PSBB021	2003551	S	1	0	1	0.0000232056
Paraoerskovia marina	545619	S	1	0	1	0.0000232056
Xylanimonas allomyrinae	2509459	S	1	0	1	0.0000232056
Georgenia sp. Z294	2585135	S	1	0	1	0.0000232056
Haloactinobacterium sp. RN3S43	2779775	S	1	0	1	0.0000232056
Mobilicoccus sp. NJES-13	2716227	S	1	0	1	0.0000232056
Rhodococcus coprophilus	38310	S	1	0	1	0.0000232056
Nocardia terpenica	455432	S	1	0	1	0.0000232056
Nocardia wallacei	480035	S	1	0	1	0.0000232056
Corynebacterium sp. NML93-0612	699041	S	1	0	1	0.0000232056
Corynebacterium sp. MC1420	2709392	S	1	0	1	0.0000232056
Corynebacterium marinum	349751	S	1	0	1	0.0000232056
Corynebacterium sphenisci	191493	S	1	0	1	0.0000232056
Corynebacterium nuruki	1032851	S	1	0	1	0.0000232056
Corynebacterium endometrii	2488819	S	1	0	1	0.0000232056
Mycolicibacterium celeriflavum	1249101	S	1	0	1	0.0000232056
Mycolicibacterium hassiacum	46351	S	1	0	1	0.0000232056
Mycolicibacterium mageritense	53462	S	1	0	1	0.0000232056
Mycobacterium sp. EPa45	1545728	S	1	0	1	0.0000232056
Mycobacterium sp. ELW1	1547487	S	1	0	1	0.0000232056
Mycobacterium sp. YC-RL4	1682113	S	1	0	1	0.0000232056
Mycobacterium colombiense	339268	S	1	0	1	0.0000232056
Mycobacterium mantenii	560555	S	1	0	1	0.0000232056
Mycobacterium parmense	185642	S	1	0	1	0.0000232056
Mycobacterium saskatchewanense	220927	S	1	0	1	0.0000232056
Mycobacterium stomatepiae	470076	S	1	0	1	0.0000232056
Mycobacterium gordonae	1778	S	1	0	1	0.0000232056
Mycobacterium seoulense	386911	S	1	0	1	0.0000232056
Mycobacterium noviomagense	459858	S	1	0	1	0.0000232056
Mycobacterium riyadhense	486698	S	1	0	1	0.0000232056
Mycobacteroides saopaulense	1578165	S	1	0	1	0.0000232056
Mycolicibacter terrae	1788	S	1	0	1	0.0000232056
Mycolicibacter hiberniae	29314	S	1	0	1	0.0000232056
Streptomyces sp. YIM 121038	2136401	S	1	0	1	0.0000232056
Streptomyces sp. Tu 2975	2676871	S	1	0	1	0.0000232056
Streptomyces sp. CB09001	2083284	S	1	0	1	0.0000232056
Streptomyces sp. S063	2005885	S	1	0	1	0.0000232056
Streptomyces sp. TN58	234612	S	1	0	1	0.0000232056
Streptomyces sp. 769	1262452	S	1	0	1	0.0000232056
Streptomyces sp. MOE7	1961713	S	1	0	1	0.0000232056
Streptomyces sp. RLB1-33	2721243	S	1	0	1	0.0000232056
Streptomyces sp. RPA4-5	2721245	S	1	0	1	0.0000232056
Streptomyces sp. Z022	1442032	S	1	0	1	0.0000232056
Streptomyces sp. QMT-12	2717324	S	1	0	1	0.0000232056
Streptomyces sp. NA02536	2742133	S	1	0	1	0.0000232056
Streptomyces sp. Rer75	2750011	S	1	0	1	0.0000232056
Streptomyces sp. SM18	1736046	S	1	0	1	0.0000232056
Streptomyces sp. SUK 48	2582831	S	1	0	1	0.0000232056
Streptomyces sp. SN-593	659352	S	1	0	1	0.0000232056
Streptomyces sp. CB00271	2750025	S	1	0	1	0.0000232056
Streptomyces sp. 11-1-2	1851167	S	1	0	1	0.0000232056
Streptomyces sp. Mg1	465541	S	1	0	1	0.0000232056
Streptomyces sp. 3214.6	1882757	S	1	0	1	0.0000232056
Streptomyces sp. 3211	1964449	S	1	0	1	0.0000232056
Streptomyces griseofuscus	146922	S	1	0	1	0.0000232056
Streptomyces xiamenensis	408015	S	1	0	1	0.0000232056
Streptomyces lavendulae	1914	S	1	0	1	0.0000232056
Streptomyces davaonensis	348043	S	1	0	1	0.0000232056
Streptomyces antibioticus	1890	S	1	0	1	0.0000232056
Streptomyces hundungensis	1077946	S	1	0	1	0.0000232056
Streptomyces harbinensis	1176198	S	1	0	1	0.0000232056
Streptomyces cadmiisoli	2184053	S	1	0	1	0.0000232056
Streptomyces albidoflavus	1886	S	1	0	1	0.0000232056
Streptomyces cacaoi	1898	S	1	0	1	0.0000232056
Streptomyces atratus	1893	S	1	0	1	0.0000232056
Streptomyces ficellus	1977088	S	1	0	1	0.0000232056
Streptomyces prasinus	67345	S	1	0	1	0.0000232056
Streptomyces cyaneogriseus	68192	S	1	0	1	0.0000232056
Streptomyces aureoverticillatus	66871	S	1	0	1	0.0000232056
Streptomyces luteoverticillatus	66425	S	1	0	1	0.0000232056
Streptomyces olivoreticuli	68246	S	1	0	1	0.0000232056
Streptomyces nitrosporeus	28894	S	1	0	1	0.0000232056
Streptomyces tuirus	68278	S	1	0	1	0.0000232056
Streptomyces platensis	58346	S	1	0	1	0.0000232056
Streptomyces subrutilus	36818	S	1	0	1	0.0000232056
Streptomyces pristinaespiralis	38300	S	1	0	1	0.0000232056
Streptomyces scabiei	1930	S	1	0	1	0.0000232056
Streptomyces roseochromogenus	285450	S	1	0	1	0.0000232056
Streptacidiphilus sp. PB12-B1b	2705012	S	1	0	1	0.0000232056
Amycolatopsis sp. BJA-103	1911175	S	1	0	1	0.0000232056
Pseudonocardia sp. HH130630-07	1690815	S	1	0	1	0.0000232056
Saccharopolyspora sp. ASAGF58	2719023	S	1	0	1	0.0000232056
Saccharomonospora viridis	1852	S	1	0	1	0.0000232056
Saccharomonospora azurea	40988	S	1	0	1	0.0000232056
Saccharomonospora glauca	40990	S	1	0	1	0.0000232056
Micromonospora sp. B006	2201999	S	1	0	1	0.0000232056
Micromonospora chokoriensis	356851	S	1	0	1	0.0000232056
Micromonospora purpureochromogenes	47872	S	1	0	1	0.0000232056
Micromonospora terminaliae	1914461	S	1	0	1	0.0000232056
Actinoplanes derwentensis	113562	S	1	0	1	0.0000232056
Plantactinospora sp. KBS50	2024580	S	1	0	1	0.0000232056
Plantactinospora sp. BB1	2071627	S	1	0	1	0.0000232056
Actinomyces sp. Z16	2079536	S	1	0	1	0.0000232056
Actinomyces sp. ZJ34	2722820	S	1	0	1	0.0000232056
Actinomyces sp. zg-993	2763540	S	1	0	1	0.0000232056
Actinomyces viscosus	1656	S	1	0	1	0.0000232056
Actinomyces israelii	1659	S	1	0	1	0.0000232056
Actinomyces howellii	52771	S	1	0	1	0.0000232056
Actinomyces slackii	52774	S	1	0	1	0.0000232056
Actinomyces gaoshouyii	1960083	S	1	0	1	0.0000232056
Trueperella pyogenes	1661	S	1	0	1	0.0000232056
Schaalia cardiffensis	181487	S	1	0	1	0.0000232056
Arcanobacterium haemolyticum	28264	S	1	0	1	0.0000232056
Pauljensenia hongkongensis	178339	S	1	0	1	0.0000232056
Candidatus Planktophila limnetica	573600	S	1	0	1	0.0000232056
Candidatus Planktophila vernalis	1884907	S	1	0	1	0.0000232056
Candidatus Nanopelagicus hibericus	1884915	S	1	0	1	0.0000232056
Bifidobacterium bifidum	1681	S	1	0	1	0.0000232056
Bifidobacterium eulemuris	1765219	S	1	0	1	0.0000232056
Bifidobacterium saguini	762210	S	1	0	1	0.0000232056
Bifidobacterium scardovii	158787	S	1	0	1	0.0000232056
Bifidobacterium choerinum	35760	S	1	0	1	0.0000232056
Bifidobacterium pseudolongum	1694	S	1	0	1	0.0000232056
Bifidobacterium coryneforme	1687	S	1	0	1	0.0000232056
Bifidobacterium catenulatum	1686	S	1	0	1	0.0000232056
Bifidobacterium angulatum	1683	S	1	0	1	0.0000232056
Jatrophihabitans sp. GAS493	1907575	S	1	0	1	0.0000232056
Olsenella umbonata	604330	S	1	0	1	0.0000232056
Parolsenella massiliensis	1871022	S	1	0	1	0.0000232056
Lancefieldella parvula	1382	S	1	0	1	0.0000232056
Gordonibacter urolithinfaciens	1335613	S	1	0	1	0.0000232056
Adlercreutzia equolifaciens	446660	S	1	0	1	0.0000232056
Phoenicibacter congonensis	1944646	S	1	0	1	0.0000232056
Arabia massiliensis	1870985	S	1	0	1	0.0000232056
Berryella intestinalis	1531429	S	1	0	1	0.0000232056
Acidimicrobium ferrooxidans	53635	S	1	0	1	0.0000232056
Rubrobacter sp. SCSIO 52909	2653851	S	1	0	1	0.0000232056
Rubrobacter sp. SCSIO 52915	2653852	S	1	0	1	0.0000232056
Rubrobacter xylanophilus	49319	S	1	0	1	0.0000232056
Staphylococcus sp. 17KM0847	2583989	S	1	0	1	0.0000232056
Staphylococcus caprae	29380	S	1	0	1	0.0000232056
Staphylococcus lloydii	2781774	S	1	0	1	0.0000232056
Staphylococcus hyicus	1284	S	1	0	1	0.0000232056
Staphylococcus agnetis	985762	S	1	0	1	0.0000232056
[Micrococcus] candicans	946432	S	1	0	1	0.0000232056
Jeotgalicoccus saudimassiliensis	1461582	S	1	0	1	0.0000232056
Abyssicoccus albus	1817405	S	1	0	1	0.0000232056
Bacillus sp. OxB-1	98228	S	1	0	1	0.0000232056
Bacillus sp. B25(2016b)	1868655	S	1	0	1	0.0000232056
Bacillus sp. FJAT-22090	1581038	S	1	0	1	0.0000232056
Bacillus sp. NSP9.1	1071078	S	1	0	1	0.0000232056
Bacillus inaquosorum	483913	S	1	0	1	0.0000232056
Bacillus smithii	1479	S	1	0	1	0.0000232056
Bacillus weihaiensis	1547283	S	1	0	1	0.0000232056
Bacillus glycinifermentans	1664069	S	1	0	1	0.0000232056
Bacillus safensis	561879	S	1	0	1	0.0000232056
Bacillus infantis	324767	S	1	0	1	0.0000232056
Bacillus vietnamensis	218284	S	1	0	1	0.0000232056
Bacillus pumilus	1408	S	1	0	1	0.0000232056
Bacillus freudenreichii	1783501	S	1	0	1	0.0000232056
Bacillus sporothermodurans	46224	S	1	0	1	0.0000232056
Priestia flexa	86664	S	1	0	1	0.0000232056
Virgibacillus phasianinus	2017483	S	1	0	1	0.0000232056
Lysinibacillus sp. YS11	2072025	S	1	0	1	0.0000232056
Lysinibacillus sp. 2017	2169540	S	1	0	1	0.0000232056
Alkalihalobacillus pseudofirmus	79885	S	1	0	1	0.0000232056
Alkalihalobacillus halodurans	86665	S	1	0	1	0.0000232056
Peribacillus asahii	228899	S	1	0	1	0.0000232056
Anoxybacillus caldiproteolyticus	247480	S	1	0	1	0.0000232056
Halobacillus mangrovi	402384	S	1	0	1	0.0000232056
Metabacillus litoralis	152268	S	1	0	1	0.0000232056
Cytobacillus kochii	859143	S	1	0	1	0.0000232056
Fictibacillus arsenicus	255247	S	1	0	1	0.0000232056
Fictibacillus phosphorivorans	1221500	S	1	0	1	0.0000232056
Aeribacillus pallidus	33936	S	1	0	1	0.0000232056
Amphibacillus xylanus	1449	S	1	0	1	0.0000232056
Gracilibacillus sp. SCU50	2663022	S	1	0	1	0.0000232056
Salicibibacter kimchii	2099786	S	1	0	1	0.0000232056
Lentibacillus amyloliquefaciens	1472767	S	1	0	1	0.0000232056
Neobacillus cucumis	1740721	S	1	0	1	0.0000232056
Mesobacillus jeotgali	129985	S	1	0	1	0.0000232056
Paraliobacillus zengyii	2213194	S	1	0	1	0.0000232056
Parageobacillus genomosp. 1	1295642	S	1	0	1	0.0000232056
Terribacillus goriensis	386490	S	1	0	1	0.0000232056
Psychrobacillus glaciei	2283160	S	1	0	1	0.0000232056
Anaerobacillus isosaccharinicus	1532552	S	1	0	1	0.0000232056
Paenibacillus sp. HB172198	2565926	S	1	0	1	0.0000232056
Paenibacillus sp. TB2019	2810347	S	1	0	1	0.0000232056
Paenibacillus sp. Y412MC10	481743	S	1	0	1	0.0000232056
Paenibacillus sp. URB8-2	2741301	S	1	0	1	0.0000232056
Paenibacillus sp. FSL R5-0345	1536770	S	1	0	1	0.0000232056
Paenibacillus sp. FSL R5-0912	1536771	S	1	0	1	0.0000232056
Paenibacillus bovis	1616788	S	1	0	1	0.0000232056
Paenibacillus cellulositrophicus	562959	S	1	0	1	0.0000232056
Paenibacillus beijingensis	1126833	S	1	0	1	0.0000232056
Paenibacillus lentus	1338368	S	1	0	1	0.0000232056
Paenibacillus yonginensis	1462996	S	1	0	1	0.0000232056
Paenibacillus guangzhouensis	1473112	S	1	0	1	0.0000232056
Paenibacillus lutimineralis	2707005	S	1	0	1	0.0000232056
Paenibacillus physcomitrellae	1619311	S	1	0	1	0.0000232056
Paenibacillus baekrokdamisoli	1712516	S	1	0	1	0.0000232056
Paenibacillus crassostreae	1763538	S	1	0	1	0.0000232056
Paenibacillus lycopersici	2704462	S	1	0	1	0.0000232056
Paenibacillus cellulosilyticus	375489	S	1	0	1	0.0000232056
Paenibacillus chitinolyticus	79263	S	1	0	1	0.0000232056
Paenibacillus terrae	159743	S	1	0	1	0.0000232056
Paenibacillus thiaminolyticus	49283	S	1	0	1	0.0000232056
Paenibacillus kribbensis	172713	S	1	0	1	0.0000232056
Paenibacillus alvei	44250	S	1	0	1	0.0000232056
Brevibacillus sp. SCSIO 07484	2496837	S	1	0	1	0.0000232056
Brevibacillus sp. JNUCC-41	2778370	S	1	0	1	0.0000232056
Brevibacillus agri	51101	S	1	0	1	0.0000232056
Brevibacillus formosus	54913	S	1	0	1	0.0000232056
Cohnella sp. KS 22	2598458	S	1	0	1	0.0000232056
Cohnella sp. MFER-1	2728023	S	1	0	1	0.0000232056
Cohnella abietis	2507935	S	1	0	1	0.0000232056
Cohnella candidum	2674991	S	1	0	1	0.0000232056
Planococcus sp. PAMC 21323	1526927	S	1	0	1	0.0000232056
Planococcus sp. Y42	2213202	S	1	0	1	0.0000232056
Planococcus plakortidis	1038856	S	1	0	1	0.0000232056
Planococcus halocryophilus	1215089	S	1	0	1	0.0000232056
Sporosarcina sp. Te-1	2818390	S	1	0	1	0.0000232056
Ureibacillus thermosphaericus	51173	S	1	0	1	0.0000232056
Tumebacillus algifaecis	1214604	S	1	0	1	0.0000232056
Alicyclobacillus sp. TC	2606450	S	1	0	1	0.0000232056
Gemella morbillorum	29391	S	1	0	1	0.0000232056
Exiguobacterium sp. Helios	2735868	S	1	0	1	0.0000232056
Listeria seeligeri	1640	S	1	0	1	0.0000232056
Listeria innocua	1642	S	1	0	1	0.0000232056
Listeria welshimeri	1643	S	1	0	1	0.0000232056
Listeria weihenstephanensis	1006155	S	1	0	1	0.0000232056
Kroppenstedtia eburnea	714067	S	1	0	1	0.0000232056
Kroppenstedtia pulmonis	1380685	S	1	0	1	0.0000232056
Thermoactinomyces vulgaris	2026	S	1	0	1	0.0000232056
Novibacillus thermophilus	1471761	S	1	0	1	0.0000232056
Streptococcus sp. oral taxon 061	712623	S	1	0	1	0.0000232056
Streptococcus sp. oral taxon 064	712624	S	1	0	1	0.0000232056
Streptococcus sp. zg-86	2664091	S	1	0	1	0.0000232056
Streptococcus sp. A12	1759399	S	1	0	1	0.0000232056
Streptococcus troglodytae	1111760	S	1	0	1	0.0000232056
Streptococcus pseudopneumoniae	257758	S	1	0	1	0.0000232056
Streptococcus pseudoporcinus	361101	S	1	0	1	0.0000232056
Streptococcus sobrinus	1310	S	1	0	1	0.0000232056
Streptococcus himalayensis	1888195	S	1	0	1	0.0000232056
Streptococcus respiraculi	2021971	S	1	0	1	0.0000232056
Streptococcus gordonii	1302	S	1	0	1	0.0000232056
Streptococcus vestibularis	1343	S	1	0	1	0.0000232056
Streptococcus mutans	1309	S	1	0	1	0.0000232056
Streptococcus parasanguinis	1318	S	1	0	1	0.0000232056
Streptococcus ratti	1341	S	1	0	1	0.0000232056
Streptococcus iniae	1346	S	1	0	1	0.0000232056
Lactococcus piscium	1364	S	1	0	1	0.0000232056
Lactobacillus ultunensis	227945	S	1	0	1	0.0000232056
Lactobacillus paragasseri	2107999	S	1	0	1	0.0000232056
Lactobacillus jensenii	109790	S	1	0	1	0.0000232056
Leuconostoc suionicum	1511761	S	1	0	1	0.0000232056
Limosilactobacillus reuteri	1598	S	1	0	1	0.0000232056
Weissella confusa	1583	S	1	0	1	0.0000232056
Weissella koreensis	165096	S	1	0	1	0.0000232056
Weissella sp. HDW19	2714949	S	1	0	1	0.0000232056
Companilactobacillus alimentarius	1602	S	1	0	1	0.0000232056
Companilactobacillus heilongjiangensis	1074467	S	1	0	1	0.0000232056
Companilactobacillus zhachilii	2304606	S	1	0	1	0.0000232056
Lactiplantibacillus paraplantarum	60520	S	1	0	1	0.0000232056
Ligilactobacillus murinus	1622	S	1	0	1	0.0000232056
Ligilactobacillus ruminis	1623	S	1	0	1	0.0000232056
Latilactobacillus fuchuensis	164393	S	1	0	1	0.0000232056
Paucilactobacillus oligofermentans	293371	S	1	0	1	0.0000232056
Levilactobacillus zymae	267363	S	1	0	1	0.0000232056
Secundilactobacillus malefermentans	176292	S	1	0	1	0.0000232056
Lentilactobacillus buchneri	1581	S	1	0	1	0.0000232056
Lentilactobacillus kefiri	33962	S	1	0	1	0.0000232056
Oenococcus oeni	1247	S	1	0	1	0.0000232056
Oenococcus sp. UCMA 16435	2259623	S	1	0	1	0.0000232056
Fructilactobacillus sanfranciscensis	1625	S	1	0	1	0.0000232056
Furfurilactobacillus rossiae	231049	S	1	0	1	0.0000232056
Enterococcus hirae	1354	S	1	0	1	0.0000232056
Enterococcus mundtii	53346	S	1	0	1	0.0000232056
Vagococcus penaei	633807	S	1	0	1	0.0000232056
Vagococcus coleopterorum	2714946	S	1	0	1	0.0000232056
Tetragenococcus halophilus	51669	S	1	0	1	0.0000232056
Tetragenococcus osmophilus	526944	S	1	0	1	0.0000232056
Carnobacterium divergens	2748	S	1	0	1	0.0000232056
Carnobacterium sp. 17-4	208596	S	1	0	1	0.0000232056
Jeotgalibaca ciconiae	2496265	S	1	0	1	0.0000232056
Clostridium sp. SY8519	1042156	S	1	0	1	0.0000232056
Clostridium novyi	1542	S	1	0	1	0.0000232056
Clostridium chauvoei	46867	S	1	0	1	0.0000232056
Clostridium bornimense	1216932	S	1	0	1	0.0000232056
Clostridium thermarum	1716543	S	1	0	1	0.0000232056
Alkaliphilus metalliredigens	208226	S	1	0	1	0.0000232056
Alkaliphilus oremlandii	461876	S	1	0	1	0.0000232056
Caloramator sp. E03	2576307	S	1	0	1	0.0000232056
Hathewaya histolytica	1498	S	1	0	1	0.0000232056
Anaerostipes caccae	105841	S	1	0	1	0.0000232056
Blautia sp. LZLJ-3	2779518	S	1	0	1	0.0000232056
Blautia hansenii	1322	S	1	0	1	0.0000232056
Anaerocolumna sp. CTTW	2736602	S	1	0	1	0.0000232056
Anaerocolumna sedimenticola	2696063	S	1	0	1	0.0000232056
Butyrivibrio fibrisolvens	831	S	1	0	1	0.0000232056
Butyrivibrio hungatei	185008	S	1	0	1	0.0000232056
Lachnoclostridium phytofermentans	66219	S	1	0	1	0.0000232056
Anaerobutyricum hallii	39488	S	1	0	1	0.0000232056
Lachnospira eligens	39485	S	1	0	1	0.0000232056
Enterocloster bolteae	208479	S	1	0	1	0.0000232056
Ruminiclostridium cellulolyticum	1521	S	1	0	1	0.0000232056
Acetivibrio clariflavus	288965	S	1	0	1	0.0000232056
Fastidiosipila sanguinis	236753	S	1	0	1	0.0000232056
Oscillibacter valericigenes	351091	S	1	0	1	0.0000232056
Romboutsia hominis	1507512	S	1	0	1	0.0000232056
Romboutsia sp. CE17	2724150	S	1	0	1	0.0000232056
Desulfosporosinus acidiphilus	885581	S	1	0	1	0.0000232056
Desulfotomaculum nigrificans	1565	S	1	0	1	0.0000232056
Desulfotomaculum reducens	59610	S	1	0	1	0.0000232056
Thermaerobacter sp. PB12/4term	2293838	S	1	0	1	0.0000232056
Mogibacterium diversum	114527	S	1	0	1	0.0000232056
Candidatus Syntrophocurvum alkaliphilum	2293317	S	1	0	1	0.0000232056
Christensenella sp. Marseille-P3954	2086585	S	1	0	1	0.0000232056
Caldicellulosiruptor saccharolyticus	44001	S	1	0	1	0.0000232056
Caldicellulosiruptor kronotskyensis	413889	S	1	0	1	0.0000232056
Caldicellulosiruptor changbaiensis	1222016	S	1	0	1	0.0000232056
Moorella thermoacetica	1525	S	1	0	1	0.0000232056
Moorella glycerini	55779	S	1	0	1	0.0000232056
Halanaerobium praevalens	2331	S	1	0	1	0.0000232056
Thermosediminibacter oceani	291990	S	1	0	1	0.0000232056
Natranaerobius thermophilus	375929	S	1	0	1	0.0000232056
Megamonas hypermegale	158847	S	1	0	1	0.0000232056
Selenomonas sp. oral taxon 126	712528	S	1	0	1	0.0000232056
Selenomonas sp. Marseille-Q3039	2754044	S	1	0	1	0.0000232056
Selenomonas ruminantium	971	S	1	0	1	0.0000232056
Pelosinus sp. UFO1	484770	S	1	0	1	0.0000232056
Sporomusa termitida	2377	S	1	0	1	0.0000232056
Veillonella nakazawae	2682456	S	1	0	1	0.0000232056
Megasphaera elsdenii	907	S	1	0	1	0.0000232056
Dialister pneumosintes	39950	S	1	0	1	0.0000232056
Dialister massiliensis	2161821	S	1	0	1	0.0000232056
Anaerococcus vaginalis	33037	S	1	0	1	0.0000232056
Anaerococcus obesiensis	1287640	S	1	0	1	0.0000232056
[Clostridium] innocuum	1522	S	1	0	1	0.0000232056
Faecalitalea cylindroides	39483	S	1	0	1	0.0000232056
Limnochorda pilosa	1555112	S	1	0	1	0.0000232056
Nostoc sp. 'Lobaria pulmonaria (5183) cyanobiont'	1618022	S	1	0	1	0.0000232056
Nostoc sp. CENA543	1869241	S	1	0	1	0.0000232056
Nostoc sp. TCL26-01	2576904	S	1	0	1	0.0000232056
Nostoc sp. UHCC 0702	2814655	S	1	0	1	0.0000232056
Nostoc flagelliforme	1306274	S	1	0	1	0.0000232056
Calothrix sp. NIES-2100	1954172	S	1	0	1	0.0000232056
Anabaenopsis elenkinii	156213	S	1	0	1	0.0000232056
Nodularia spumigena	70799	S	1	0	1	0.0000232056
Sphaerospermopsis kisseleviana	289435	S	1	0	1	0.0000232056
Fischerella sp. NIES-3754	1752063	S	1	0	1	0.0000232056
Brasilonema sennae	1397703	S	1	0	1	0.0000232056
Synechococcus sp. BIOS-U3-1	1400865	S	1	0	1	0.0000232056
Synechococcus sp. NOUM97013	1442555	S	1	0	1	0.0000232056
Synechococcus sp. PROS-7-1	1442556	S	1	0	1	0.0000232056
Synechococcus sp. JA-3-3Ab	321327	S	1	0	1	0.0000232056
Synechococcus sp. RS9909	221352	S	1	0	1	0.0000232056
Synechococcus sp. Minos11	221341	S	1	0	1	0.0000232056
Synechococcus sp. PCC 6312	195253	S	1	0	1	0.0000232056
Synechococcus sp. SynAce01	1916956	S	1	0	1	0.0000232056
Synechococcus sp. CBW1108	1353147	S	1	0	1	0.0000232056
Synechococcus sp. WH 8101	59932	S	1	0	1	0.0000232056
Synechococcus sp. CC9311	64471	S	1	0	1	0.0000232056
Synechococcus elongatus	32046	S	1	0	1	0.0000232056
Cyanobium sp. NS01	261284	S	1	0	1	0.0000232056
Leptolyngbya sp. BL0902	1115757	S	1	0	1	0.0000232056
Leptolyngbya sp. NIES-3755	1752064	S	1	0	1	0.0000232056
Synechocystis sp. PCC 6714	1147	S	1	0	1	0.0000232056
Geminocystis herdmanii	669359	S	1	0	1	0.0000232056
Oxynema sp. AP17	2064643	S	1	0	1	0.0000232056
Cyanothece sp. PCC 7425	395961	S	1	0	1	0.0000232056
Geitlerinema sp. PCC 7407	1173025	S	1	0	1	0.0000232056
Crinalium epipsammum	241425	S	1	0	1	0.0000232056
Gloeomargarita lithophora	1188228	S	1	0	1	0.0000232056
Mycoplasma sp. Mirounga ES2805-ORL	754514	S	1	0	1	0.0000232056
Mycoplasma sp. Phocoena C-264-GEN	754517	S	1	0	1	0.0000232056
Mycoplasma sp. (ex Biomphalaria glabrata)	1749074	S	1	0	1	0.0000232056
Mycoplasma sp. NEAQ87857	2683967	S	1	0	1	0.0000232056
Mycoplasma sp. C264-NAS	2726117	S	1	0	1	0.0000232056
Mycoplasma sp. OR1901	2742195	S	1	0	1	0.0000232056
Mycoplasma capricolum	2095	S	1	0	1	0.0000232056
Mycoplasma dispar	86660	S	1	0	1	0.0000232056
Mycoplasma yeatsii	51365	S	1	0	1	0.0000232056
Mycoplasma gallisepticum	2096	S	1	0	1	0.0000232056
Mycoplasma glycophilum	171285	S	1	0	1	0.0000232056
Mycoplasma citelli	171281	S	1	0	1	0.0000232056
Mycoplasma pullorum	48003	S	1	0	1	0.0000232056
Mycoplasma felis	33923	S	1	0	1	0.0000232056
Mycoplasma bovigenitalium	2112	S	1	0	1	0.0000232056
Mycoplasma agalactiae	2110	S	1	0	1	0.0000232056
Mycoplasma bovirhinis	29553	S	1	0	1	0.0000232056
Ureaplasma urealyticum	2130	S	1	0	1	0.0000232056
Spiroplasma alleghenense	216931	S	1	0	1	0.0000232056
Spiroplasma chinense	216932	S	1	0	1	0.0000232056
Spiroplasma chrysopicola	216933	S	1	0	1	0.0000232056
Spiroplasma culicicola	216935	S	1	0	1	0.0000232056
Spiroplasma tabanidicola	324079	S	1	0	1	0.0000232056
Spiroplasma sabaudiense	216944	S	1	0	1	0.0000232056
Spiroplasma syrphidicola	216945	S	1	0	1	0.0000232056
Entomoplasma freundtii	74700	S	1	0	1	0.0000232056
Mesoplasma lactucae	138853	S	1	0	1	0.0000232056
Acholeplasma palmae	38986	S	1	0	1	0.0000232056
Candidatus Phytoplasma ziziphi	135727	S	1	0	1	0.0000232056
Candidatus Phytoplasma australiense	59748	S	1	0	1	0.0000232056
Deinococcus sp. NW-56	2080419	S	1	0	1	0.0000232056
Deinococcus sp. S14-83	2489213	S	1	0	1	0.0000232056
Deinococcus sp. AJ005	2652443	S	1	0	1	0.0000232056
Deinococcus peraridilitoris	432329	S	1	0	1	0.0000232056
Deinococcus wulumuqiensis	980427	S	1	0	1	0.0000232056
Deinococcus metallilatus	1211322	S	1	0	1	0.0000232056
Deinococcus irradiatisoli	2202254	S	1	0	1	0.0000232056
Deinococcus radiodurans	1299	S	1	0	1	0.0000232056
Thermus caldilimi	2483360	S	1	0	1	0.0000232056
Meiothermus silvanus	52022	S	1	0	1	0.0000232056
Truepera radiovictrix	332249	S	1	0	1	0.0000232056
Chloroflexus aggregans	152260	S	1	0	1	0.0000232056
Roseiflexus castenholzii	120962	S	1	0	1	0.0000232056
Thermomicrobium roseum	500	S	1	0	1	0.0000232056
Dehalococcoides mccartyi	61435	S	1	0	1	0.0000232056
Dehalococcoides sp. UCH007	1522671	S	1	0	1	0.0000232056
Thermobaculum terrenum	166501	S	1	0	1	0.0000232056
Ktedonosporobacter rubrisoli	2509675	S	1	0	1	0.0000232056
Tepidiforma bonchosmolovskayae	2601677	S	1	0	1	0.0000232056
Polaribacter haliotis	1888915	S	1	0	1	0.0000232056
Formosa sp. L2A11	2686363	S	1	0	1	0.0000232056
Myroides sp. ZB35	1458492	S	1	0	1	0.0000232056
Tenacibaculum mesophilum	104268	S	1	0	1	0.0000232056
Winogradskyella sp. J14-2	1936080	S	1	0	1	0.0000232056
Capnocytophaga sputigena	1019	S	1	0	1	0.0000232056
Capnocytophaga leadbetteri	327575	S	1	0	1	0.0000232056
Capnocytophaga endodontalis	2708117	S	1	0	1	0.0000232056
Maribacter sp. HTCC2170	313603	S	1	0	1	0.0000232056
Aquimarina sp. TRL1	2736252	S	1	0	1	0.0000232056
Nonlabens sp. Ci31	2608253	S	1	0	1	0.0000232056
Nonlabens marinus	930802	S	1	0	1	0.0000232056
Lacinutrix sp. Bg11-31	2057808	S	1	0	1	0.0000232056
Algibacter sp. L1A34	2686365	S	1	0	1	0.0000232056
Algibacter alginicilyticus	1736674	S	1	0	1	0.0000232056
Gramella echinicola	279359	S	1	0	1	0.0000232056
Gramella salexigens	1913577	S	1	0	1	0.0000232056
Gramella sp. MAR_2010_147	1250205	S	1	0	1	0.0000232056
Aequorivita sublithincola	101385	S	1	0	1	0.0000232056
Tamlana carrageenivorans	2069432	S	1	0	1	0.0000232056
Tamlana sp. s12	1630406	S	1	0	1	0.0000232056
Aureitalea sp. RR4-38	2094025	S	1	0	1	0.0000232056
Costertonia aggregata	343403	S	1	0	1	0.0000232056
Robiginitalea biformata	252307	S	1	0	1	0.0000232056
Chryseobacterium sp.	1871047	S	1	0	1	0.0000232056
Chryseobacterium gallinarum	1324352	S	1	0	1	0.0000232056
Chryseobacterium gleum	250	S	1	0	1	0.0000232056
Apibacter sp. B2966	2656761	S	1	0	1	0.0000232056
Weeksella virosa	1014	S	1	0	1	0.0000232056
Blattabacterium sp. (Cryptocercus kyebangensis)	298656	S	1	0	1	0.0000232056
Blattabacterium sp. (Nauphoeta cinerea)	1316444	S	1	0	1	0.0000232056
Candidatus Walczuchella monophlebidarum	1415657	S	1	0	1	0.0000232056
Owenweeksia hongkongensis	253245	S	1	0	1	0.0000232056
Croceimicrobium hydrocarbonivorans	2761580	S	1	0	1	0.0000232056
Spirosoma radiotolerans	1379870	S	1	0	1	0.0000232056
Spirosoma aureum	2692134	S	1	0	1	0.0000232056
Arcticibacterium luteifluviistationis	1784714	S	1	0	1	0.0000232056
Hymenobacter sp. DG25A	1385663	S	1	0	1	0.0000232056
Rufibacter tibetensis	512763	S	1	0	1	0.0000232056
Rufibacter sp. DG15C	1379909	S	1	0	1	0.0000232056
Echinicola sp. 20G	2781961	S	1	0	1	0.0000232056
Algoriphagus sanaruensis	1727163	S	1	0	1	0.0000232056
Pedobacter steynii	430522	S	1	0	1	0.0000232056
Sphingobacterium sp. CZ-2	2557994	S	1	0	1	0.0000232056
Sphingobacterium thalpophilum	259	S	1	0	1	0.0000232056
Mucilaginibacter ginsenosidivorax	862126	S	1	0	1	0.0000232056
Anseongella ginsenosidimutans	496056	S	1	0	1	0.0000232056
Bacteroides sp. CBA7301	2715212	S	1	0	1	0.0000232056
Bacteroides uniformis	820	S	1	0	1	0.0000232056
Bacteroides zoogleoformans	28119	S	1	0	1	0.0000232056
Bacteroides coprosuis	151276	S	1	0	1	0.0000232056
Bacteroides xylanisolvens	371601	S	1	0	1	0.0000232056
Prevotella sp. oral taxon 299	652716	S	1	0	1	0.0000232056
Prevotella oris	28135	S	1	0	1	0.0000232056
Prevotella dentalis	52227	S	1	0	1	0.0000232056
Prevotella fusca	589436	S	1	0	1	0.0000232056
Prevotella scopos	589437	S	1	0	1	0.0000232056
Paraprevotella xylaniphila	454155	S	1	0	1	0.0000232056
Alistipes indistinctus	626932	S	1	0	1	0.0000232056
Alistipes communis	2585118	S	1	0	1	0.0000232056
Alistipes dispar	2585119	S	1	0	1	0.0000232056
Alistipes sp. dk3624	2662363	S	1	0	1	0.0000232056
Tannerella sp. oral taxon HOT-286	712710	S	1	0	1	0.0000232056
Porphyromonas gingivalis	837	S	1	0	1	0.0000232056
Odoribacter splanchnicus	28118	S	1	0	1	0.0000232056
Pelodictyon luteolum	1100	S	1	0	1	0.0000232056
Pelodictyon phaeoclathratiforme	34090	S	1	0	1	0.0000232056
Prosthecochloris sp. GSB1	281093	S	1	0	1	0.0000232056
Prosthecochloris sp. CIB 2401	1868325	S	1	0	1	0.0000232056
Chlorobaculum limnaeum	274537	S	1	0	1	0.0000232056
Chloroherpeton thalassium	100716	S	1	0	1	0.0000232056
Melioribacter roseus	1134405	S	1	0	1	0.0000232056
Candidatus Cloacimonas acidaminovorans	456827	S	1	0	1	0.0000232056
Thermogutta terrifontis	1331910	S	1	0	1	0.0000232056
Akkermansia glycaniphila	1679444	S	1	0	1	0.0000232056
Methylacidiphilum sp. IT6	2795386	S	1	0	1	0.0000232056
Methylacidiphilum kamchatkense	431057	S	1	0	1	0.0000232056
Candidatus Xiphinematobacter sp. Idaho Grape	1704307	S	1	0	1	0.0000232056
Chlamydia sp. 2742-308	1806891	S	1	0	1	0.0000232056
Chlamydia abortus	83555	S	1	0	1	0.0000232056
Chlamydia muridarum	83560	S	1	0	1	0.0000232056
Chlamydia pecorum	85991	S	1	0	1	0.0000232056
Candidatus Protochlamydia amoebophila	362787	S	1	0	1	0.0000232056
Candidatus Protochlamydia naegleriophila	389348	S	1	0	1	0.0000232056
Waddlia chondrophila	71667	S	1	0	1	0.0000232056
Borrelia hermsii	140	S	1	0	1	0.0000232056
Borrelia turicatae	142	S	1	0	1	0.0000232056
Borreliella burgdorferi	139	S	1	0	1	0.0000232056
Borreliella afzelii	29518	S	1	0	1	0.0000232056
Borreliella garinii	29519	S	1	0	1	0.0000232056
Treponema sp. OMZ 838	1539298	S	1	0	1	0.0000232056
Treponema sp. RCC2812	2787628	S	1	0	1	0.0000232056
Treponema denticola	158	S	1	0	1	0.0000232056
Salinispira pacifica	1307761	S	1	0	1	0.0000232056
Sediminispirochaeta smaragdinae	55206	S	1	0	1	0.0000232056
Oceanispirochaeta crateris	2518645	S	1	0	1	0.0000232056
Leptospira santarosai	28183	S	1	0	1	0.0000232056
Leptospira mayottensis	1137606	S	1	0	1	0.0000232056
Leptospira tipperaryensis	2564040	S	1	0	1	0.0000232056
Brachyspira murdochii	84378	S	1	0	1	0.0000232056
Fusobacterium sp. NSJ-57	2764326	S	1	0	1	0.0000232056
Fusobacterium mortiferum	850	S	1	0	1	0.0000232056
Fusobacterium canifelinum	285729	S	1	0	1	0.0000232056
Fusobacterium pseudoperiodonticum	2663009	S	1	0	1	0.0000232056
Leptotrichia sp. oral taxon 212	712357	S	1	0	1	0.0000232056
Leptotrichia sp. oral taxon 498	712368	S	1	0	1	0.0000232056
Leptotrichia buccalis	40542	S	1	0	1	0.0000232056
Sebaldella termitidis	826	S	1	0	1	0.0000232056
Terriglobus albidus	1592106	S	1	0	1	0.0000232056
Thermosipho melanesiensis	46541	S	1	0	1	0.0000232056
Kosmotoga olearia	651457	S	1	0	1	0.0000232056
Nitrospira japonica	1325564	S	1	0	1	0.0000232056
Candidatus Nitrospira inopinata	1715989	S	1	0	1	0.0000232056
Leptospirillum sp. Group II 'CF-1'	1660083	S	1	0	1	0.0000232056
Dissulfurispira thermophila	2715679	S	1	0	1	0.0000232056
Candidatus Chazhemtobacterium aquaticus	2715735	S	1	0	1	0.0000232056
Thermanaerovibrio velox	108007	S	1	0	1	0.0000232056
Jonquetella anthropi	428712	S	1	0	1	0.0000232056
Fretibacterium fastidiosum	651822	S	1	0	1	0.0000232056
Thermodesulfobacterium commune	1741	S	1	0	1	0.0000232056
Thermodesulfobacterium sp. TA1	2234087	S	1	0	1	0.0000232056
Thermosulfuriphilus ammonigenes	1936021	S	1	0	1	0.0000232056
Geovibrio thiophilus	139438	S	1	0	1	0.0000232056
Denitrovibrio acetiphilus	118000	S	1	0	1	0.0000232056
Calditerrivibrio nitroreducens	477976	S	1	0	1	0.0000232056
Sulfurihydrogenibium azorense	309806	S	1	0	1	0.0000232056
Sulfurihydrogenibium sp. YO3AOP1	436114	S	1	0	1	0.0000232056
Persephonella marina	309805	S	1	0	1	0.0000232056
Desulfurispirillum indicum	936456	S	1	0	1	0.0000232056
Halorubrum sp. BOL3-1	2497325	S	1	0	1	0.0000232056
Halorubrum sp. RHB-C	2739057	S	1	0	1	0.0000232056
Halorubrum lacusprofundi	2247	S	1	0	1	0.0000232056
Halobonum sp. Gai3-2	2743090	S	1	0	1	0.0000232056
Halopenitus persicus	1048396	S	1	0	1	0.0000232056
Haloprofundus sp. MHR1	2572921	S	1	0	1	0.0000232056
Haloarcula sp. JP-L23	2716717	S	1	0	1	0.0000232056
Natronomonas pharaonis	2257	S	1	0	1	0.0000232056
Halorhabdus tiamatea	430914	S	1	0	1	0.0000232056
Halorientalis sp. IM1011	1932360	S	1	0	1	0.0000232056
Halapricum salinum	1457250	S	1	0	1	0.0000232056
Halobacterium sp. BOL4-2	2810537	S	1	0	1	0.0000232056
Halorussus sp. RC-68	2505977	S	1	0	1	0.0000232056
Halorussus sp. ZS-3	2650975	S	1	0	1	0.0000232056
Haloterrigena turkmenica	62320	S	1	0	1	0.0000232056
Haloterrigena daqingensis	588898	S	1	0	1	0.0000232056
Natrinema versiforme	88724	S	1	0	1	0.0000232056
Natrinema sp. YPL30	1710539	S	1	0	1	0.0000232056
Natrarchaeobaculum sulfurireducens	2044521	S	1	0	1	0.0000232056
Methanosarcina horonobensis	418008	S	1	0	1	0.0000232056
Methanosarcina flavescens	1715806	S	1	0	1	0.0000232056
Methanosarcina sp. Kolksee	1434099	S	1	0	1	0.0000232056
Methanohalophilus portucalensis	39664	S	1	0	1	0.0000232056
Methanolobus zinderi	536044	S	1	0	1	0.0000232056
Methanohalobium evestigatum	2322	S	1	0	1	0.0000232056
Methanomethylovorans hollandica	101192	S	1	0	1	0.0000232056
Methanosalsum zhilinae	39669	S	1	0	1	0.0000232056
Methanolacinia petrolearia	54120	S	1	0	1	0.0000232056
Methanocella paludicola	570267	S	1	0	1	0.0000232056
Methanocella arvoryzae	1175445	S	1	0	1	0.0000232056
Methanocaldococcus infernus	67760	S	1	0	1	0.0000232056
Methanocaldococcus fervens	83171	S	1	0	1	0.0000232056
Methanocaldococcus bathoardescens	1301915	S	1	0	1	0.0000232056
Methanotorris igneus	2189	S	1	0	1	0.0000232056
Methanobrevibacter smithii	2173	S	1	0	1	0.0000232056
Methanobacterium paludis	868131	S	1	0	1	0.0000232056
Methanothermobacter sp. CaT2	866790	S	1	0	1	0.0000232056
Methanothermus fervidus	2180	S	1	0	1	0.0000232056
Pyrococcus yayanosii	1008460	S	1	0	1	0.0000232056
Pyrococcus sp. 12/1	758582	S	1	0	1	0.0000232056
Methanopyrus sp. KOL6	1937004	S	1	0	1	0.0000232056
Nitrosopumilus maritimus	338192	S	1	0	1	0.0000232056
Nitrosopumilus cobalaminigenes	1470066	S	1	0	1	0.0000232056
Nitrosopumilus ureiphilus	1470067	S	1	0	1	0.0000232056
Nitrosopumilus piranensis	1582439	S	1	0	1	0.0000232056
Candidatus Nitrosopumilus sp. SW	2508726	S	1	0	1	0.0000232056
Candidatus Nitrosotenuis cloacae	1603555	S	1	0	1	0.0000232056
Candidatus Nitrosotenuis sp. DW1	2259672	S	1	0	1	0.0000232056
Candidatus Nitrosocosmicus oleophilus	1353260	S	1	0	1	0.0000232056
Candidatus Nitrosocosmicus franklandus	1798806	S	1	0	1	0.0000232056
Candidatus Nitrosocosmicus hydrocola	1826872	S	1	0	1	0.0000232056
Candidatus Nitrososphaera gargensis	497727	S	1	0	1	0.0000232056
Nitrososphaera viennensis	1034015	S	1	0	1	0.0000232056
Acidianus brierleyi	41673	S	1	0	1	0.0000232056
Sulfolobus sp. S-194	2512240	S	1	0	1	0.0000232056
Sulfodiicoccus acidiphilus	1670455	S	1	0	1	0.0000232056
Thermoproteus tenax	2271	S	1	0	1	0.0000232056
Pyrobaculum aerophilum	13773	S	1	0	1	0.0000232056
Caldivirga maquilingensis	76887	S	1	0	1	0.0000232056
Caldisphaera lagunensis	200415	S	1	0	1	0.0000232056
Candidatus Mancarchaeum acidiphilum	1920749	S	1	0	1	0.0000232056
Ferroplasma acidiphilum	74969	S	1	0	1	0.0000232056
Rhizobium phage 16-3	10704	S	1	0	1	0.0000232056
Pseudomonas phage phiPSA1	1500757	S	1	0	1	0.0000232056
Geobacillus phage GBK2	1458842	S	1	0	1	0.0000232056
Staphylococcus phage StB20	1147043	S	1	0	1	0.0000232056
Salicola phage CGphi29	754067	S	1	0	1	0.0000232056
Listeria phage P35	330398	S	1	0	1	0.0000232056
Flavobacterium phage 11b	294631	S	1	0	1	0.0000232056
Streptococcus virus phiAbc2	633135	S	1	0	1	0.0000232056
Propionibacterium virus PAS50	1982272	S	1	0	1	0.0000232056
Propionibacterium virus Ouroboros	1982259	S	1	0	1	0.0000232056
Propionibacterium virus PHL041M10	1982276	S	1	0	1	0.0000232056
Polaribacter virus P12002L	1982245	S	1	0	1	0.0000232056
Lactococcus virus bIL170	63118	S	1	0	1	0.0000232056
Burkholderia virus KL1	1921548	S	1	0	1	0.0000232056
Sphingobium virus Lacusarx	2560778	S	1	0	1	0.0000232056
Rhodobacter virus RcTitan	1982575	S	1	0	1	0.0000232056
Rhodococcus virus Trina	2560705	S	1	0	1	0.0000232056
Streptomyces virus Darolandstone	2734266	S	1	0	1	0.0000232056
Corynebacterium phage StAB	2591204	S	1	0	1	0.0000232056
Nonlabens virus P12024L	1982247	S	1	0	1	0.0000232056
Salmonella virus Sasha	2734275	S	1	0	1	0.0000232056
Gordonia virus Bowser	2560487	S	1	0	1	0.0000232056
Streptomyces virus Rowa	2734271	S	1	0	1	0.0000232056
Bacteroides phage crAss001	2301731	S	1	0	1	0.0000232056
uncultured crAssphage	1211417	S	1	0	1	0.0000232056
Pseudomonas phage AF	1235689	S	1	0	1	0.0000232056
Serratia phage Parlo	2557554	S	1	0	1	0.0000232056
Dinoroseobacter virus DFL12	2169868	S	1	0	1	0.0000232056
Sulfitobacter phage EE36phi1	490913	S	1	0	1	0.0000232056
Burkholderia virus Bcep22	242527	S	1	0	1	0.0000232056
Achromobacter virus Axp3	2169962	S	1	0	1	0.0000232056
Pseudomonas virus phCDa	2734187	S	1	0	1	0.0000232056
Lactococcus virus KSY1	388452	S	1	0	1	0.0000232056
Synechococcus phage S-CAM7	1883368	S	1	0	1	0.0000232056
Cyanophage P-RSM1	536444	S	1	0	1	0.0000232056
Tenacibaculum phage pT24	1880590	S	1	0	1	0.0000232056
Synechococcus phage S-SSM4	536466	S	1	0	1	0.0000232056
Escherichia phage vB_EcoM_PHB05	2041347	S	1	0	1	0.0000232056
Synechococcus phage S-CRM01	1026955	S	1	0	1	0.0000232056
Synechococcus phage syn9	382359	S	1	0	1	0.0000232056
Mycobacterium phage Myrna	546805	S	1	0	1	0.0000232056
Yersinia phage phiR1-37	331278	S	1	0	1	0.0000232056
Aeromonas phage 4_L372XY	2588520	S	1	0	1	0.0000232056
Acinetobacter phage Acj61	760732	S	1	0	1	0.0000232056
Citrobacter virus Merlin	1985341	S	1	0	1	0.0000232056
Aeromonas virus Aeh1	227470	S	1	0	1	0.0000232056
Acinetobacter virus Aci05	2734137	S	1	0	1	0.0000232056
Acinetobacter phage vB_AbaM_Acibel004	1481186	S	1	0	1	0.0000232056
Cyanophage P-RSM6	929832	S	1	0	1	0.0000232056
Synechococcus phage S-WAM1	1815521	S	1	0	1	0.0000232056
Synechococcus virus ST4	2734145	S	1	0	1	0.0000232056
Flavobacterium virus FCV1	2560474	S	1	0	1	0.0000232056
Yersinia virus Yen9-04	2560849	S	1	0	1	0.0000232056
Synechococcus phage S-CAM8	754038	S	1	0	1	0.0000232056
Synechococcus virus SSM1	2734149	S	1	0	1	0.0000232056
Aeromonas virus 56	2560283	S	1	0	1	0.0000232056
Pseudomonas phage PA11	347327	S	1	0	1	0.0000232056
Ralstonia virus RSJ2	2733594	S	1	0	1	0.0000232056
Bacillus virus NIT1	1921018	S	1	0	1	0.0000232056
Klebsiella virus KpS110	2731623	S	1	0	1	0.0000232056
Human betaherpesvirus 5	10359	S	1	0	1	0.0000232056
Human betaherpesvirus 6B	32604	S	1	0	1	0.0000232056
Alcelaphine gammaherpesvirus 1	35252	S	1	0	1	0.0000232056
Felid gammaherpesvirus 1	2560468	S	1	0	1	0.0000232056
Ostreid herpesvirus 1	261939	S	1	0	1	0.0000232056
Acanthocystis turfacea chlorella virus 1	322019	S	1	0	1	0.0000232056
Chrysochromulina ericina virus	455364	S	1	0	1	0.0000232056
Orf virus	10258	S	1	0	1	0.0000232056
Raccoonpox virus	10256	S	1	0	1	0.0000232056
Squirrelpox virus	240426	S	1	0	1	0.0000232056
Swinepox virus	10276	S	1	0	1	0.0000232056
Amsacta moorei entomopoxvirus	28321	S	1	0	1	0.0000232056
Anomala cuprea entomopoxvirus	62099	S	1	0	1	0.0000232056
Yellowstone Lake virophage 7	1557035	S	1	0	1	0.0000232056
Fowl aviadenovirus E	190065	S	1	0	1	0.0000232056
Beihai picorna-like virus 49	1922593	S	1	0	1	0.0000232056
Changjiang crawfish virus 6	1922770	S	1	0	1	0.0000232056
Grapevine leafroll-associated virus 13	1815581	S	1	0	1	0.0000232056
Pepper vein yellows virus	909827	S	1	0	1	0.0000232056
Sectovirus 1	2508252	S	1	0	1	0.0000232056
Macrobrachium rosenbergii Taihu virus	1027947	S	1	0	1	0.0000232056
Torque teno virus 5	687344	S	1	0	1	0.0000232056
Pandoravirus neocaledonia	2107708	S	1	0	1	0.0000232056
Halovirus HCTV-2	1273747	S	1	0	1	0.0000232056
Halovirus HGTV-1	1273749	S	1	0	1	0.0000232056
White spot syndrome virus	342409	S	1	0	1	0.0000232056
Candidatus Kinetoplastibacterium crithidii	33056	S	1	-1	0	0.0000000000
Candidatus Kinetoplastibacterium blastocrithidii	233181	S	1	-1	0	0.0000000000
Azotobacter vinelandii	354	S	1	-1	0	0.0000000000
Candidatus Moranella endobia	1048758	S	1	-1	0	0.0000000000
Fluoribacter dumoffii	463	S	1	-1	0	0.0000000000
Afipia carboxidovorans	40137	S	3	-3	0	0.0000000000
Rhodospirillum rubrum	1085	S	3	-3	0	0.0000000000
Rickettsia canadensis	788	S	1	-1	0	0.0000000000
Rickettsia massiliae	35791	S	1	-1	0	0.0000000000
Ehrlichia chaffeensis	945	S	1	-1	0	0.0000000000
Mycolicibacterium gilvum	1804	S	3	-3	0	0.0000000000
Paenibacillus mucilaginosus	61624	S	1	-1	0	0.0000000000
Roseburia intestinalis	166486	S	1	-1	0	0.0000000000
Desulfitobacterium hafniense	49338	S	4	-4	0	0.0000000000
Mycoplasma genitalium	2097	S	2	-2	0	0.0000000000
Chloroflexus aurantiacus	1108	S	2	-2	0	0.0000000000
Tannerella forsythia	28112	S	1	-1	0	0.0000000000
Leptospira biflexa	172	S	2	-2	0	0.0000000000
Archaeoglobus fulgidus	2234	S	3	-3	0	0.0000000000
