name	taxonomy_id	taxonomy_lvl	kraken_assigned_reads	added_reads	new_est_reads	fraction_total_reads
Homo sapiens	9606	S	122468172	21305	122489477	0.99981
Acidovorax sp. KKS102	358220	S	205	60	265	0.00000
Acidovorax sp. JMULE5	2518343	S	143	16	159	0.00000
Acidovorax sp. RAC01	1842533	S	49	14	63	0.00000
Acidovorax sp. 1608163	2478662	S	48	4	52	0.00000
Acidovorax sp. T1	1858609	S	44	74	118	0.00000
Acidovorax sp. HDW3	2714923	S	10	1	11	0.00000
Acidovorax sp. JS42	232721	S	3	37	40	0.00000
Acidovorax carolinensis	553814	S	44	20	64	0.00000
Acidovorax avenae	80867	S	32	12	44	0.00000
Acidovorax antarcticus	2743470	S	20	5	25	0.00000
Acidovorax monticola	1926868	S	12	1	13	0.00000
Acidovorax cattleyae	80868	S	2	0	2	0.00000
Acidovorax citrulli	80869	S	2	1	3	0.00000
Acidovorax ebreus	721785	S	2	13	15	0.00000
Variovorax sp. PAMC 28711	1795631	S	53	3	56	0.00000
Variovorax sp. PAMC26660	2762322	S	51	5	56	0.00000
Variovorax sp. WDL1	207745	S	29	20	49	0.00000
Variovorax sp. 38R	2774875	S	29	18	47	0.00000
Variovorax sp. PBS-H4	434008	S	20	6	26	0.00000
Variovorax sp. HW608	1034889	S	20	1	21	0.00000
Variovorax sp. PAMC28562	2762323	S	16	0	16	0.00000
Variovorax sp. RKNM96	2681552	S	16	3	19	0.00000
Variovorax sp. PBL-E5	434014	S	12	21	33	0.00000
Variovorax sp. RA8	662548	S	11	5	16	0.00000
Variovorax sp. PBL-H6	434009	S	7	5	12	0.00000
Variovorax sp. SRS16	282217	S	3	4	7	0.00000
Variovorax sp. PMC12	2126319	S	2	62	64	0.00000
Variovorax sp. PDNC026	2811425	S	1	23	24	0.00000
Variovorax paradoxus	34073	S	130	28	158	0.00000
Variovorax boronicumulans	436515	S	89	41	130	0.00000
Diaphorobacter sp. HDW4A	2714924	S	127	61	188	0.00000
Diaphorobacter sp. HDW4B	2714925	S	13	0	13	0.00000
Diaphorobacter sp. JS3051	2792224	S	3	38	41	0.00000
Diaphorobacter sp. JS3050	2735554	S	2	25	27	0.00000
Diaphorobacter aerolatus	1288495	S	19	14	33	0.00000
Diaphorobacter ruginosibacter	1715720	S	10	0	10	0.00000
Diaphorobacter polyhydroxybutyrativorans	1546149	S	2	9	11	0.00000
Rhodoferax sp. BAB1	2741720	S	25	3	28	0.00000
Rhodoferax sp. AJA081-3	2752316	S	21	1	22	0.00000
Rhodoferax sp. PAMC29310	2822760	S	13	1	14	0.00000
Rhodoferax koreense	1842727	S	41	16	57	0.00000
Rhodoferax sediminis	2509614	S	23	1	24	0.00000
Rhodoferax saidenbachensis	1484693	S	22	2	24	0.00000
Rhodoferax antarcticus	81479	S	12	0	12	0.00000
Rhodoferax ferrireducens	192843	S	10	0	10	0.00000
Hydrogenophaga sp. BPS33	2651974	S	24	8	32	0.00000
Hydrogenophaga sp. PBL-H3	434010	S	18	9	27	0.00000
Hydrogenophaga sp. RAC07	1842537	S	18	2	20	0.00000
Hydrogenophaga sp. BA0156	2716225	S	15	4	19	0.00000
Hydrogenophaga sp. NH-16	2184519	S	14	16	30	0.00000
Hydrogenophaga sp. YM1	2806262	S	14	2	16	0.00000
Hydrogenophaga sp. PBC	795665	S	12	4	16	0.00000
Hydrogenophaga sp. PAMC20947	2565558	S	7	0	7	0.00000
Hydrogenophaga pseudoflava	47421	S	14	12	26	0.00000
Hydrogenophaga crassostreae	1763535	S	7	0	7	0.00000
Comamonas testosteroni	285	S	33	24	57	0.00000
Comamonas kerstersii	225992	S	20	3	23	0.00000
Comamonas aquatica	225991	S	19	3	22	0.00000
Comamonas thiooxydans	363952	S	18	13	31	0.00000
Comamonas koreensis	160825	S	13	1	14	0.00000
Comamonas sp. NLF-7-7	2597701	S	11	2	13	0.00000
Comamonas piscis	1562974	S	9	0	9	0.00000
Comamonas serinivorans	1082851	S	5	0	5	0.00000
Delftia acidovorans	80866	S	23	33	56	0.00000
Delftia sp. Cs1-4	742013	S	6	13	19	0.00000
Delftia sp. KV29	1170710	S	2	152	154	0.00000
Delftia tsuruhatensis	180282	S	6	19	25	0.00000
Delftia lacustris	558537	S	5	21	26	0.00000
Polaromonas sp. JS666	296591	S	22	17	39	0.00000
Polaromonas sp. W10N	1840301	S	2	0	2	0.00000
Polaromonas naphthalenivorans	216465	S	28	2	30	0.00000
Polaromonas vacuolata	37448	S	9	1	10	0.00000
Kinneretia sp. DAIF2	2714952	S	67	9	76	0.00000
Ottowia oryzae	2109914	S	34	2	36	0.00000
Ottowia sp. 27C	2816950	S	16	0	16	0.00000
Ottowia sp. oral taxon 894	1658672	S	8	0	8	0.00000
Limnohabitans sp. 63ED37-2	1678128	S	44	2	46	0.00000
Limnohabitans sp. 103DPR2	1678129	S	7	0	7	0.00000
Curvibacter sp. AEP1-3	1844971	S	33	0	33	0.00000
Alicycliphilus denitrificans	179636	S	28	24	52	0.00000
Ramlibacter tataouinensis	94132	S	23	2	25	0.00000
Schlegelella thermodepolymerans	215580	S	17	2	19	0.00000
Verminephrobacter eiseniae	364317	S	13	0	13	0.00000
Melaminivora sp. SC2-9	2109913	S	12	3	15	0.00000
Serpentinomonas raichei	1458425	S	2	1	3	0.00000
Serpentinomonas mccroryi	1458426	S	2	1	3	0.00000
Hylemonella gracilis	80880	S	6	0	6	0.00000
Simplicispira suum	2109915	S	4	0	4	0.00000
Candidatus Symbiobacter mobilis	1436290	S	2	0	2	0.00000
Pulveribacter suum	2116657	S	2	0	2	0.00000
Ralstonia solanacearum	305	S	241	49	290	0.00000
Ralstonia pickettii	329	S	7	1	8	0.00000
Ralstonia insidiosa	190721	S	7	1	8	0.00000
Ralstonia mannitolilytica	105219	S	3	1	4	0.00000
Burkholderia ubonensis	101571	S	10	9	19	0.00000
Burkholderia contaminans	488447	S	7	2	9	0.00000
Burkholderia cenocepacia	95486	S	7	8	15	0.00000
Burkholderia cepacia	292	S	7	4	11	0.00000
Burkholderia pyrrocinia	60550	S	3	1	4	0.00000
Burkholderia vietnamiensis	60552	S	3	10	13	0.00000
Burkholderia anthina	179879	S	2	1	3	0.00000
Burkholderia latens	488446	S	2	3	5	0.00000
Burkholderia stabilis	95485	S	2	1	3	0.00000
Burkholderia multivorans	87883	S	2	0	2	0.00000
Burkholderia metallica	488729	S	1	0	1	0.00000
Burkholderia seminalis	488731	S	1	0	1	0.00000
Burkholderia diffusa	488732	S	1	0	1	0.00000
Burkholderia stagnalis	1503054	S	1	0	1	0.00000
Burkholderia pseudomallei	28450	S	14	19	33	0.00000
Burkholderia thailandensis	57975	S	7	1	8	0.00000
Burkholderia sp. BDU8	1385592	S	2	0	2	0.00000
Burkholderia sp. MSMB617WGS	1637831	S	2	2	4	0.00000
Burkholderia sp. BDU6	1385591	S	1	0	1	0.00000
Burkholderia sp. MSMB0852	1637841	S	1	0	1	0.00000
Burkholderia sp. PAMC 26561	1795043	S	3	3	6	0.00000
Burkholderia sp. MS389	2811789	S	2	1	3	0.00000
Burkholderia sp. KK1	1855726	S	2	3	5	0.00000
Burkholderia sp. IDO3	1705310	S	1	1	2	0.00000
Burkholderia sp. DHOD12	2571746	S	1	0	1	0.00000
Burkholderia sp. JP2-270	2217913	S	1	0	1	0.00000
Burkholderia sp. PAMC 28687	1795874	S	1	1	2	0.00000
Burkholderia sp. Bp7605	1740163	S	1	0	1	0.00000
Burkholderia sp. NRF60-BP8	1637853	S	1	0	1	0.00000
Burkholderia sp. CCGE1003	640512	S	1	0	1	0.00000
Burkholderia gladioli	28095	S	9	0	9	0.00000
Burkholderia plantarii	41899	S	6	0	6	0.00000
Burkholderia glumae	337	S	3	0	3	0.00000
Cupriavidus taiwanensis	164546	S	28	6	34	0.00000
Cupriavidus necator	106590	S	16	2	18	0.00000
Cupriavidus basilensis	68895	S	10	3	13	0.00000
Cupriavidus nantongensis	1796606	S	10	9	19	0.00000
Cupriavidus pinatubonensis	248026	S	7	2	9	0.00000
Cupriavidus metallidurans	119219	S	6	2	8	0.00000
Cupriavidus oxalaticus	96344	S	5	1	6	0.00000
Cupriavidus pauculus	82633	S	4	0	4	0.00000
Cupriavidus malaysiensis	367825	S	2	5	7	0.00000
Cupriavidus gilardii	82541	S	1	1	2	0.00000
Cupriavidus campinensis	151783	S	1	0	1	0.00000
Paraburkholderia sp. Msb3	2604047	S	5	2	7	0.00000
Paraburkholderia sp. SOS3	1926494	S	3	0	3	0.00000
Paraburkholderia sp. PGU16	2735433	S	2	0	2	0.00000
Paraburkholderia sp. PGU19	2735434	S	2	0	2	0.00000
Paraburkholderia sp. 7MH5	2547399	S	1	0	1	0.00000
Paraburkholderia aromaticivorans	2026199	S	6	1	7	0.00000
Paraburkholderia phymatum	148447	S	5	0	5	0.00000
Paraburkholderia acidisoli	2571748	S	4	0	4	0.00000
Paraburkholderia fungorum	134537	S	4	0	4	0.00000
Paraburkholderia acidophila	265293	S	3	2	5	0.00000
Paraburkholderia atlantica	2654982	S	3	0	3	0.00000
Paraburkholderia acidiphila	2571747	S	3	0	3	0.00000
Paraburkholderia xenovorans	36873	S	3	1	4	0.00000
Paraburkholderia phytofirmans	261302	S	3	1	4	0.00000
Paraburkholderia phenoliruptrix	252970	S	3	0	3	0.00000
Paraburkholderia tropica	92647	S	3	0	3	0.00000
Paraburkholderia caribensis	75105	S	3	0	3	0.00000
Paraburkholderia hospita	169430	S	2	1	3	0.00000
Paraburkholderia terrae	311230	S	2	1	3	0.00000
Paraburkholderia megapolitana	420953	S	2	0	2	0.00000
Paraburkholderia sprentiae	948107	S	2	0	2	0.00000
Paraburkholderia terricola	169427	S	2	0	2	0.00000
Paraburkholderia dokdonella	2211211	S	2	0	2	0.00000
Paraburkholderia graminis	60548	S	2	0	2	0.00000
Paraburkholderia caledonica	134536	S	1	0	1	0.00000
Polynucleobacter difficilis	556054	S	43	1	44	0.00000
Polynucleobacter necessarius	576610	S	9	0	9	0.00000
Polynucleobacter sp. LimPoW16	1743162	S	4	0	4	0.00000
Polynucleobacter sp. MWH-UH21B	1743174	S	1	0	1	0.00000
Polynucleobacter asymbioticus	576611	S	4	0	4	0.00000
Polynucleobacter duraquae	1835254	S	4	0	4	0.00000
Pandoraea pnomenusa	93220	S	10	4	14	0.00000
Pandoraea apista	93218	S	4	2	6	0.00000
Pandoraea sp. XY-2	2518599	S	4	1	5	0.00000
Pandoraea thiooxydans	445709	S	3	0	3	0.00000
Pandoraea pulmonicola	93221	S	2	0	2	0.00000
Pandoraea vervacti	656178	S	2	1	3	0.00000
Pandoraea faecigallinarum	656179	S	2	0	2	0.00000
Pandoraea norimbergensis	93219	S	1	0	1	0.00000
Pandoraea sputorum	93222	S	1	0	1	0.00000
Caballeronia sp. M1242	2814653	S	3	2	5	0.00000
Caballeronia insecticola	758793	S	2	0	2	0.00000
Lautropia mirabilis	47671	S	3	0	3	0.00000
Chitinimonas arctica	2594795	S	3	0	3	0.00000
Ephemeroptericola cinctiostellae	2268024	S	3	0	3	0.00000
Limnobacter sp. SAORIC-580	2732163	S	2	0	2	0.00000
Janthinobacterium sp. HH102	1537274	S	31	37	68	0.00000
Janthinobacterium sp. LM6	1938606	S	23	6	29	0.00000
Janthinobacterium sp. 1_2014MBL_MicDiv	1644131	S	20	3	23	0.00000
Janthinobacterium sp. PLB02	2808899	S	6	7	13	0.00000
Janthinobacterium sp. 17J80-10	2497863	S	2	0	2	0.00000
Janthinobacterium sp. Marseille	375286	S	1	0	1	0.00000
Janthinobacterium agaricidamnosum	55508	S	17	17	34	0.00000
Janthinobacterium svalbardensis	368607	S	15	4	19	0.00000
Janthinobacterium lividum	29581	S	13	10	23	0.00000
Janthinobacterium tructae	2590869	S	13	3	16	0.00000
Massilia sp. WG5	1707785	S	7	2	9	0.00000
Massilia sp. NR 4-1	1678028	S	5	0	5	0.00000
Massilia sp. CCM 8941	2765360	S	5	1	6	0.00000
Massilia sp. YMA4	1593482	S	3	1	4	0.00000
Massilia sp. LPB0304	2769491	S	2	1	3	0.00000
Massilia violaceinigra	2045208	S	8	1	9	0.00000
Massilia albidiflava	321983	S	6	1	7	0.00000
Massilia oculi	945844	S	6	0	6	0.00000
Massilia putida	1141883	S	6	1	7	0.00000
Massilia plicata	321984	S	4	0	4	0.00000
Massilia umbonata	864828	S	4	0	4	0.00000
Massilia lutea	321985	S	3	0	3	0.00000
Massilia flava	871742	S	3	0	3	0.00000
Massilia armeniaca	2072590	S	2	0	2	0.00000
Herbaspirillum seropedicae	964	S	6	1	7	0.00000
Herbaspirillum frisingense	92645	S	6	1	7	0.00000
Herbaspirillum hiltneri	341045	S	6	0	6	0.00000
Herbaspirillum huttiense	863372	S	5	1	6	0.00000
Herbaspirillum robiniae	2014887	S	5	0	5	0.00000
Herbaspirillum rubrisubalbicans	80842	S	4	1	5	0.00000
Herbaspirillum sp. meg3	2025949	S	2	0	2	0.00000
Collimonas arenae	279058	S	13	1	14	0.00000
Collimonas fungivorans	158899	S	8	1	9	0.00000
Collimonas pratensis	279113	S	7	1	8	0.00000
Undibacterium sp. YM2	2058625	S	9	3	12	0.00000
Undibacterium sp. KW1	2058624	S	7	2	9	0.00000
Undibacterium parvum	401471	S	2	0	2	0.00000
Duganella sp. GN2-R2	2728020	S	12	1	13	0.00000
Duganella sp. AF9R3	2728021	S	5	0	5	0.00000
Noviherbaspirillum sp. UKPF54	2601898	S	7	0	7	0.00000
Herminiimonas arsenitoxidans	1809410	S	2	0	2	0.00000
Glaciimonas sp. PAMC28666	2807626	S	1	0	1	0.00000
Rhizobacter gummiphilus	946333	S	39	6	45	0.00000
Rhizobacter sp. AJA081-3	2753607	S	34	7	41	0.00000
Paucibacter sp. KCTC 42545	1768242	S	41	5	46	0.00000
Methylibium sp. Pch-M	2082386	S	11	10	21	0.00000
Methylibium sp. T29	1430884	S	1	4	5	0.00000
Methylibium petroleiphilum	105560	S	10	8	18	0.00000
Roseateles depolymerans	76731	S	33	4	37	0.00000
Aquabacterium olei	1296669	S	30	5	35	0.00000
Rubrivivax gelatinosus	28068	S	26	5	31	0.00000
Sphaerotilus natans	34103	S	24	5	29	0.00000
Mitsuaria sp. 7	1658665	S	24	3	27	0.00000
Leptothrix cholodnii	34029	S	20	4	24	0.00000
Inhella inkyongensis	392593	S	15	1	16	0.00000
Thiomonas sp. X19	1050370	S	3	0	3	0.00000
Thiomonas intermedia	926	S	2	0	2	0.00000
Thiomonas arsenitoxydans	426114	S	1	4	5	0.00000
Xylophilus rhododendri	2697032	S	9	1	10	0.00000
Achromobacter xylosoxidans	85698	S	21	19	40	0.00000
Achromobacter sp. AONIH1	1758194	S	8	3	11	0.00000
Achromobacter sp. B7	2282475	S	6	0	6	0.00000
Achromobacter sp. MFA1 R4	1881016	S	4	0	4	0.00000
Achromobacter spanius	217203	S	4	0	4	0.00000
Achromobacter insolitus	217204	S	4	0	4	0.00000
Achromobacter denitrificans	32002	S	2	1	3	0.00000
Achromobacter deleyi	1353891	S	2	2	4	0.00000
Achromobacter pestifer	1353889	S	1	0	1	0.00000
Bordetella hinzii	103855	S	7	1	8	0.00000
Bordetella avium	521	S	5	0	5	0.00000
Bordetella genomosp. 9	1416803	S	5	0	5	0.00000
Bordetella bronchialis	463025	S	4	0	4	0.00000
Bordetella bronchiseptica	518	S	3	4	7	0.00000
Bordetella parapertussis	519	S	3	9	12	0.00000
Bordetella petrii	94624	S	3	1	4	0.00000
Bordetella trematum	123899	S	3	0	3	0.00000
Bordetella genomosp. 13	463040	S	3	0	3	0.00000
Bordetella pseudohinzii	1331258	S	3	0	3	0.00000
Bordetella genomosp. 8	1416806	S	3	0	3	0.00000
Bordetella pertussis	520	S	1	2	3	0.00000
Bordetella holmesii	35814	S	1	0	1	0.00000
Bordetella sp. N	1746199	S	1	0	1	0.00000
Alcaligenes faecalis	511	S	5	1	6	0.00000
Alcaligenes aquatilis	323284	S	1	1	2	0.00000
Orrella dioscoreae	1851544	S	8	1	9	0.00000
Pigmentiphaga aceris	1940612	S	3	0	3	0.00000
Pigmentiphaga sp. H8	2488560	S	2	0	2	0.00000
Castellaniella defragrans	75697	S	4	0	4	0.00000
Pusillimonas sp. T7-7	1007105	S	2	0	2	0.00000
Pusillimonas thiosulfatoxidans	2028345	S	1	0	1	0.00000
Oligella urethralis	90245	S	2	0	2	0.00000
Kerstersia gyiorum	206506	S	2	0	2	0.00000
Advenella mimigardefordensis	302406	S	1	0	1	0.00000
Advenella kashmirensis	310575	S	1	0	1	0.00000
Sutterella wadsworthensis	40545	S	1	0	1	0.00000
Sutterella megalosphaeroides	2494234	S	1	0	1	0.00000
Turicimonas muris	1796652	S	1	0	1	0.00000
Azoarcus sp. M9-3-2	2016596	S	7	0	7	0.00000
Azoarcus sp. CIB	198107	S	5	2	7	0.00000
Azoarcus sp. DD4	2027405	S	5	1	6	0.00000
Azoarcus sp. KH32C	748247	S	3	0	3	0.00000
Azoarcus sp. DN11	356837	S	1	0	1	0.00000
Azoarcus pumilus	2067960	S	10	0	10	0.00000
Azoarcus communis	41977	S	2	0	2	0.00000
Azoarcus olearius	418699	S	2	0	2	0.00000
Thauera sp. K11	2005884	S	5	1	6	0.00000
Thauera sp. MZ1T	85643	S	1	0	1	0.00000
Thauera humireducens	1134435	S	5	0	5	0.00000
Thauera hydrothermalis	2184083	S	4	0	4	0.00000
Thauera chlorobenzoica	96773	S	3	1	4	0.00000
Thauera aromatica	59405	S	2	1	3	0.00000
Azospira restricta	404405	S	5	0	5	0.00000
Azospira oryzae	146939	S	2	5	7	0.00000
Azospira sp. I09	1765049	S	1	2	3	0.00000
Oryzomicrobium terrae	1735038	S	13	0	13	0.00000
Aromatoleum petrolei	76116	S	4	0	4	0.00000
Aromatoleum aromaticum	551760	S	4	1	5	0.00000
Aromatoleum bremense	76115	S	1	0	1	0.00000
Rugosibacter aromaticivorans	1565605	S	9	0	9	0.00000
Niveibacterium sp. HC41	2811415	S	4	0	4	0.00000
Dechloromonas sp. TW-R-39-2	2654218	S	5	0	5	0.00000
Dechloromonas sp. HYN0024	2231055	S	4	0	4	0.00000
Dechloromonas aromatica	259537	S	3	0	3	0.00000
Fluviibacter phosphoraccumulans	1751046	S	1	0	1	0.00000
Chromobacterium vaccinii	1108595	S	5	0	5	0.00000
Chromobacterium violaceum	536	S	4	1	5	0.00000
Chromobacterium phragmitis	2202141	S	3	0	3	0.00000
Chromobacterium haemolyticum	394935	S	2	2	4	0.00000
Chromobacterium paludis	2605945	S	2	0	2	0.00000
Chromobacterium sp. ATCC 53434	2059672	S	1	0	1	0.00000
Chromobacterium sp. Rain0013	2292447	S	1	0	1	0.00000
Chromobacterium rhizoryzae	1778675	S	1	0	1	0.00000
Iodobacter fluviatilis	537	S	1	0	1	0.00000
Iodobacter sp. H11R3	2496266	S	1	0	1	0.00000
Vogesella sp. LIG4	1192162	S	5	0	5	0.00000
Deefgea sp. D17	2739061	S	4	0	4	0.00000
Pseudogulbenkiania sp. NH8B	748280	S	4	0	4	0.00000
Aquaspirillum sp. LM1	1938604	S	3	0	3	0.00000
Chitinibacter sp. 2T18	2739434	S	2	0	2	0.00000
Chitinibacter fontanus	1737446	S	1	0	1	0.00000
Aquitalea magnusonii	332411	S	1	0	1	0.00000
Aquitalea aquatilis	1537400	S	1	0	1	0.00000
Jeongeupia sp. USM3	1906741	S	3	0	3	0.00000
Laribacter hongkongensis	168471	S	2	0	2	0.00000
Microvirgula aerodenitrificans	57480	S	1	0	1	0.00000
Neisseria sp. oral taxon 014	641148	S	2	0	2	0.00000
Neisseria sp. KEM232	655307	S	1	0	1	0.00000
Neisseria sp. 10022	1853276	S	1	0	1	0.00000
Neisseria sicca	490	S	3	0	3	0.00000
Neisseria shayeganii	607712	S	3	0	3	0.00000
Neisseria zoodegmatis	326523	S	3	0	3	0.00000
Neisseria mucosa	488	S	2	0	2	0.00000
Neisseria meningitidis	487	S	1	0	1	0.00000
Neisseria musculi	1815583	S	1	0	1	0.00000
Neisseria animaloris	326522	S	1	0	1	0.00000
Vitreoscilla filiformis	63	S	7	0	7	0.00000
Vitreoscilla sp. C1	96942	S	1	0	1	0.00000
Kingella oralis	505	S	4	0	4	0.00000
Kingella denitrificans	502	S	1	0	1	0.00000
Crenobacter cavernae	2290923	S	2	0	2	0.00000
Eikenella corrodens	539	S	1	0	1	0.00000
Alysiella filiformis	194196	S	1	0	1	0.00000
Snodgrassella alvi	1196083	S	1	0	1	0.00000
Denitratisoma sp. DHT3	1981880	S	7	2	9	0.00000
Denitratisoma oestradiolicum	311182	S	2	0	2	0.00000
Sulfuritalea hydrogenivorans	748811	S	6	0	6	0.00000
Methyloversatilis sp. RAC08	1842540	S	4	0	4	0.00000
Sterolibacterium denitrificans	157592	S	2	0	2	0.00000
Methylophilus medardicus	2588534	S	5	0	5	0.00000
Methylophilus sp. TWE2	1662285	S	3	0	3	0.00000
Methylotenera mobilis	359408	S	4	0	4	0.00000
Methylotenera versatilis	1055487	S	1	0	1	0.00000
Candidatus Methylopumilus turicensis	1581680	S	2	0	2	0.00000
Candidatus Methylopumilus rimovensis	2588535	S	1	0	1	0.00000
Methylobacillus flagellatus	405	S	1	0	1	0.00000
Sideroxydans lithotrophicus	63745	S	5	0	5	0.00000
Candidatus Nitrotoga sp. AM1P	2559597	S	4	0	4	0.00000
Ferriphaselus amnicola	1188319	S	3	0	3	0.00000
Nitrosomonas sp. Is79A3	261292	S	6	0	6	0.00000
Nitrosomonas communis	44574	S	3	0	3	0.00000
Nitrosomonas ureae	44577	S	2	0	2	0.00000
Usitatibacter palustris	2732487	S	8	0	8	0.00000
Usitatibacter rugosus	2732067	S	3	0	3	0.00000
Sulfuriferula plumbiphila	171865	S	3	0	3	0.00000
Sulfuriferula nivalis	2675298	S	1	0	1	0.00000
Sulfuricella denitrificans	649841	S	3	0	3	0.00000
Sulfurimicrobium lacus	2715678	S	3	0	3	0.00000
Sulfuritortus calidifontis	1914471	S	3	0	3	0.00000
Thiobacillus denitrificans	36861	S	2	0	2	0.00000
Casimicrobium huifangae	2591109	S	5	0	5	0.00000
Candidatus Kinetoplastibacterium galatii	994695	S	1	0	1	0.00000
Candidatus Kinetoplastibacterium sorsogonicusi	1576550	S	1	0	1	0.00000
Candidatus Accumulibacter phosphatis	327160	S	2	0	2	0.00000
Candidatus Profftella armatura (Diaphorina cf. continua)	2661583	S	2	0	2	0.00000
Pseudomonas sp. CMR12a	658629	S	247	37	284	0.00000
Pseudomonas sp. TCU-HL1	1856685	S	5	0	5	0.00000
Pseudomonas sp. DY-1	1755504	S	5	0	5	0.00000
Pseudomonas sp. S1-A32-2	2731681	S	5	0	5	0.00000
Pseudomonas sp. URMO17WK12:I11	1283291	S	3	1	4	0.00000
Pseudomonas sp. DTU12.3	2073078	S	3	0	3	0.00000
Pseudomonas sp. C27(2019)	2604941	S	3	0	3	0.00000
Pseudomonas sp. BIGb0427	2724470	S	3	0	3	0.00000
Pseudomonas sp. 15A4	2804761	S	3	0	3	0.00000
Pseudomonas sp. J380	2605424	S	2	0	2	0.00000
Pseudomonas sp. DG56-2	2320270	S	2	0	2	0.00000
Pseudomonas sp. K2W31S-8	2320867	S	2	0	2	0.00000
Pseudomonas sp. CC6-YY-74	1930532	S	2	0	2	0.00000
Pseudomonas sp. StFLB209	1028989	S	2	0	2	0.00000
Pseudomonas sp. LPH1	1898684	S	2	1	3	0.00000
Pseudomonas sp. ATCC 13867	1294143	S	2	0	2	0.00000
Pseudomonas sp. PDNC002	2811422	S	2	0	2	0.00000
Pseudomonas sp. UW4	1207075	S	2	0	2	0.00000
Pseudomonas sp. ADPe	2774873	S	2	2	4	0.00000
Pseudomonas sp. ABC1	2748080	S	2	0	2	0.00000
Pseudomonas sp. MRSN12121	1611770	S	2	1	3	0.00000
Pseudomonas sp. MSPm1	2726956	S	2	0	2	0.00000
Pseudomonas sp. SK	2729423	S	2	0	2	0.00000
Pseudomonas sp. LTJR-52	2479392	S	1	0	1	0.00000
Pseudomonas sp. S49	1573720	S	1	0	1	0.00000
Pseudomonas sp. NS1(2017)	2025658	S	1	0	1	0.00000
Pseudomonas sp. S-6-2	1931241	S	1	0	1	0.00000
Pseudomonas sp. 7SR1	1881017	S	1	0	1	0.00000
Pseudomonas sp. BIOMIG1BAC	1758730	S	1	0	1	0.00000
Pseudomonas sp. PONIH3	1636610	S	1	1	2	0.00000
Pseudomonas sp. SWI6	2083051	S	1	0	1	0.00000
Pseudomonas sp. LBUM920	2126069	S	1	0	1	0.00000
Pseudomonas sp. 31-12	2201356	S	1	0	1	0.00000
Pseudomonas sp. LG1E9	2219057	S	1	0	1	0.00000
Pseudomonas sp. HLS-6	2049589	S	1	0	1	0.00000
Pseudomonas sp. MPC6	2498848	S	1	0	1	0.00000
Pseudomonas sp. SWI7	2587597	S	1	3	4	0.00000
Pseudomonas sp. THAF7b	2587845	S	1	0	1	0.00000
Pseudomonas sp. LPB0260	2614442	S	1	0	1	0.00000
Pseudomonas sp. OIL-1	2706126	S	1	0	1	0.00000
Pseudomonas sp. TUM18999	2725477	S	1	0	1	0.00000
Pseudomonas sp. gcc21	2726989	S	1	0	1	0.00000
Pseudomonas sp. B11D7D	2735906	S	1	0	1	0.00000
Pseudomonas sp. Tri1	2823875	S	1	0	1	0.00000
Pseudomonas sp. phDV1	253237	S	1	1	2	0.00000
Pseudomonas sp. JY-Q	1338689	S	1	5	6	0.00000
Pseudomonas sp. CMR5c	658630	S	1	0	1	0.00000
Pseudomonas sp. R32	1573704	S	1	0	1	0.00000
Pseudomonas sp. R5-89-07	658644	S	1	0	1	0.00000
Pseudomonas sp. FGI182	1259844	S	1	0	1	0.00000
Pseudomonas sp. LAB-08	143813	S	1	0	1	0.00000
Pseudomonas sp. Os17	1500686	S	1	0	1	0.00000
Pseudomonas aeruginosa	287	S	40	89	129	0.00000
Pseudomonas alcaligenes	43263	S	13	2	15	0.00000
Pseudomonas citronellolis	53408	S	9	4	13	0.00000
Pseudomonas mendocina	300	S	6	0	6	0.00000
Pseudomonas nitroreducens	46680	S	2	1	3	0.00000
Pseudomonas multiresinivorans	95301	S	1	0	1	0.00000
Pseudomonas furukawaii	1149133	S	3	0	3	0.00000
Pseudomonas oleovorans	301	S	2	2	4	0.00000
Pseudomonas resinovorans	53412	S	2	0	2	0.00000
Pseudomonas fluorescens	294	S	45	16	61	0.00000
Pseudomonas tolaasii	29442	S	5	0	5	0.00000
Pseudomonas protegens	380021	S	5	0	5	0.00000
Pseudomonas poae	200451	S	4	1	5	0.00000
Pseudomonas synxantha	47883	S	4	1	5	0.00000
Pseudomonas veronii	76761	S	3	4	7	0.00000
Pseudomonas orientalis	76758	S	3	0	3	0.00000
Pseudomonas rhodesiae	76760	S	2	0	2	0.00000
Pseudomonas brenneri	129817	S	1	0	1	0.00000
Pseudomonas extremorientalis	169669	S	1	0	1	0.00000
Pseudomonas mediterranea	183795	S	1	0	1	0.00000
Pseudomonas trivialis	200450	S	1	0	1	0.00000
Pseudomonas putida	303	S	26	14	40	0.00000
Pseudomonas oryzihabitans	47885	S	6	0	6	0.00000
Pseudomonas monteilii	76759	S	4	2	6	0.00000
Pseudomonas sp. SGAir0191	2217867	S	3	1	4	0.00000
Pseudomonas fulva	47880	S	1	3	4	0.00000
Pseudomonas mosselii	78327	S	1	0	1	0.00000
Pseudomonas stutzeri	316	S	25	4	29	0.00000
Pseudomonas balearica	74829	S	1	0	1	0.00000
Pseudomonas cichorii	36746	S	6	0	6	0.00000
Pseudomonas syringae	317	S	6	3	9	0.00000
Pseudomonas savastanoi	29438	S	2	2	4	0.00000
Pseudomonas amygdali	47877	S	1	0	1	0.00000
Pseudomonas coronafaciens	53409	S	2	0	2	0.00000
Pseudomonas asturiensis	1190415	S	2	0	2	0.00000
Pseudomonas viridiflava	33069	S	1	0	1	0.00000
Pseudomonas syringae group genomosp. 3	251701	S	1	3	4	0.00000
Pseudomonas chlororaphis	587753	S	12	4	16	0.00000
Pseudomonas fragi	296	S	1	0	1	0.00000
Pseudomonas koreensis	198620	S	6	1	7	0.00000
Pseudomonas guangdongensis	1245526	S	6	0	6	0.00000
Pseudomonas palleroniana	191390	S	5	0	5	0.00000
Pseudomonas psychrophila	122355	S	5	0	5	0.00000
Pseudomonas yamanorum	515393	S	4	0	4	0.00000
Pseudomonas pelagia	553151	S	4	0	4	0.00000
Pseudomonas taetrolens	47884	S	3	0	3	0.00000
Pseudomonas knackmussii	65741	S	3	0	3	0.00000
Pseudomonas psychrotolerans	237610	S	3	0	3	0.00000
Pseudomonas entomophila	312306	S	3	0	3	0.00000
Pseudomonas otitidis	319939	S	3	0	3	0.00000
Pseudomonas sabulinigri	472181	S	3	0	3	0.00000
Pseudomonas versuta	1788301	S	3	0	3	0.00000
Pseudomonas agarici	46677	S	2	0	2	0.00000
Pseudomonas simiae	321846	S	2	0	2	0.00000
Pseudomonas granadensis	1421430	S	2	0	2	0.00000
Pseudomonas denitrificans (nom. rej.)	43306	S	2	0	2	0.00000
Pseudomonas allokribbensis	2774460	S	2	0	2	0.00000
Pseudomonas salegens	1434072	S	1	0	1	0.00000
Pseudomonas oryzae	1392877	S	1	0	1	0.00000
Pseudomonas sihuiensis	1274359	S	1	0	1	0.00000
Pseudomonas saudiphocaensis	1499686	S	1	0	1	0.00000
Pseudomonas cerasi	1583341	S	1	1	2	0.00000
Pseudomonas brassicacearum	930166	S	1	1	2	0.00000
Pseudomonas kribbensis	1628086	S	1	0	1	0.00000
Pseudomonas litoralis	797277	S	1	0	1	0.00000
Pseudomonas glycinae	1785145	S	1	1	2	0.00000
Pseudomonas viciae	2505979	S	1	0	1	0.00000
Pseudomonas eucalypticola	2599595	S	1	0	1	0.00000
Pseudomonas marincola	437900	S	1	0	1	0.00000
Pseudomonas alkylphenolica	237609	S	1	0	1	0.00000
Pseudomonas parafulva	157782	S	1	0	1	0.00000
Pseudomonas alcaliphila	101564	S	1	0	1	0.00000
Pseudomonas umsongensis	198618	S	1	0	1	0.00000
Pseudomonas rhizosphaerae	216142	S	1	0	1	0.00000
Pseudomonas extremaustralis	359110	S	1	0	1	0.00000
Pseudomonas pohangensis	364197	S	1	0	1	0.00000
Pseudomonas reinekei	395598	S	1	0	1	0.00000
Azotobacter chroococcum	353	S	6	1	7	0.00000
Azotobacter vinelandii	354	S	5	-5	0	0.00000
Azotobacter salinestris	69964	S	2	0	2	0.00000
Entomomonas moraniae	2213226	S	1	0	1	0.00000
Entomomonas sp. F2A	2785331	S	1	0	1	0.00000
Oblitimonas alkaliphila	1697053	S	1	0	1	0.00000
Acinetobacter junii	40215	S	288	32	320	0.00000
Acinetobacter baumannii	470	S	29	51	80	0.00000
Acinetobacter pittii	48296	S	7	4	11	0.00000
Acinetobacter calcoaceticus	471	S	6	0	6	0.00000
Acinetobacter seifertii	1530123	S	5	0	5	0.00000
Acinetobacter nosocomialis	106654	S	1	0	1	0.00000
Acinetobacter sp. MYb10	1827285	S	6	0	6	0.00000
Acinetobacter sp. WCHAc010052	2004647	S	3	0	3	0.00000
Acinetobacter sp. WCHA45	2004644	S	3	2	5	0.00000
Acinetobacter sp. TGL-Y2	1407071	S	2	0	2	0.00000
Acinetobacter sp. WCHAc010034	1879049	S	2	0	2	0.00000
Acinetobacter sp. WCHA55	2004646	S	1	0	1	0.00000
Acinetobacter sp. CS-2	2798861	S	1	0	1	0.00000
Acinetobacter sp. 10FS3-1	2563897	S	1	0	1	0.00000
Acinetobacter sp. SWBY1	2079596	S	1	0	1	0.00000
Acinetobacter sp. NCu2D-2	1608473	S	1	0	1	0.00000
Acinetobacter haemolyticus	29430	S	11	1	12	0.00000
Acinetobacter johnsonii	40214	S	11	3	14	0.00000
Acinetobacter venetianus	52133	S	7	0	7	0.00000
Acinetobacter guillouiae	106649	S	6	0	6	0.00000
Acinetobacter ursingii	108980	S	6	1	7	0.00000
Acinetobacter wuhouensis	1879050	S	5	0	5	0.00000
Acinetobacter indicus	756892	S	5	1	6	0.00000
Acinetobacter bereziniae	106648	S	5	0	5	0.00000
Acinetobacter tandoii	202954	S	4	0	4	0.00000
Acinetobacter towneri	202956	S	4	2	6	0.00000
Acinetobacter lwoffii	28090	S	4	2	6	0.00000
Acinetobacter gyllenbergii	134534	S	2	0	2	0.00000
Acinetobacter piscicola	2006115	S	2	0	2	0.00000
Acinetobacter dispersus	70348	S	2	0	2	0.00000
Acinetobacter equi	1324350	S	2	0	2	0.00000
Acinetobacter defluvii	1871111	S	2	0	2	0.00000
Acinetobacter shaoyimingii	2715164	S	1	0	1	0.00000
Acinetobacter baylyi	202950	S	1	0	1	0.00000
Acinetobacter chinensis	2004650	S	1	0	1	0.00000
Acinetobacter radioresistens	40216	S	1	0	1	0.00000
Acinetobacter schindleri	108981	S	1	0	1	0.00000
Moraxella osloensis	34062	S	51	1	52	0.00000
Moraxella catarrhalis	480	S	2	0	2	0.00000
Moraxella ovis	29433	S	1	0	1	0.00000
Moraxella bovoculi	386891	S	1	0	1	0.00000
Psychrobacter sp. DAB_AL43B	1028416	S	6	0	6	0.00000
Psychrobacter sp.	56811	S	5	1	6	0.00000
Psychrobacter sp. G	571800	S	1	0	1	0.00000
Psychrobacter sp. P11F6	1699621	S	1	0	1	0.00000
Psychrobacter sp. P11G5	1699624	S	1	1	2	0.00000
Psychrobacter arenosus	256326	S	1	0	1	0.00000
Psychrobacter arcticus	334543	S	1	0	1	0.00000
Klebsiella pneumoniae	573	S	53	149	202	0.00000
Klebsiella michiganensis	1134687	S	3	1	4	0.00000
Klebsiella quasipneumoniae	1463165	S	3	1	4	0.00000
Klebsiella aerogenes	548	S	2	0	2	0.00000
Klebsiella oxytoca	571	S	2	0	2	0.00000
Klebsiella variicola	244366	S	1	0	1	0.00000
Klebsiella grimontii	2058152	S	1	1	2	0.00000
Klebsiella sp. STW0522-44	2681387	S	1	0	1	0.00000
Citrobacter freundii	546	S	8	8	16	0.00000
Citrobacter werkmanii	67827	S	1	0	1	0.00000
Citrobacter sp. R56	1573676	S	2	0	2	0.00000
Citrobacter sp. LY-1	2546350	S	1	0	1	0.00000
Citrobacter sp. RHBSTW-00881	2742667	S	1	3	4	0.00000
Citrobacter rodentium	67825	S	2	0	2	0.00000
Citrobacter cronae	1748967	S	2	2	4	0.00000
Citrobacter amalonaticus	35703	S	1	1	2	0.00000
Citrobacter telavivum	2653932	S	1	0	1	0.00000
Enterobacter cloacae	550	S	7	4	11	0.00000
Enterobacter hormaechei	158836	S	2	8	10	0.00000
Enterobacter asburiae	61645	S	1	0	1	0.00000
Enterobacter cancerogenus	69218	S	1	0	1	0.00000
Enterobacter sichuanensis	2071710	S	1	0	1	0.00000
Enterobacter sp. 638	399742	S	1	0	1	0.00000
Enterobacter sp. RHBSTW-00422	2742646	S	1	8	9	0.00000
Enterobacter sp. SA187	1914861	S	1	0	1	0.00000
Escherichia coli	562	S	11	192	203	0.00000
Escherichia fergusonii	564	S	5	0	5	0.00000
Escherichia albertii	208962	S	2	0	2	0.00000
Escherichia marmotae	1499973	S	2	0	2	0.00000
Leclercia sp. 29361	2714951	S	1	2	3	0.00000
Leclercia adecarboxylata	83655	S	2	9	11	0.00000
Cronobacter dublinensis	413497	S	2	0	2	0.00000
Cronobacter malonaticus	413503	S	2	1	3	0.00000
Cronobacter condimenti	1163710	S	2	0	2	0.00000
Cronobacter sakazakii	28141	S	1	0	1	0.00000
Cronobacter universalis	535744	S	1	0	1	0.00000
Candidatus Blochmannia pennsylvanicus	101534	S	1	1	2	0.00000
Candidatus Blochmannia vafer	251535	S	1	0	1	0.00000
Candidatus Hamiltonella defensa	138072	S	1	0	1	0.00000
secondary endosymbiont of Trabutina mannipara	1835721	S	1	0	1	0.00000
Candidatus Annandia adelgestsuga	1302411	S	1	0	1	0.00000
Candidatus Tachikawaea gelatinosa	1410383	S	1	0	1	0.00000
Candidatus Gullanella endobia	1070130	S	1	0	1	0.00000
Salmonella enterica	28901	S	5	4	9	0.00000
Enterobacteriaceae endosymbiont of Macroplea appendiculata	2675790	S	2	0	2	0.00000
Enterobacteriaceae endosymbiont of Macroplea mutica	2675791	S	1	0	1	0.00000
Enterobacteriaceae endosymbiont of Donacia provostii	2675781	S	1	0	1	0.00000
Enterobacteriaceae endosymbiont of Donacia vulgaris	2675789	S	1	0	1	0.00000
Enterobacteriaceae endosymbiont of Donacia semicuprea	2675783	S	1	0	1	0.00000
Raoultella planticola	575	S	1	0	1	0.00000
Raoultella terrigena	577	S	1	0	1	0.00000
Raoultella ornithinolytica	54291	S	1	3	4	0.00000
Kosakonia sacchari	1158459	S	1	0	1	0.00000
Kosakonia sp. MUSA4	2067958	S	1	0	1	0.00000
Kluyvera intermedia	61648	S	3	0	3	0.00000
Pluralibacter gergoviae	61647	S	3	0	3	0.00000
Lelliottia amnigena	61646	S	2	0	2	0.00000
Lelliottia sp. WB101	2153385	S	1	0	1	0.00000
Metakosakonia sp. MRY16-398	2487150	S	2	1	3	0.00000
Cedecea neteri	158822	S	1	0	1	0.00000
Cedecea lapagei	158823	S	1	0	1	0.00000
Scandinavium goeteborgense	1851514	S	1	0	1	0.00000
Candidatus Riesia pediculicola	401619	S	1	0	1	0.00000
Phytobacter ursingii	1972431	S	1	0	1	0.00000
Buttiauxella sp. 3AFRM03	2479367	S	1	0	1	0.00000
Pantoea sp. PSNIH1	1484158	S	4	2	6	0.00000
Pantoea sp. CCBC3-3-1	2490851	S	3	0	3	0.00000
Pantoea sp. SO10	2575375	S	3	0	3	0.00000
Pantoea sp. At-9b	592316	S	2	0	2	0.00000
Pantoea sp. MSR2	2052056	S	1	0	1	0.00000
Pantoea cypripedii	55209	S	5	0	5	0.00000
Pantoea ananatis	553	S	3	0	3	0.00000
Candidatus Pantoea carbekii	1235990	S	3	0	3	0.00000
Pantoea agglomerans	549	S	2	1	3	0.00000
Pantoea dispersa	59814	S	1	0	1	0.00000
Pantoea stewartii	66269	S	1	0	1	0.00000
Pantoea rwandensis	1076550	S	1	0	1	0.00000
Buchnera aphidicola	9	S	20	-1	19	0.00000
Candidatus Erwinia haradaeae	1922217	S	4	0	4	0.00000
Erwinia persicina	55211	S	1	0	1	0.00000
Erwinia tasmaniensis	338565	S	1	0	1	0.00000
Erwinia gerundensis	1619313	S	1	0	1	0.00000
Mixta intestinalis	1615494	S	3	0	3	0.00000
Mixta theicola	1458355	S	2	0	2	0.00000
Mixta gaviniae	665914	S	1	0	1	0.00000
Serratia marcescens	615	S	7	6	13	0.00000
Serratia plymuthica	82996	S	5	0	5	0.00000
Serratia odorifera	618	S	4	0	4	0.00000
Serratia symbiotica	138074	S	4	0	4	0.00000
Serratia rubidaea	61652	S	2	1	3	0.00000
Serratia liquefaciens	614	S	1	0	1	0.00000
Serratia proteamaculans	28151	S	1	0	1	0.00000
Serratia fonticola	47917	S	1	0	1	0.00000
Serratia grimesii	82995	S	1	0	1	0.00000
Serratia quinivorans	137545	S	1	0	1	0.00000
Serratia sp. ATCC 39006	104623	S	1	0	1	0.00000
Yersinia intermedia	631	S	2	3	5	0.00000
Yersinia aleksiciae	263819	S	2	0	2	0.00000
Yersinia pseudotuberculosis	633	S	1	0	1	0.00000
Yersinia similis	367190	S	1	0	1	0.00000
Yersinia enterocolitica	630	S	1	0	1	0.00000
Yersinia aldovae	29483	S	1	0	1	0.00000
Yersinia frederiksenii	29484	S	1	0	1	0.00000
Yersinia massiliensis	419257	S	1	1	2	0.00000
Yersinia entomophaga	935293	S	1	0	1	0.00000
Yersinia canariae	2607663	S	1	0	1	0.00000
Gibbsiella quercinecans	929813	S	3	0	3	0.00000
Ewingella americana	41202	S	2	0	2	0.00000
Nissabacter sp. SGAir0207	2126321	S	1	0	1	0.00000
Proteus mirabilis	584	S	8	2	10	0.00000
Proteus vulgaris	585	S	3	3	6	0.00000
Proteus hauseri	183417	S	1	0	1	0.00000
Providencia rustigianii	158850	S	3	0	3	0.00000
Providencia rettgeri	587	S	2	0	2	0.00000
Providencia stuartii	588	S	2	1	3	0.00000
Providencia heimbachae	333962	S	2	0	2	0.00000
Providencia vermicola	333965	S	1	0	1	0.00000
Providencia sp. 2.29	2791982	S	1	5	6	0.00000
Morganella morganii	582	S	6	0	6	0.00000
Xenorhabdus bovienii	40576	S	3	0	3	0.00000
Xenorhabdus budapestensis	290110	S	2	0	2	0.00000
Xenorhabdus doucetiae	351671	S	1	0	1	0.00000
Candidatus Arsenophonus lipoptenae	634113	S	2	0	2	0.00000
Photorhabdus laumondii	2218628	S	2	0	2	0.00000
Pectobacterium atrosepticum	29471	S	3	0	3	0.00000
Pectobacterium carotovorum	554	S	2	1	3	0.00000
Pectobacterium brasiliense	180957	S	2	1	3	0.00000
Pectobacterium parmentieri	1905730	S	2	0	2	0.00000
Pectobacterium punjabense	2108399	S	1	0	1	0.00000
Dickeya zeae	204042	S	2	0	2	0.00000
Dickeya dadantii	204038	S	1	0	1	0.00000
Dickeya solani	1089444	S	1	0	1	0.00000
Dickeya sp. NCPPB 3274	568766	S	1	1	2	0.00000
Brenneria goodwinii	1109412	S	2	0	2	0.00000
Brenneria rubrifaciens	55213	S	1	0	1	0.00000
Lonsdalea britannica	1082704	S	1	0	1	0.00000
Edwardsiella ictaluri	67780	S	2	0	2	0.00000
Edwardsiella piscicida	1263550	S	2	1	3	0.00000
Edwardsiella tarda	636	S	1	0	1	0.00000
Edwardsiella hoshinae	93378	S	1	0	1	0.00000
Hafnia alvei	569	S	2	1	3	0.00000
Hafnia paralvei	546367	S	1	0	1	0.00000
Obesumbacterium proteus	82983	S	4	0	4	0.00000
Jinshanibacter zhutongyuii	2498113	S	3	0	3	0.00000
Plesiomonas shigelloides	703	S	1	0	1	0.00000
Xanthomonas campestris	339	S	26	0	26	0.00000
Xanthomonas oryzae	347	S	8	0	8	0.00000
Xanthomonas sp. GW	2724121	S	4	2	6	0.00000
Xanthomonas arboricola	56448	S	5	5	10	0.00000
Xanthomonas citri	346	S	4	0	4	0.00000
Xanthomonas hyacinthi	56455	S	3	0	3	0.00000
Xanthomonas euvesicatoria	456327	S	3	170	173	0.00000
Xanthomonas cassavae	56450	S	3	0	3	0.00000
Xanthomonas axonopodis	53413	S	2	0	2	0.00000
Xanthomonas euroxanthea	2259622	S	2	0	2	0.00000
Xanthomonas translucens	343	S	2	0	2	0.00000
Xanthomonas hortorum	56454	S	1	0	1	0.00000
Xanthomonas vasicola	56459	S	1	0	1	0.00000
Xanthomonas theicola	56464	S	1	0	1	0.00000
Stenotrophomonas maltophilia	40324	S	39	29	68	0.00000
Stenotrophomonas sp. ESTM1D_MKCIP4_1	2072414	S	3	0	3	0.00000
Stenotrophomonas sp. 169	2770322	S	3	0	3	0.00000
Stenotrophomonas sp. LM091	1904944	S	2	0	2	0.00000
Stenotrophomonas sp. WZN-1	2005046	S	1	0	1	0.00000
Stenotrophomonas sp. 364	2691571	S	1	0	1	0.00000
Stenotrophomonas sp. CW117	2775920	S	1	8	9	0.00000
Stenotrophomonas rhizophila	216778	S	5	0	5	0.00000
Stenotrophomonas acidaminiphila	128780	S	1	0	1	0.00000
Lysobacter enzymogenes	69	S	50	9	59	0.00000
Lysobacter antibioticus	84531	S	4	0	4	0.00000
Lysobacter oculi	2698682	S	4	0	4	0.00000
Lysobacter sp. TY2-98	2290922	S	1	1	2	0.00000
Lysobacter sp. HDW10	2714936	S	1	0	1	0.00000
Lysobacter solisilvae	2763317	S	3	0	3	0.00000
Lysobacter arenosi	2795387	S	2	0	2	0.00000
Lysobacter gummosus	262324	S	1	0	1	0.00000
Lysobacter soli	453783	S	1	0	1	0.00000
Lysobacter lycopersici	1324796	S	1	0	1	0.00000
Lysobacter maris	1605891	S	1	0	1	0.00000
Lysobacter alkalisoli	2591633	S	1	0	1	0.00000
Pseudoxanthomonas suwonensis	314722	S	6	0	6	0.00000
Pseudoxanthomonas mexicana	128785	S	5	0	5	0.00000
Pseudoxanthomonas spadix	415229	S	4	0	4	0.00000
Thermomonas sp. SY21	2202149	S	3	0	3	0.00000
Thermomonas sp. XSG	2771436	S	3	0	3	0.00000
Thermomonas sp. HDW16	2714945	S	1	0	1	0.00000
Thermomonas brevis	215691	S	4	0	4	0.00000
Thermomonas carbonis	1463158	S	4	0	4	0.00000
Luteimonas sp. MC1750	2799326	S	4	0	4	0.00000
Luteimonas sp. JM171	1896164	S	2	0	2	0.00000
Luteimonas sp. YGD11-2	2508168	S	2	0	2	0.00000
Luteimonas yindakuii	2565782	S	2	0	2	0.00000
Arenimonas daejeonensis	370777	S	2	0	2	0.00000
Xylella fastidiosa	2371	S	1	0	1	0.00000
Rhodanobacter glycinis	582702	S	6	0	6	0.00000
Rhodanobacter denitrificans	666685	S	4	0	4	0.00000
Dyella caseinilytica	1849581	S	4	0	4	0.00000
Dyella thiooxydans	445710	S	3	0	3	0.00000
Dyella japonica	231455	S	2	0	2	0.00000
Luteibacter rhizovicinus	242606	S	2	3	5	0.00000
Luteibacter pinisoli	2589080	S	1	1	2	0.00000
Dokdonella koreensis	323415	S	7	0	7	0.00000
Ahniella affigens	2021234	S	3	0	3	0.00000
Frateuria aurantia	81475	S	1	0	1	0.00000
Aerosticca soli	2010829	S	1	0	1	0.00000
Marinobacter sp. Arc7-DN-1	2304594	S	3	1	4	0.00000
Marinobacter sp. LV10R510-11A	1415568	S	2	0	2	0.00000
Marinobacter sp. NP-4(2019)	2488665	S	1	0	1	0.00000
Marinobacter fonticola	2603215	S	5	0	5	0.00000
Marinobacter hydrocarbonoclasticus	2743	S	2	0	2	0.00000
Marinobacter salinus	1874317	S	2	0	2	0.00000
Alteromonas sp. BL110	1714845	S	1	2	3	0.00000
Alteromonas macleodii	28108	S	2	0	2	0.00000
Alteromonas mediterranea	314275	S	2	0	2	0.00000
Alteromonas pelagimontana	1858656	S	2	0	2	0.00000
Alteromonas addita	287094	S	1	4	5	0.00000
Salinimonas sp. KX18D6	2572577	S	3	0	3	0.00000
Salinimonas sp. G2-b	2785918	S	2	0	2	0.00000
Salinimonas sediminis	2303538	S	1	0	1	0.00000
Agarivorans gilvus	680279	S	5	0	5	0.00000
Glaciecola amylolytica	2489595	S	3	0	3	0.00000
Catenovulum sediminis	1740262	S	2	0	2	0.00000
Catenovulum sp. CCB-QB4	2172099	S	1	0	1	0.00000
Paraglaciecola sp. L3A3	2686358	S	1	0	1	0.00000
Lacimicrobium alkaliphilum	1526571	S	1	0	1	0.00000
Shewanella sp. Scap07	2589987	S	2	0	2	0.00000
Shewanella sp. Arc9-LZ	2698686	S	2	0	2	0.00000
Shewanella sp. YLB-06	2593655	S	2	0	2	0.00000
Shewanella sp. MR-7	60481	S	1	0	1	0.00000
Shewanella sp. MR-4	60480	S	1	0	1	0.00000
Shewanella sp. FJAT-51800	2814294	S	1	0	1	0.00000
Shewanella sp. WE21	2029986	S	1	0	1	0.00000
Shewanella sp. LZH-2	2806008	S	1	0	1	0.00000
Shewanella sp. KX20019	2803864	S	1	0	1	0.00000
Shewanella sp. WPAGA9	2775245	S	1	1	2	0.00000
Shewanella sp. LC6	2589790	S	1	2	3	0.00000
Shewanella algae	38313	S	4	0	4	0.00000
Shewanella putrefaciens	24	S	4	4	8	0.00000
Shewanella psychrophila	225848	S	3	0	3	0.00000
Shewanella benthica	43661	S	2	0	2	0.00000
Shewanella violacea	60217	S	1	0	1	0.00000
Shewanella baltica	62322	S	1	0	1	0.00000
Shewanella khirikhana	1965282	S	1	0	1	0.00000
Shewanella decolorationis	256839	S	1	0	1	0.00000
Shewanella aestuarii	1028752	S	1	0	1	0.00000
Parashewanella tropica	2547970	S	2	0	2	0.00000
Pseudoalteromonas sp. DL-6	1390185	S	2	1	3	0.00000
Pseudoalteromonas sp. A25	116092	S	1	0	1	0.00000
Pseudoalteromonas sp. GCY	2003316	S	1	0	1	0.00000
Pseudoalteromonas prydzensis	182141	S	3	0	3	0.00000
Pseudoalteromonas atlantica	288	S	2	0	2	0.00000
Pseudoalteromonas spongiae	298657	S	2	0	2	0.00000
Pseudoalteromonas luteoviolacea	43657	S	2	0	2	0.00000
Pseudoalteromonas piratica	1348114	S	1	0	1	0.00000
Pseudoalteromonas xiamenensis	882626	S	1	0	1	0.00000
Pseudoalteromonas aliena	247523	S	1	0	1	0.00000
Pseudoalteromonas ulvae	107327	S	1	0	1	0.00000
Pseudoalteromonas espejiana	28107	S	1	0	1	0.00000
Pseudoalteromonas undina	43660	S	1	2	3	0.00000
Pseudoalteromonas piscicida	43662	S	1	0	1	0.00000
Psychrosphaera sp. MTZ26	2820710	S	2	0	2	0.00000
Colwellia sp. PAMC 21821	1816219	S	2	0	2	0.00000
Colwellia sp. MT41	58049	S	1	0	1	0.00000
Colwellia beringensis	1967665	S	3	0	3	0.00000
Colwellia psychrerythraea	28229	S	1	0	1	0.00000
Thalassotalea crassostreae	1763536	S	1	0	1	0.00000
Psychromonas ingrahamii	357794	S	3	0	3	0.00000
Psychromonas sp. CNPT3	314282	S	3	0	3	0.00000
Moritella yayanosii	69539	S	1	0	1	0.00000
Moritella marina	90736	S	1	0	1	0.00000
Idiomarina andamanensis	1940690	S	2	0	2	0.00000
Ferrimonas balearica	44012	S	1	0	1	0.00000
Halomonas sp. JS92-SW72	2306583	S	60	14	74	0.00000
Halomonas sp. THAF5a	2587844	S	6	0	6	0.00000
Halomonas sp. HG01	1609967	S	3	0	3	0.00000
Halomonas sp. MCCC 1A13316	2733487	S	3	0	3	0.00000
Halomonas sp. THAF12	2587849	S	2	0	2	0.00000
Halomonas sp. KO116	1504981	S	2	0	2	0.00000
Halomonas sp. MCCC 1A11059	2733484	S	1	0	1	0.00000
Halomonas sp. GT	1971364	S	1	0	1	0.00000
Halomonas sp. 1513	1883416	S	1	0	1	0.00000
Halomonas sp. SH5A2	2749040	S	1	0	1	0.00000
Halomonas sp. A3H3	1346287	S	1	1	2	0.00000
Halomonas elongata	2746	S	2	0	2	0.00000
Halomonas piezotolerans	2609667	S	2	0	2	0.00000
Halomonas chromatireducens	507626	S	2	0	2	0.00000
Halomonas meridiana	29570	S	1	0	1	0.00000
Halomonas socia	1081866	S	1	0	1	0.00000
Halomonas titanicae	664683	S	1	0	1	0.00000
Halomonas beimenensis	475662	S	1	0	1	0.00000
Halomonas subglaciescola	29571	S	1	0	1	0.00000
Candidatus Portiera aleyrodidarum	91844	S	2	0	2	0.00000
Candidatus Carsonella ruddii	114186	S	1	0	1	0.00000
Kushneria phosphatilytica	657387	S	2	0	2	0.00000
Kushneria konosiri	698828	S	1	0	1	0.00000
Chromohalobacter salexigens	158080	S	1	0	1	0.00000
Marinomonas sp. FW-1	2071621	S	1	1	2	0.00000
Marinomonas posidonica	936476	S	2	0	2	0.00000
Marinomonas algicola	2773454	S	2	0	2	0.00000
Thalassolituus oleivorans	187493	S	2	0	2	0.00000
Marinobacterium georgiense	48076	S	1	0	1	0.00000
Neptunomonas japonica	417574	S	1	0	1	0.00000
Amphritea japonica	452627	S	1	0	1	0.00000
Bacterioplanes sanyensis	1249553	S	1	0	1	0.00000
Alcanivorax sp. N3-2A	2014542	S	5	1	6	0.00000
Alcanivorax dieselolei	285091	S	1	0	1	0.00000
Alcanivorax xenomutans	1094342	S	1	0	1	0.00000
Alcanivorax pacificus	1306787	S	1	0	1	0.00000
Ketobacter alkanivorans	1917421	S	1	0	1	0.00000
Reinekea forsetii	1336806	S	2	0	2	0.00000
Saccharospirillum mangrovi	2161747	S	1	0	1	0.00000
Gynuella sunshinyii	1445505	S	1	0	1	0.00000
Hahella chejuensis	158327	S	1	0	1	0.00000
Kangiella sediminilitoris	1144748	S	1	0	1	0.00000
Endozoicomonas montiporae	1027273	S	1	0	1	0.00000
Vibrio parahaemolyticus	670	S	6	0	6	0.00000
Vibrio diabolicus	50719	S	3	0	3	0.00000
Vibrio campbellii	680	S	2	0	2	0.00000
Vibrio harveyi	669	S	1	0	1	0.00000
Vibrio natriegens	691	S	1	1	2	0.00000
Vibrio rotiferianus	190895	S	1	0	1	0.00000
Vibrio jasicida	766224	S	1	0	1	0.00000
Vibrio anguillarum	55601	S	13	2	15	0.00000
Vibrio vulnificus	672	S	5	0	5	0.00000
Vibrio sp. THAF190c	2587865	S	2	0	2	0.00000
Vibrio sp. HDW18	2714948	S	1	0	1	0.00000
Vibrio sp. SM1977	2662262	S	1	0	1	0.00000
Vibrio fluvialis	676	S	4	0	4	0.00000
Vibrio mimicus	674	S	3	0	3	0.00000
Vibrio coralliilyticus	190893	S	3	2	5	0.00000
Vibrio panuliri	1381081	S	2	0	2	0.00000
Vibrio tubiashii	29498	S	1	0	1	0.00000
Vibrio europaeus	300876	S	1	0	1	0.00000
Vibrio tapetis	52443	S	2	0	2	0.00000
Vibrio rumoiensis	76258	S	2	0	2	0.00000
Vibrio taketomensis	2572923	S	1	0	1	0.00000
Vibrio spartinae	1918945	S	1	0	1	0.00000
Vibrio scophthalmi	45658	S	1	0	1	0.00000
Vibrio crassostreae	246167	S	1	0	1	0.00000
Vibrio astriarenae	1481923	S	1	0	1	0.00000
Photobacterium damselae	38293	S	4	0	4	0.00000
Photobacterium profundum	74109	S	2	0	2	0.00000
Aliivibrio fischeri	668	S	4	0	4	0.00000
Aliivibrio salmonicida	40269	S	2	0	2	0.00000
Candidatus Enterovibrio luxaltus	1927128	S	2	0	2	0.00000
Paraphotobacterium marinum	1755811	S	2	0	2	0.00000
Salinivibrio sp. YCSC6	2003370	S	1	0	1	0.00000
Pasteurella multocida	747	S	43	12	55	0.00000
Haemophilus parainfluenzae	729	S	9	0	9	0.00000
Haemophilus influenzae	727	S	2	1	3	0.00000
Haemophilus haemolyticus	726	S	1	0	1	0.00000
Haemophilus pittmaniae	249188	S	1	0	1	0.00000
Actinobacillus pleuropneumoniae	715	S	3	1	4	0.00000
Actinobacillus porcitonsillarum	189834	S	2	0	2	0.00000
Actinobacillus suis	716	S	1	0	1	0.00000
Mannheimia pernigra	111844	S	2	1	3	0.00000
Mannheimia varigena	85404	S	1	0	1	0.00000
Gallibacterium anatis	750	S	3	0	3	0.00000
Basfia succiniciproducens	653940	S	2	1	3	0.00000
Aggregatibacter actinomycetemcomitans	714	S	1	0	1	0.00000
Aggregatibacter sp. 2125159857	2820817	S	1	0	1	0.00000
Rodentibacter sp. DSM 111151	2778911	S	2	0	2	0.00000
Vespertiliibacter pulmonis	1443036	S	2	0	2	0.00000
Bibersteinia trehalosi	47735	S	1	20	21	0.00000
Avibacterium volantium	762	S	1	0	1	0.00000
Candidatus Thiodictyon syntrophicum	1166950	S	8	0	8	0.00000
Rheinheimera sp. F8	1763998	S	2	0	2	0.00000
Rheinheimera sp. LHK132	2498451	S	1	0	1	0.00000
Rheinheimera sp. D18	2545632	S	1	0	1	0.00000
Nitrosococcus wardiae	1814290	S	3	0	3	0.00000
Marichromatium purpuratum	37487	S	3	0	3	0.00000
Candidatus Nitrosoglobus terrae	1630141	S	2	0	2	0.00000
Candidatus Nitrosacidococcus tergens	553981	S	2	0	2	0.00000
Thioalkalivibrio nitratireducens	186931	S	4	0	4	0.00000
Thioalkalivibrio versutus	106634	S	2	0	2	0.00000
Thioalkalivibrio paradoxus	108010	S	2	0	2	0.00000
Thioalkalivibrio sulfidiphilus	1033854	S	1	0	1	0.00000
Ectothiorhodospira sp. BSL-9	1442136	S	3	0	3	0.00000
Acidihalobacter aeolianus	2792603	S	2	0	2	0.00000
Acidihalobacter ferrooxydans	1765967	S	1	0	1	0.00000
Halorhodospira halophila	1053	S	1	0	1	0.00000
Alkalilimnicola ehrlichii	351052	S	1	0	1	0.00000
Spiribacter salinus	1335746	S	1	0	1	0.00000
Sulfurivermis fontis	1972068	S	5	0	5	0.00000
Granulosicoccus antarcticus	437505	S	2	0	2	0.00000
Sulfuriflexus mobilis	1811807	S	2	0	2	0.00000
Wenzhouxiangella marina	1579979	S	1	0	1	0.00000
Wenzhouxiangella sp. AB-CW3	2771012	S	1	0	1	0.00000
Woeseia oceani	1548547	S	2	0	2	0.00000
Guyparkeria halophila	47960	S	2	0	2	0.00000
Halothiobacillus neapolitanus	927	S	1	0	1	0.00000
Aeromonas sp. CA23	2033032	S	3	0	3	0.00000
Aeromonas sp. ASNIH2	1636607	S	1	5	6	0.00000
Aeromonas veronii	654	S	6	1	7	0.00000
Aeromonas hydrophila	644	S	3	2	5	0.00000
Aeromonas simiae	218936	S	3	0	3	0.00000
Aeromonas schubertii	652	S	3	0	3	0.00000
Aeromonas jandaei	650	S	2	0	2	0.00000
Aeromonas salmonicida	645	S	1	0	1	0.00000
Aeromonas encheleia	73010	S	1	0	1	0.00000
Aeromonas allosaccharophila	656	S	1	0	1	0.00000
Tolumonas auensis	43948	S	2	0	2	0.00000
Oceanisphaera profunda	1416627	S	2	0	2	0.00000
Oceanimonas sp. GK1	511062	S	1	0	1	0.00000
Zobellella denitrificans	347534	S	1	0	1	0.00000
Succinivibrio dextrinosolvens	83771	S	1	0	1	0.00000
Cellvibrio japonicus	155077	S	2	0	2	0.00000
Cellvibrio sp. PSBB006	1987723	S	1	0	1	0.00000
Cellvibrio sp. KY-GH-1	2303332	S	1	0	1	0.00000
Agarilytica rhodophyticola	1737490	S	2	0	2	0.00000
Teredinibacter purpureus	2731756	S	1	0	1	0.00000
Saccharophagus degradans	86304	S	1	0	1	0.00000
Simiduia agarivorans	447471	S	1	0	1	0.00000
Kineobactrum salinum	2708301	S	6	0	6	0.00000
Congregibacter litoralis	393662	S	2	1	3	0.00000
Oceanicoccus sagamiensis	716816	S	3	0	3	0.00000
Zhongshania aliphaticivorans	1470434	S	3	0	3	0.00000
Spongiibacter sp. CSC3.9	2794344	S	2	0	2	0.00000
Microbulbifer sp. A4B17	359370	S	2	0	2	0.00000
Microbulbifer sp. SH-1	2681547	S	2	0	2	0.00000
Legionella pneumophila	446	S	4	0	4	0.00000
Legionella cherrii	28084	S	3	0	3	0.00000
Legionella hackeliae	449	S	2	1	3	0.00000
Legionella sp. TUM19329	2708020	S	1	0	1	0.00000
Legionella sp. PC997	2755562	S	1	0	1	0.00000
Legionella sainthelensi	28087	S	2	0	2	0.00000
Legionella anisa	28082	S	2	0	2	0.00000
Legionella spiritensis	452	S	1	0	1	0.00000
Legionella oakridgensis	29423	S	1	0	1	0.00000
Legionella geestiana	45065	S	1	0	1	0.00000
Legionella waltersii	66969	S	1	0	1	0.00000
Legionella fallonii	96230	S	1	0	1	0.00000
Legionella clemsonensis	1867846	S	1	0	1	0.00000
Tatlockia micdadei	451	S	1	0	1	0.00000
Aquicella siphonis	254247	S	2	0	2	0.00000
Aquicella lusitana	254246	S	1	0	1	0.00000
Coxiella burnetii	777	S	1	0	1	0.00000
Candidatus Coxiella mudrowiae	2054173	S	1	0	1	0.00000
Candidatus Rickettsiella viridis	676208	S	1	0	1	0.00000
Hydrogenovibrio crunogenus	39765	S	4	0	4	0.00000
Methylophaga frappieri	754477	S	2	0	2	0.00000
Methylophaga nitratireducenticrescens	754476	S	1	0	1	0.00000
Piscirickettsia salmonis	1238	S	2	0	2	0.00000
Thiosulfativibrio zosterae	2675053	S	2	0	2	0.00000
Thiomicrospira cyclica	147268	S	1	0	1	0.00000
Thiosulfatimonas sediminis	2675054	S	1	0	1	0.00000
Francisella tularensis	263	S	2	1	3	0.00000
Francisella sp. FSC1006	1547445	S	1	0	1	0.00000
Francisella sp. Scap27	2589986	S	1	0	1	0.00000
Francisella orientalis	299583	S	1	0	1	0.00000
Francisella hispaniensis	622488	S	1	0	1	0.00000
Allofrancisella guangzhouensis	594679	S	1	0	1	0.00000
Allofrancisella inopinata	1085647	S	1	0	1	0.00000
Thiothrix sp.	1032	S	2	1	3	0.00000
Thiothrix unzii	111769	S	1	0	1	0.00000
Methylomonas sp. LL1	2785785	S	2	0	2	0.00000
Methylomonas sp. DH-1	1727196	S	1	4	5	0.00000
Methylomonas rhizoryzae	2608981	S	2	0	2	0.00000
Methylomonas denitrificans	1538553	S	1	0	1	0.00000
Methylomicrobium album	39775	S	3	0	3	0.00000
Methylomicrobium sp. wino1	2049332	S	1	0	1	0.00000
Methylovulum psychrotolerans	1704499	S	4	0	4	0.00000
Methylococcus capsulatus	414	S	1	2	3	0.00000
Methylocaldum marinum	1432792	S	2	0	2	0.00000
Methylotuvimicrobium buryatense	95641	S	1	0	1	0.00000
Immundisolibacter cernigliae	1810504	S	20	0	20	0.00000
Sulfurifustis variabilis	1675686	S	3	0	3	0.00000
Acidiferrobacter sp. SPIII_3	1281578	S	2	0	2	0.00000
Sulfuricaulis limicola	1620215	S	2	0	2	0.00000
Bathymodiolus thermophilus thioautotrophic gill symbiont	2360	S	2	0	2	0.00000
Candidatus Ruthia magnifica	386487	S	1	0	1	0.00000
Candidatus Reidiella endopervernicosa	2738883	S	2	0	2	0.00000
Candidatus Thioglobus autotrophicus	1705394	S	1	0	1	0.00000
Orbus sp. IPMB12	1635327	S	3	0	3	0.00000
Gilliamella apicola	1196095	S	1	0	1	0.00000
Frischella perrara	1267021	S	1	0	1	0.00000
Solimonas sp. K1W22B-7	2303331	S	2	0	2	0.00000
Sinimarinibacterium sp. NLF-5-8	2698684	S	1	0	1	0.00000
Steroidobacter denitrificans	465721	S	1	0	1	0.00000
Cardiobacterium hominis	2718	S	1	0	1	0.00000
Bradyrhizobium sp. BTAi1	288000	S	11	1	12	0.00000
Bradyrhizobium sp. CCBAU 051011	858422	S	9	0	9	0.00000
Bradyrhizobium sp. ORS 285	115808	S	8	1	9	0.00000
Bradyrhizobium sp. CCBAU 51753	1325100	S	8	1	9	0.00000
Bradyrhizobium sp. CCBAU 53338	1325111	S	8	2	10	0.00000
Bradyrhizobium sp. CCBAU 53351	1325114	S	8	3	11	0.00000
Bradyrhizobium sp. SK17	2057741	S	7	2	9	0.00000
Bradyrhizobium sp.	376	S	6	12	18	0.00000
Bradyrhizobium sp. 6(2017)	1197460	S	6	0	6	0.00000
Bradyrhizobium sp. CCBAU 53421	1325120	S	6	1	7	0.00000
Bradyrhizobium sp. CCBAU 51765	1325102	S	6	1	7	0.00000
Bradyrhizobium sp. PSBB068	2715960	S	5	1	6	0.00000
Bradyrhizobium sp. ORS 278	114615	S	4	0	4	0.00000
Bradyrhizobium sp. CCBAU 53340	1325112	S	3	0	3	0.00000
Bradyrhizobium sp. CCGE-LA001	1223566	S	3	0	3	0.00000
Bradyrhizobium sp. 1(2017)	1404888	S	2	0	2	0.00000
Bradyrhizobium icense	1274631	S	21	1	22	0.00000
Bradyrhizobium erythrophlei	1437360	S	16	0	16	0.00000
Bradyrhizobium paxllaeri	190148	S	14	1	15	0.00000
Bradyrhizobium lablabi	722472	S	14	11	25	0.00000
Bradyrhizobium diazoefficiens	1355477	S	14	8	22	0.00000
Bradyrhizobium canariense	255045	S	7	0	7	0.00000
Bradyrhizobium zhanjiangense	1325107	S	6	0	6	0.00000
Bradyrhizobium arachidis	858423	S	5	0	5	0.00000
Bradyrhizobium oligotrophicum	44255	S	5	0	5	0.00000
Bradyrhizobium symbiodeficiens	1404367	S	5	0	5	0.00000
Bradyrhizobium vignae	1549949	S	4	0	4	0.00000
Bradyrhizobium betae	244734	S	4	1	5	0.00000
Bradyrhizobium japonicum	375	S	4	1	5	0.00000
Bradyrhizobium guangxiense	1325115	S	4	1	5	0.00000
Bradyrhizobium guangdongense	1325090	S	3	1	4	0.00000
Bradyrhizobium elkanii	29448	S	3	41	44	0.00000
Bradyrhizobium cosmicum	1404864	S	3	0	3	0.00000
Bradyrhizobium amphicarpaeae	1404768	S	3	0	3	0.00000
Bradyrhizobium genosp. L	83637	S	3	0	3	0.00000
Bradyrhizobium guangzhouense	1325095	S	2	0	2	0.00000
Bradyrhizobium ottawaense	931866	S	2	6	8	0.00000
Bradyrhizobium genosp. B	83627	S	2	0	2	0.00000
Bosea sp. ANAM02	2020412	S	17	4	21	0.00000
Bosea sp. RAC05	1842539	S	8	1	9	0.00000
Bosea sp. Tri-49	1867715	S	7	1	8	0.00000
Bosea sp. F3-2	2599640	S	5	1	6	0.00000
Bosea sp. AS-1	2015316	S	4	1	5	0.00000
Bosea sp. PAMC 26642	1792307	S	3	0	3	0.00000
Bosea vaviloviae	1526658	S	6	1	7	0.00000
Rhodopseudomonas palustris	1076	S	26	3	29	0.00000
Tardiphaga robiniae	943830	S	10	0	10	0.00000
Afipia carboxidovorans	40137	S	4	-4	0	0.00000
Afipia sp. GAS231	1882747	S	4	2	6	0.00000
Nitrobacter hamburgensis	912	S	3	0	3	0.00000
Nitrobacter winogradskyi	913	S	3	0	3	0.00000
Variibacter gotjawalensis	1333996	S	6	0	6	0.00000
Rhizobium sp. BG4	2613770	S	3	0	3	0.00000
Rhizobium sp. 11515TR	2028343	S	2	0	2	0.00000
Rhizobium sp. NXC14	1981173	S	1	0	1	0.00000
Rhizobium sp. Khangiran2	1435607	S	1	0	1	0.00000
Rhizobium sp. ACO-34A	1571470	S	1	0	1	0.00000
Rhizobium sp. NZLR1	2731096	S	1	0	1	0.00000
Rhizobium sp. TAL182	2020313	S	1	2	3	0.00000
Rhizobium sp. NXC24	2048897	S	1	0	1	0.00000
Rhizobium bangladeshense	1138189	S	7	0	7	0.00000
Rhizobium etli	29449	S	7	2	9	0.00000
Rhizobium leguminosarum	384	S	6	3	9	0.00000
Rhizobium pusense	648995	S	4	10	14	0.00000
Rhizobium gallicum	56730	S	3	0	3	0.00000
Rhizobium phaseoli	396	S	3	3	6	0.00000
Rhizobium oryzihabitans	2267833	S	3	2	5	0.00000
Rhizobium rosettiformans	1368430	S	3	1	4	0.00000
Rhizobium tropici	398	S	3	1	4	0.00000
Rhizobium lusitanum	293958	S	3	0	3	0.00000
Rhizobium pseudoryzae	379684	S	2	0	2	0.00000
Rhizobium indicum	2583231	S	1	0	1	0.00000
Rhizobium favelukesii	348824	S	1	0	1	0.00000
Rhizobium daejeonense	240521	S	1	0	1	0.00000
Rhizobium lentis	1138194	S	1	0	1	0.00000
Rhizobium jaguaris	1312183	S	1	0	1	0.00000
Rhizobium ruizarguesonis	2081791	S	1	2	3	0.00000
Agrobacterium tumefaciens	358	S	11	7	18	0.00000
Agrobacterium vitis	373	S	5	0	5	0.00000
Agrobacterium sp. MA01	2664893	S	2	1	3	0.00000
Agrobacterium sp. T29	2580515	S	1	0	1	0.00000
Agrobacterium rhizogenes	359	S	3	3	6	0.00000
Agrobacterium rubi	28099	S	1	0	1	0.00000
Agrobacterium larrymoorei	160699	S	1	0	1	0.00000
Neorhizobium sp. NCHU2750	1825976	S	5	0	5	0.00000
Neorhizobium sp. SOG26	2060726	S	4	0	4	0.00000
Neorhizobium galegae	399	S	4	0	4	0.00000
Sinorhizobium meliloti	382	S	15	1	16	0.00000
Sinorhizobium fredii	380	S	9	3	12	0.00000
Sinorhizobium sp. RAC02	1842534	S	3	0	3	0.00000
Sinorhizobium sp. BG8	2613773	S	3	0	3	0.00000
Sinorhizobium medicae	110321	S	1	0	1	0.00000
Sinorhizobium americanum	194963	S	1	0	1	0.00000
Ensifer adhaerens	106592	S	7	0	7	0.00000
Ensifer mexicanus	375549	S	3	0	3	0.00000
Ensifer sp. PDNC004	2811423	S	3	0	3	0.00000
Ensifer sojae	716925	S	2	0	2	0.00000
Ensifer alkalisoli	1752398	S	1	0	1	0.00000
Shinella sp. HZN7	879274	S	5	3	8	0.00000
Shinella sp. PSBB067	2715959	S	3	2	5	0.00000
Georhizobium profundi	2341112	S	4	0	4	0.00000
Kaistia sp. 32K	2795690	S	3	0	3	0.00000
Ciceribacter thiooxidans	1969821	S	3	0	3	0.00000
Methylobacterium sp. 17Sr1-43	2202828	S	10	0	10	0.00000
Methylobacterium sp. 17Sr1-1	2202826	S	8	1	9	0.00000
Methylobacterium sp. WL1	2603276	S	6	0	6	0.00000
Methylobacterium sp. 4-46	426117	S	3	0	3	0.00000
Methylobacterium sp. AMS5	925818	S	3	1	4	0.00000
Methylobacterium sp. DM1	2067957	S	3	3	6	0.00000
Methylobacterium mesophilicum	39956	S	11	0	11	0.00000
Methylobacterium durans	2202825	S	8	0	8	0.00000
Methylobacterium nodulans	114616	S	7	0	7	0.00000
Methylobacterium brachiatum	269660	S	5	1	6	0.00000
Methylobacterium aquaticum	270351	S	5	1	6	0.00000
Methylobacterium indicum	1775910	S	4	0	4	0.00000
Methylobacterium currus	2051553	S	4	1	5	0.00000
Methylobacterium oryzae	334852	S	2	23	25	0.00000
Methylobacterium terrae	2202827	S	2	0	2	0.00000
Methylobacterium radiotolerans	31998	S	1	2	3	0.00000
Methylorubrum populi	223967	S	20	5	25	0.00000
Methylorubrum extorquens	408	S	11	10	21	0.00000
Microvirga thermotolerans	2651334	S	6	0	6	0.00000
Microvirga ossetica	1882682	S	1	0	1	0.00000
Microvirga sp. 17 mud 1-3	2082949	S	1	0	1	0.00000
Mesorhizobium sp. Pch-S	2082387	S	9	0	9	0.00000
Mesorhizobium sp. N3	675281	S	6	0	6	0.00000
Mesorhizobium sp. INR15	2654248	S	5	0	5	0.00000
Mesorhizobium sp. M4B.F.Ca.ET.058.02.1.1	2493675	S	4	1	5	0.00000
Mesorhizobium sp. M1E.F.Ca.ET.045.02.1.1	2493672	S	4	1	5	0.00000
Mesorhizobium sp. M7A.F.Ce.TU.012.03.2.1	2493681	S	3	0	3	0.00000
Mesorhizobium sp. L-8-3	2744522	S	3	6	9	0.00000
Mesorhizobium sp. M1A.F.Ca.IN.022.06.1.1	2493680	S	3	0	3	0.00000
Mesorhizobium sp. 131-2-1	2744518	S	3	1	4	0.00000
Mesorhizobium sp. M1B.F.Ca.ET.045.04.1.1	2493673	S	2	0	2	0.00000
Mesorhizobium sp. M8A.F.Ca.ET.057.01.1.1	2493679	S	2	0	2	0.00000
Mesorhizobium sp. M7D.F.Ca.US.005.01.1.1	2493678	S	2	0	2	0.00000
Mesorhizobium sp. M3A.F.Ca.ET.080.04.2.1	2493676	S	2	0	2	0.00000
Mesorhizobium sp. M2A.F.Ca.ET.043.05.1.1	2493671	S	2	0	2	0.00000
Mesorhizobium sp. M1D.F.Ca.ET.043.01.1.1	2493669	S	1	0	1	0.00000
Mesorhizobium sp. M9A.F.Ca.ET.002.03.1.2	2493668	S	1	0	1	0.00000
Mesorhizobium sp. NZP2298	2483403	S	1	0	1	0.00000
Mesorhizobium sp. 113-3-9	2744517	S	1	0	1	0.00000
Mesorhizobium sp. NBSH29	2654249	S	1	0	1	0.00000
Mesorhizobium loti	381	S	4	9	13	0.00000
Mesorhizobium opportunistum	593909	S	4	1	5	0.00000
Mesorhizobium ciceri	39645	S	3	4	7	0.00000
Mesorhizobium amorphae	71433	S	3	0	3	0.00000
Mesorhizobium japonicum	2066070	S	3	1	4	0.00000
Mesorhizobium oceanicum	1670800	S	2	0	2	0.00000
Mesorhizobium australicum	536018	S	1	0	1	0.00000
Aminobacter sp. MSH1	374606	S	3	1	4	0.00000
Aminobacter sp. MDW-2	2666139	S	3	10	13	0.00000
Aminobacter sp. SR38	2774562	S	3	8	11	0.00000
Aminobacter aminovorans	83263	S	3	0	3	0.00000
Hoeflea phototrophica	244596	S	3	0	3	0.00000
Hoeflea sp. IMCC20628	1620421	S	2	0	2	0.00000
Phyllobacterium sp. 628	2718938	S	2	0	2	0.00000
Phyllobacterium zundukense	1867719	S	1	0	1	0.00000
Nitratireductor sp. SY7	2599600	S	2	0	2	0.00000
Nitratireductor sp. OM-1	1756988	S	1	0	1	0.00000
Chelativorans sp. BNC1	266779	S	2	0	2	0.00000
Lentilitoribacter sp. Alg239-R112	2305987	S	1	0	1	0.00000
Devosia sp. A16	1736675	S	7	0	7	0.00000
Devosia sp. G19	2801335	S	5	0	5	0.00000
Devosia sp. MC521	2759954	S	3	0	3	0.00000
Devosia sp. 1566	2499144	S	1	0	1	0.00000
Devosia ginsengisoli	400770	S	3	0	3	0.00000
Hyphomicrobium sp. MC1	717785	S	4	0	4	0.00000
Hyphomicrobium denitrificans	53399	S	3	0	3	0.00000
Hyphomicrobium nitrativorans	1427356	S	1	0	1	0.00000
Rhodoplanes sp. Z2-YC6860	674703	S	6	0	6	0.00000
Youhaiella tibetensis	1447062	S	5	0	5	0.00000
Candidatus Filomicrobium marinum	1608628	S	3	0	3	0.00000
Methyloceanibacter sp. wino2	2170729	S	2	0	2	0.00000
Methyloceanibacter caenitepidi	1384459	S	1	0	1	0.00000
Blastochloris tepida	2233851	S	2	0	2	0.00000
Aquabacter sp. L1I39	2820278	S	1	0	1	0.00000
Maritalea myrionectae	454601	S	1	0	1	0.00000
Paradevosia shaoguanensis	1335043	S	1	1	2	0.00000
Caenibius tardaugens	169176	S	1	1	2	0.00000
Pseudolabrys taiwanensis	331696	S	6	0	6	0.00000
Pseudolabrys sp. FHR47	2562284	S	3	0	3	0.00000
Xanthobacter sp. YN2	2528964	S	6	0	6	0.00000
Ancylobacter sp. TS-1	1850374	S	3	0	3	0.00000
Ancylobacter pratisalsi	1745854	S	2	0	2	0.00000
Azorhizobium caulinodans	7	S	2	0	2	0.00000
Starkeya novella	921	S	1	0	1	0.00000
Starkeya sp. ORNL1	2709380	S	1	0	1	0.00000
Labrys sp. KNU-23	2789216	S	1	0	1	0.00000
Aureimonas sp. AU20	1349819	S	8	0	8	0.00000
Aureimonas sp. OT7	2816454	S	3	2	5	0.00000
Aureimonas sp. LMG 31693	2758041	S	2	0	2	0.00000
Aureimonas populi	1701758	S	6	0	6	0.00000
Martelella sp. AD-3	686597	S	1	1	2	0.00000
Martelella mediterranea	293089	S	1	0	1	0.00000
Martelella endophytica	1486262	S	1	0	1	0.00000
Martelella lutilitoris	2583532	S	1	0	1	0.00000
Pannonibacter phragmitetus	121719	S	6	5	11	0.00000
Stappia indica	538381	S	4	0	4	0.00000
Stappia sp. ES.058	1881061	S	1	0	1	0.00000
Labrenzia alexandrii	388408	S	2	0	2	0.00000
Labrenzia aggregata	187304	S	1	0	1	0.00000
Methylocystis bryophila	655015	S	4	0	4	0.00000
Methylocystis parvus	134	S	2	0	2	0.00000
Methylocystis rosea	173366	S	2	0	2	0.00000
Methylocystis heyeri	391905	S	1	0	1	0.00000
Methylocystis sp. SC2	187303	S	1	0	1	0.00000
Methylosinus sp. C49	2699395	S	4	0	4	0.00000
Bartonella vinsonii	33047	S	2	0	2	0.00000
Bartonella ancashensis	1318743	S	2	0	2	0.00000
Bartonella sp. HY038	2759660	S	1	0	1	0.00000
Bartonella grahamii	33045	S	1	0	1	0.00000
Bartonella henselae	38323	S	1	0	1	0.00000
Bartonella apis	1686310	S	1	0	1	0.00000
Bartonella australis	388640	S	1	0	1	0.00000
[Ochrobactrum] quorumnocens	271865	S	2	0	2	0.00000
Brucella pseudogrignonensis	419475	S	2	1	3	0.00000
Brucella pituitosa	571256	S	1	0	1	0.00000
Brucella sp. 6810	2769351	S	1	2	3	0.00000
Beijerinckia indica	533	S	4	0	4	0.00000
Methylocella silvestris	199596	S	2	0	2	0.00000
Methylocella tundrae	227605	S	2	0	2	0.00000
Methylovirgula ligni	569860	S	1	0	1	0.00000
Hartmannibacter diazotrophicus	1482074	S	4	0	4	0.00000
Candidatus Hodgkinia cicadicola	573658	S	2	0	2	0.00000
Nordella sp. HKS 07	2712222	S	1	0	1	0.00000
Breoghania sp. L-A4	2304600	S	3	0	3	0.00000
Cohaesibacter sp. ES.047	1798205	S	2	0	2	0.00000
Chelatococcus daeguensis	444444	S	3	0	3	0.00000
Chelatococcus sp. CO-6	1702325	S	2	0	2	0.00000
Pyruvatibacter mobilis	1712261	S	2	0	2	0.00000
Parvibaculum lavamentivorans	256618	S	1	0	1	0.00000
Lichenihabitans psoromatis	2528642	S	1	0	1	0.00000
Sphingomonas sp. LM7	1938607	S	7	0	7	0.00000
Sphingomonas sp. DH-S5	2759526	S	6	0	6	0.00000
Sphingomonas sp. MK52	2711156	S	6	0	6	0.00000
Sphingomonas sp. C33	2698679	S	6	0	6	0.00000
Sphingomonas sp. CL5.1	2653203	S	6	1	7	0.00000
Sphingomonas sp. NBWT7	2596913	S	6	0	6	0.00000
Sphingomonas sp. FARSPH	2219696	S	6	2	8	0.00000
Sphingomonas sp. HMP9	1517554	S	6	1	7	0.00000
Sphingomonas sp. HMP6	1517551	S	5	0	5	0.00000
Sphingomonas sp. PAMC26645	2565555	S	5	0	5	0.00000
Sphingomonas sp. YZ-8	2319844	S	5	0	5	0.00000
Sphingomonas sp. KC8	1030157	S	5	1	6	0.00000
Sphingomonas sp. AAP5	1523415	S	5	0	5	0.00000
Sphingomonas sp. AP4-R1	2735134	S	4	0	4	0.00000
Sphingomonas sp. LMO-1	2681549	S	4	0	4	0.00000
Sphingomonas sp. NIC1	1961362	S	3	2	5	0.00000
Sphingomonas sp. HDW15C	2714944	S	3	0	3	0.00000
Sphingomonas sp. C8-2	2492837	S	3	1	4	0.00000
Sphingomonas sp. MM-1	745310	S	3	3	6	0.00000
Sphingomonas sp. HDW15A	2714942	S	2	0	2	0.00000
Sphingomonas sp. Cra20	1327635	S	2	0	2	0.00000
Sphingomonas sp. LK11	1390395	S	2	0	2	0.00000
Sphingomonas sp. XS-10	2599297	S	2	0	2	0.00000
Sphingomonas sp. IC081	304378	S	2	5	7	0.00000
Sphingomonas sp. sand1-3	2764186	S	1	0	1	0.00000
Sphingomonas melonis	152682	S	24	25	49	0.00000
Sphingomonas koreensis	93064	S	14	6	20	0.00000
Sphingomonas hengshuiensis	1609977	S	12	0	12	0.00000
Sphingomonas panacisoli	1813879	S	10	0	10	0.00000
Sphingomonas alpina	653931	S	8	0	8	0.00000
Sphingomonas panacis	1560345	S	7	0	7	0.00000
Sphingomonas wittichii	160791	S	7	2	9	0.00000
Sphingomonas sanxanigenens	397260	S	6	2	8	0.00000
Sphingomonas lutea	1045317	S	6	0	6	0.00000
Sphingomonas taxi	1549858	S	5	0	5	0.00000
Sphingomonas ginsengisoli An et al. 2013	363835	S	5	0	5	0.00000
Sphingomonas paucimobilis	13689	S	4	0	4	0.00000
Sphingomonas lacunae	2698828	S	4	0	4	0.00000
Sphingomonas insulae	424800	S	2	0	2	0.00000
Sphingomonas rhizophila	2071607	S	2	0	2	0.00000
Sphingomonas xanthus	2594473	S	2	0	2	0.00000
Sphingomonas daechungensis	1176646	S	1	0	1	0.00000
Sphingopyxis sp. QXT-31	1357916	S	7	1	8	0.00000
Sphingopyxis sp. EG6	1874061	S	6	2	8	0.00000
Sphingopyxis sp. OPL5	2486273	S	6	0	6	0.00000
Sphingopyxis sp. 113P3	292913	S	5	1	6	0.00000
Sphingopyxis sp. PAMC25046	2565556	S	5	2	7	0.00000
Sphingopyxis sp. FD7	1914525	S	4	1	5	0.00000
Sphingopyxis sp. LPB0140	1913578	S	1	0	1	0.00000
Sphingopyxis macrogoltabida	33050	S	16	6	22	0.00000
Sphingopyxis terrae	33052	S	8	3	11	0.00000
Sphingopyxis fribergensis	1515612	S	7	2	9	0.00000
Sphingopyxis lindanitolerans	2054227	S	6	1	7	0.00000
Sphingopyxis alaskensis	117207	S	4	0	4	0.00000
Sphingopyxis granuli	267128	S	4	23	27	0.00000
Sphingobium sp. RAC03	1843368	S	6	0	6	0.00000
Sphingobium sp. SYK-6	627192	S	4	0	4	0.00000
Sphingobium sp. TKS	1315974	S	4	4	8	0.00000
Sphingobium sp. SCG-1	2072936	S	4	0	4	0.00000
Sphingobium sp. YG1	2082188	S	4	1	5	0.00000
Sphingobium sp. CAP-1	2676077	S	4	2	6	0.00000
Sphingobium sp. KCTC 72723	2733867	S	3	0	3	0.00000
Sphingobium sp. Cam5-1	2789327	S	3	0	3	0.00000
Sphingobium sp. MI1205	407020	S	1	1	2	0.00000
Sphingobium sp. YBL2	484429	S	1	2	3	0.00000
Sphingobium sp. LF-16	2185111	S	1	6	7	0.00000
Sphingobium yanoikuyae	13690	S	12	11	23	0.00000
Sphingobium amiense	135719	S	8	11	19	0.00000
Sphingobium japonicum	332056	S	4	1	5	0.00000
Sphingobium chlorophenolicum	46429	S	3	1	4	0.00000
Sphingobium herbicidovorans	76947	S	3	1	4	0.00000
Sphingobium cloacae	120107	S	3	4	7	0.00000
Sphingobium fuliginis	336203	S	3	5	8	0.00000
Sphingobium hydrophobicum	1673076	S	3	2	5	0.00000
Sphingobium baderi	1332080	S	2	2	4	0.00000
Novosphingobium sp. ABRDHK2	2571749	S	9	2	11	0.00000
Novosphingobium sp. ES2-1	2780074	S	6	1	7	0.00000
Novosphingobium sp. THN1	1016987	S	4	0	4	0.00000
Novosphingobium sp. PP1Y	702113	S	2	1	3	0.00000
Novosphingobium sp. Gsoil 351	2675225	S	2	0	2	0.00000
Novosphingobium sp. KA1	164608	S	1	2	3	0.00000
Novosphingobium sp. P6W	1609758	S	1	0	1	0.00000
Novosphingobium aromaticivorans	48935	S	5	1	6	0.00000
Novosphingobium pentaromativorans	205844	S	5	6	11	0.00000
Novosphingobium resinovorum	158500	S	4	1	5	0.00000
Novosphingobium ginsenosidimutans	1176536	S	4	0	4	0.00000
Sphingorhabdus lacus	392610	S	23	1	24	0.00000
Sphingorhabdus sp. SMR4y	2584094	S	9	1	10	0.00000
Sphingorhabdus sp. YGSMI21	2077182	S	2	0	2	0.00000
Sphingorhabdus sp. M41	1806885	S	1	0	1	0.00000
Blastomonas sp. RAC04	1842535	S	7	4	11	0.00000
Blastomonas fulva	1550728	S	4	4	8	0.00000
Sphingosinithalassobacter sp. zrk23	2711215	S	4	0	4	0.00000
Sphingosinithalassobacter sp. CS137	2762748	S	3	0	3	0.00000
Tardibacter chloracetimidivorans	1921510	S	7	5	12	0.00000
Parasphingopyxis algicola	2026624	S	4	0	4	0.00000
Parasphingopyxis sp. CP4	2724527	S	2	0	2	0.00000
Allosphingosinicella indica	941907	S	4	0	4	0.00000
Citromicrobium sp. JL477	1634516	S	3	0	3	0.00000
Rhizorhabdus dicambivorans	1850238	S	3	2	5	0.00000
Parasphingorhabdus sp. JHSY0214	2806553	S	2	0	2	0.00000
Novosphingopyxis sp. PB63	2762729	S	2	0	2	0.00000
Erythrobacter sp. THAF29	2587851	S	5	1	6	0.00000
Erythrobacter sp. 6D36	2782568	S	3	0	3	0.00000
Erythrobacter sp. KY5	2011159	S	2	0	2	0.00000
Erythrobacter sp. HKB08	2502843	S	2	0	2	0.00000
Erythrobacter litoralis	39960	S	6	2	8	0.00000
Erythrobacter mangrovi	2739433	S	4	0	4	0.00000
Erythrobacter aureus	2182384	S	2	0	2	0.00000
Erythrobacter neustonensis	1112	S	1	0	1	0.00000
Porphyrobacter sp. CACIAM 03H1	2003315	S	9	2	11	0.00000
Porphyrobacter sp. LM 6	1896196	S	3	1	4	0.00000
Porphyrobacter sp. YT40	2547601	S	3	2	5	0.00000
Porphyrobacter sp. HT-58-2	2023229	S	2	0	2	0.00000
Altererythrobacter sp. BO-6	2604537	S	6	0	6	0.00000
Altererythrobacter sp. TH136	2067415	S	3	0	3	0.00000
Altererythrobacter sp. B11	2060312	S	1	0	1	0.00000
Altererythrobacter epoxidivorans	361183	S	7	1	8	0.00000
Altererythrobacter atlanticus	1267766	S	2	0	2	0.00000
Altererythrobacter ishigakiensis	476157	S	1	0	1	0.00000
Tsuneonella dongtanensis	692370	S	4	0	4	0.00000
Tsuneonella mangrovi	1982042	S	4	0	4	0.00000
Tsuneonella amylolytica	2338327	S	2	0	2	0.00000
Tsuneonella flava	2055955	S	1	0	1	0.00000
Croceicoccus sp. YJ47	2798724	S	4	1	5	0.00000
Croceicoccus marinus	450378	S	2	1	3	0.00000
Croceicoccus naphthovorans	1348774	S	1	1	2	0.00000
Qipengyuania flava	192812	S	4	2	6	0.00000
Qipengyuania seohaensis	266951	S	1	0	1	0.00000
Pelagerythrobacter marensis	543877	S	4	0	4	0.00000
Paraurantiacibacter namhicola	645517	S	3	0	3	0.00000
Aurantiacibacter gangjinensis	502682	S	2	0	2	0.00000
Sphingosinicella sp. BN140058	1892855	S	6	0	6	0.00000
Sphingosinicella sp. UDD2	2771430	S	4	0	4	0.00000
Sphingosinicella microcystinivorans	335406	S	3	0	3	0.00000
Sandaracinobacter sp. M6	2759707	S	1	0	1	0.00000
Paracoccus sp. Arc7-R13	2500532	S	5	0	5	0.00000
Paracoccus sp. AK26	2589076	S	5	0	5	0.00000
Paracoccus sp. MC1862	2760307	S	2	0	2	0.00000
Paracoccus sp. BM15	1529068	S	1	0	1	0.00000
Paracoccus sp. H4-D09	2812658	S	1	0	1	0.00000
Paracoccus suum	2259340	S	7	1	8	0.00000
Paracoccus yeei	147645	S	7	10	17	0.00000
Paracoccus denitrificans	266	S	6	1	7	0.00000
Paracoccus pantotrophus	82367	S	5	1	6	0.00000
Paracoccus sanguinis	1545044	S	5	0	5	0.00000
Paracoccus zhejiangensis	1077935	S	4	0	4	0.00000
Paracoccus liaowanqingii	2560053	S	3	0	3	0.00000
Paracoccus jeotgali	2065379	S	3	0	3	0.00000
Paracoccus aestuarii	453842	S	2	0	2	0.00000
Paracoccus kondratievae	135740	S	2	0	2	0.00000
Paracoccus aminovorans	34004	S	2	0	2	0.00000
Paracoccus aminophilus	34003	S	2	0	2	0.00000
Sulfitobacter sp. SK011	1389004	S	2	0	2	0.00000
Sulfitobacter sp. AM1-D1	1917485	S	2	2	4	0.00000
Sulfitobacter sp. JL08	2070369	S	2	0	2	0.00000
Sulfitobacter sp. THAF37	2587855	S	2	1	3	0.00000
Sulfitobacter sp. SK012	1389005	S	1	0	1	0.00000
Sulfitobacter sp. SK025	1389011	S	1	0	1	0.00000
Sulfitobacter sp. B30-2	2785912	S	1	0	1	0.00000
Sulfitobacter pseudonitzschiae	1402135	S	4	1	5	0.00000
Sulfitobacter mediterraneus	83219	S	3	0	3	0.00000
Rhodobacter blasticus	1075	S	8	0	8	0.00000
Rhodobacter capsulatus	1061	S	4	0	4	0.00000
Rhodobacter sp. LPB0142	1850250	S	2	0	2	0.00000
Rhodobacter sp. CZR27	2033869	S	2	0	2	0.00000
Tabrizicola piscis	2494374	S	15	0	15	0.00000
Gemmobacter sp. HYN0069	2169400	S	12	1	13	0.00000
Phaeobacter piscinae	1580596	S	4	5	9	0.00000
Phaeobacter gallaeciensis	60890	S	3	2	5	0.00000
Salipiger pacificus	311180	S	5	0	5	0.00000
Yangia sp. CCB-MM3	1792508	S	4	0	4	0.00000
Salipiger profundus	1229727	S	3	1	4	0.00000
Roseovarius faecimaris	2494550	S	4	0	4	0.00000
Roseovarius sp. THAF27	2587850	S	2	2	4	0.00000
Roseovarius sp. THAF9	2587847	S	1	0	1	0.00000
Roseovarius indicus	540747	S	2	1	3	0.00000
Cereibacter sphaeroides	1063	S	11	0	11	0.00000
Defluviimonas alba	1335048	S	8	2	10	0.00000
Leisingera aquaemixtae	1396826	S	4	0	4	0.00000
Leisingera sp. NJS204	2508307	S	2	1	3	0.00000
Leisingera sp. NJS201	2508306	S	1	0	1	0.00000
Confluentimicrobium sp. EMB200-NS6	1609966	S	6	5	11	0.00000
Rhodobaca barguzinensis	441209	S	6	0	6	0.00000
Pseudohalocynthiibacter aestuariivivens	1591409	S	6	1	7	0.00000
Octadecabacter arcticus	53946	S	3	0	3	0.00000
Octadecabacter sp. SW4	2602067	S	1	0	1	0.00000
Octadecabacter antarcticus	1217908	S	1	0	1	0.00000
Marinovum algicola	42444	S	5	2	7	0.00000
Jannaschia sp. CCS1	290400	S	5	0	5	0.00000
Pontivivens sp. MT2928	2789856	S	5	0	5	0.00000
Ruegeria sp. THAF33	2587853	S	2	1	3	0.00000
Ruegeria sp. AD91A	2293862	S	1	0	1	0.00000
Thioclava nitratireducens	1915078	S	3	0	3	0.00000
Thioclava electrotropha	1549850	S	1	0	1	0.00000
Rhodovulum sulfidophilum	35806	S	1	2	3	0.00000
Rhodovulum sp. P5	1564506	S	1	0	1	0.00000
Roseobacter litoralis	42443	S	4	0	4	0.00000
Thalassobius gelatinovorus	53501	S	3	0	3	0.00000
Haematobacter massiliensis	195105	S	3	1	4	0.00000
Mameliella alba	561184	S	3	0	3	0.00000
Parasedimentitalea marina	2483033	S	3	0	3	0.00000
Qingshengfaniella alkalisoli	2599296	S	2	0	2	0.00000
Marivivens sp. JLT3646	1920883	S	2	0	2	0.00000
Pseudooceanicola algae	1537215	S	2	0	2	0.00000
Brevirhabdus pacifica	1267768	S	2	1	3	0.00000
Yoonia vestfoldensis	245188	S	2	0	2	0.00000
Roseicitreum antarcticum	564137	S	2	0	2	0.00000
Celeribacter marinus	1397108	S	1	0	1	0.00000
Celeribacter ethanolicus	1758178	S	1	0	1	0.00000
Pseudorhodobacter turbinis	2500533	S	2	0	2	0.00000
Polymorphum gilvum	991904	S	2	0	2	0.00000
Sagittula sp. P11	2009329	S	1	0	1	0.00000
Thalassococcus sp. S3	2017482	S	1	0	1	0.00000
Profundibacter amoris	2171755	S	1	0	1	0.00000
Antarctobacter heliothermus	74033	S	1	0	1	0.00000
Paraoceanicella profunda	2579971	S	1	0	1	0.00000
Pseudopuniceibacterium antarcticum	2613965	S	1	0	1	0.00000
Ketogulonicigenium robustum	92947	S	1	0	1	0.00000
Silicimonas algicola	1826607	S	1	0	1	0.00000
Roseibacterium elongatum	159346	S	1	0	1	0.00000
Boseongicola sp. CCM32	2552942	S	1	0	1	0.00000
Maribius sp. THAF1	2587842	S	1	0	1	0.00000
Brevundimonas sp. LVF1	2774189	S	15	2	17	0.00000
Brevundimonas sp. LM2	1938605	S	8	0	8	0.00000
Brevundimonas sp. AJA228-03	2752515	S	5	0	5	0.00000
Brevundimonas sp. DS20	1532555	S	3	6	9	0.00000
Brevundimonas sp. GW460-12-10-14-LB2	1827469	S	3	3	6	0.00000
Brevundimonas sp. MF30-B	2561924	S	3	0	3	0.00000
Brevundimonas sp. M20	2591463	S	3	0	3	0.00000
Brevundimonas sp. LVF2	2774190	S	3	0	3	0.00000
Brevundimonas sp. GRTSA-9	2800818	S	3	0	3	0.00000
Brevundimonas sp. Bb-A	2560058	S	2	4	6	0.00000
Brevundimonas sp. 'scallop'	2562582	S	2	2	4	0.00000
Brevundimonas naejangsanensis	588932	S	14	2	16	0.00000
Brevundimonas vesicularis	41276	S	7	13	20	0.00000
Brevundimonas mediterranea	74329	S	7	1	8	0.00000
Brevundimonas subvibrioides	74313	S	1	0	1	0.00000
Caulobacter vibrioides	155892	S	12	3	15	0.00000
Caulobacter sp. FWC26	69665	S	6	1	7	0.00000
Caulobacter sp. K31	366602	S	2	0	2	0.00000
Caulobacter soli	2708539	S	8	1	9	0.00000
Caulobacter rhizosphaerae	2010972	S	6	1	7	0.00000
Caulobacter flavus	1679497	S	5	0	5	0.00000
Caulobacter mirabilis	69666	S	4	0	4	0.00000
Caulobacter henricii	69395	S	2	0	2	0.00000
Caulobacter segnis	88688	S	1	0	1	0.00000
Phenylobacterium zucineum	284016	S	6	0	6	0.00000
Phenylobacterium parvum	2201350	S	1	0	1	0.00000
Asticcacaulis excentricus	78587	S	7	0	7	0.00000
Terricaulis silvestris	2686094	S	5	0	5	0.00000
Azospirillum brasilense	192	S	20	6	26	0.00000
Azospirillum lipoferum	193	S	3	0	3	0.00000
Azospirillum sp. TSH100	652764	S	2	0	2	0.00000
Azospirillum sp. TSA2s	709810	S	1	0	1	0.00000
Azospirillum thiophilum	528244	S	2	0	2	0.00000
Azospirillum baldaniorum	1064539	S	2	1	3	0.00000
Azospirillum oryzae	286727	S	1	0	1	0.00000
Azospirillum ramasamyi	682998	S	1	0	1	0.00000
Azospirillum humicireducens	1226968	S	1	0	1	0.00000
Magnetospirillum sp. XM-1	1663591	S	5	1	6	0.00000
Magnetospirillum sp. ME-1	1639348	S	3	0	3	0.00000
Magnetospirillum magneticum	84159	S	5	1	6	0.00000
Magnetospirillum gryphiswaldense	55518	S	4	0	4	0.00000
Skermanella sp. TT6	2775420	S	4	4	8	0.00000
Skermanella pratensis	2233999	S	3	1	4	0.00000
Rhodospirillum centenum	34018	S	3	0	3	0.00000
Rhodospirillum rubrum	1085	S	2	-2	0	0.00000
Hypericibacter terrae	2602015	S	3	0	3	0.00000
Hypericibacter adhaerens	2602016	S	1	0	1	0.00000
Ferrovibrio terrae	2594003	S	4	0	4	0.00000
Niveispirillum cyanobacteriorum	1612173	S	4	0	4	0.00000
Nitrospirillum amazonense	28077	S	4	0	4	0.00000
Thalassospira indica	1891279	S	1	0	1	0.00000
Thalassospira marina	2048283	S	1	0	1	0.00000
Thalassospira sp. B30-1	2785911	S	1	0	1	0.00000
Tistrella mobilis	171437	S	3	0	3	0.00000
Indioceanicola profundi	2220096	S	2	0	2	0.00000
Defluviicoccus vanus	111831	S	1	0	1	0.00000
Candidatus Endolissoclinum faulkneri	1263979	S	1	0	1	0.00000
Roseomonas sp. 1318	2768161	S	5	0	5	0.00000
Roseomonas sp. 546	2768162	S	2	0	2	0.00000
Roseomonas sp. FDAARGOS_362	2018065	S	1	1	2	0.00000
Roseomonas gilardii	257708	S	2	0	2	0.00000
Roseomonas mucosa	207340	S	1	2	3	0.00000
Acetobacter aceti	435	S	3	2	5	0.00000
Acetobacter ghanensis	431306	S	3	2	5	0.00000
Acetobacter persici	1076596	S	1	0	1	0.00000
Komagataeibacter xylinus	28448	S	2	3	5	0.00000
Komagataeibacter oboediens	65958	S	1	0	1	0.00000
Komagataeibacter medellinensis	1177712	S	1	1	2	0.00000
Stella humosa	94	S	6	0	6	0.00000
Gluconobacter oxydans	442	S	2	2	4	0.00000
Roseococcus sp. NIBR12	2771361	S	4	0	4	0.00000
Gluconacetobacter diazotrophicus	33996	S	3	0	3	0.00000
Lichenicola cladoniae	1484109	S	2	0	2	0.00000
Entomobacter blattae	2762277	S	1	0	1	0.00000
Oecophyllibacter saccharovorans	2558360	S	1	0	1	0.00000
Swingsia samuiensis	1293412	S	1	0	1	0.00000
Granulibacter bethesdensis	364410	S	1	0	1	0.00000
Kozakia baliensis	153496	S	1	0	1	0.00000
Rickettsia montanensis	33991	S	2	2	4	0.00000
Rickettsia endosymbiont of Ixodes scapularis	444612	S	1	0	1	0.00000
Rickettsia raoultii	369822	S	1	0	1	0.00000
Rickettsia endosymbiont of Bemisia tabaci	337479	S	1	0	1	0.00000
Rickettsia endosymbiont of Ixodes pacificus	1133329	S	1	1	2	0.00000
Rickettsia sp. Tillamook 23	2761623	S	1	1	2	0.00000
Rickettsia canadensis	788	S	1	-1	0	0.00000
Orientia tsutsugamushi	784	S	5	0	5	0.00000
Candidatus Phycorickettsia trachydisci	2115978	S	1	0	1	0.00000
Wolbachia endosymbiont of Litomosoides sigmodontis	80850	S	2	0	2	0.00000
Wolbachia endosymbiont of Ctenocephalides felis wCfeT	2732593	S	1	0	1	0.00000
Wolbachia endosymbiont of Diaphorina citri	116598	S	1	3	4	0.00000
Wolbachia endosymbiont of Folsomia candida	169402	S	1	0	1	0.00000
Candidatus Wolbachia massiliensis	1845000	S	1	0	1	0.00000
Ehrlichia ruminantium	779	S	6	0	6	0.00000
Rickettsiales endosymbiont of Stachyamoeba lipophora	2486578	S	4	0	4	0.00000
Phreatobacter stygius	1940610	S	7	0	7	0.00000
Phreatobacter cathodiphilus	1868589	S	4	0	4	0.00000
Phreatobacter sp. NMCR1094	2570229	S	2	0	2	0.00000
Micavibrio aeruginosavorus	349221	S	1	0	1	0.00000
Hyphomonas sp. CACIAM 19H1	1873716	S	7	0	7	0.00000
Hyphomonas sp. Mor2	1906738	S	2	0	2	0.00000
Hyphomonas sp. KY3	2016196	S	1	0	1	0.00000
Hirschia baltica	2724	S	1	0	1	0.00000
Candidatus Pelagibacter giovannonii	2563896	S	3	0	3	0.00000
Candidatus Pelagibacter sp. RS39	1977864	S	2	0	2	0.00000
Candidatus Pelagibacter sp. HIMB1321	1388755	S	1	0	1	0.00000
Candidatus Fonsibacter ubiquis	1925548	S	1	0	1	0.00000
Marinicauda algicola	2029849	S	6	0	6	0.00000
Maricaulis maris	74318	S	1	0	1	0.00000
Hyphobacterium sp. CCMP332	2749086	S	1	0	1	0.00000
Candidatus Nucleicultrix amoebiphila	1509244	S	2	0	2	0.00000
Candidatus Nesciobacter abundans	2601668	S	1	0	1	0.00000
Candidatus Paracaedibacter acanthamoebae	91604	S	1	0	1	0.00000
Parvularcula bermudensis	208216	S	2	0	2	0.00000
Luteithermobacter gelatinilyticus	2582913	S	2	0	2	0.00000
Magnetococcus marinus	1124597	S	1	0	1	0.00000
Sorangium cellulosum	56	S	48	4	52	0.00000
Chondromyces crocatus	52	S	4	0	4	0.00000
Labilithrix luteola	1391654	S	16	0	16	0.00000
Sandaracinus amylolyticus	927083	S	10	0	10	0.00000
Minicystis rosea	888845	S	8	0	8	0.00000
Myxococcus xanthus	34	S	7	2	9	0.00000
Myxococcus hansupus	1297742	S	5	1	6	0.00000
Myxococcus stipitatus	83455	S	2	1	3	0.00000
Corallococcus coralloides	184914	S	6	0	6	0.00000
Corallococcus macrosporus	35	S	2	1	3	0.00000
Pyxidicoccus sp. SCPEA002	2813578	S	2	0	2	0.00000
Archangium violaceum	83451	S	10	1	11	0.00000
Archangium gephyra	48	S	7	1	8	0.00000
Cystobacter fuscus	43	S	6	1	7	0.00000
Melittangium boletus	83453	S	3	0	3	0.00000
Stigmatella aurantiaca	41	S	1	0	1	0.00000
Anaeromyxobacter sp. Fw109-5	404589	S	4	0	4	0.00000
Anaeromyxobacter sp. K	447217	S	1	8	9	0.00000
Vulgatibacter incomptus	1391653	S	3	0	3	0.00000
Haliangium ochraceum	80816	S	9	0	9	0.00000
Desulfovibrio sp. 86	2666132	S	5	1	6	0.00000
Desulfovibrio sp. IOR2	2583823	S	2	0	2	0.00000
Desulfovibrio carbinoliphilus	345370	S	6	0	6	0.00000
Desulfovibrio vulgaris	881	S	5	0	5	0.00000
Desulfovibrio piger	901	S	5	0	5	0.00000
Desulfovibrio desulfuricans	876	S	1	0	1	0.00000
Desulfovibrio gigas	879	S	1	0	1	0.00000
Desulfovibrio fairfieldensis	44742	S	1	0	1	0.00000
Desulfovibrio alaskensis	58180	S	1	0	1	0.00000
Desulfovibrio carbinolicus	296842	S	1	1	2	0.00000
Desulfovibrio marinus	370038	S	1	0	1	0.00000
Pseudodesulfovibrio aespoeensis	182210	S	2	0	2	0.00000
Pseudodesulfovibrio mercurii	641491	S	2	0	2	0.00000
Pseudodesulfovibrio indicus	1716143	S	1	0	1	0.00000
Pseudodesulfovibrio sp. zrk46	2725288	S	1	0	1	0.00000
Pseudodesulfovibrio cashew	2678688	S	1	0	1	0.00000
Lawsonia intracellularis	29546	S	2	-2	0	0.00000
Maridesulfovibrio salexigens	880	S	1	0	1	0.00000
Maridesulfovibrio hydrothermalis	191026	S	1	0	1	0.00000
Desulfomicrobium baculatum	899	S	1	0	1	0.00000
Geobacter sp. SVR	2495594	S	4	0	4	0.00000
Geobacter sp. M21	443144	S	1	0	1	0.00000
Geobacter sp. DSM 9736	1277350	S	1	0	1	0.00000
Geobacter sp. Jerry-YX	2815309	S	1	0	1	0.00000
Geobacter bremensis	60035	S	4	0	4	0.00000
Geobacter lovleyi	313985	S	3	0	3	0.00000
Geobacter sulfurreducens	35554	S	1	0	1	0.00000
Geobacter bemidjiensis	225194	S	1	0	1	0.00000
Geobacter pickeringii	345632	S	1	0	1	0.00000
Geobacter uraniireducens	351604	S	1	0	1	0.00000
Syntrophotalea carbinolica	19	S	3	0	3	0.00000
Syntrophotalea acetylenica	29542	S	2	0	2	0.00000
Syntrophotalea acetylenivorans	1842532	S	2	0	2	0.00000
Desulfuromonas sp. DDH964	1823759	S	2	0	2	0.00000
Desulfuromonas soudanensis	1603606	S	1	0	1	0.00000
Pelobacter propionicus	29543	S	2	0	2	0.00000
Desulfosarcina ovata	83564	S	3	0	3	0.00000
Desulfosarcina widdelii	947919	S	3	0	3	0.00000
Desulfosarcina alkanivorans	571177	S	1	0	1	0.00000
Desulfococcus oleovorans	181663	S	5	0	5	0.00000
Desulfobacter hydrogenophilus	2291	S	1	0	1	0.00000
Desulfobacterium autotrophicum	2296	S	1	0	1	0.00000
Desulfonema limicola	45656	S	1	0	1	0.00000
Desulfatibacillum aliphaticivorans	218208	S	1	0	1	0.00000
Desulfobulbus oralis	1986146	S	1	0	1	0.00000
Desulfotalea psychrophila	84980	S	1	0	1	0.00000
Desulfurivibrio alkaliphilus	427923	S	1	0	1	0.00000
Desulfopila sp. IMCC35004	2569540	S	1	0	1	0.00000
Persicimonas caeni	2292766	S	7	0	7	0.00000
Bradymonas sediminis	1548548	S	2	0	2	0.00000
Desulfarculus baarsii	453230	S	5	1	6	0.00000
Syntrophobacter fumaroxidans	119484	S	1	0	1	0.00000
Desulfoglaeba alkanexedens	361111	S	1	0	1	0.00000
Syntrophus aciditrophicus	316277	S	1	0	1	0.00000
Candidatus Desulfofervidus auxilii	1621989	S	2	0	2	0.00000
Aliarcobacter cryaerophilus	28198	S	6	2	8	0.00000
Aliarcobacter skirrowii	28200	S	1	0	1	0.00000
Aliarcobacter cibarius	255507	S	1	0	1	0.00000
Aliarcobacter thereius	544718	S	1	0	1	0.00000
Aliarcobacter trophiarum	708186	S	1	0	1	0.00000
Aliarcobacter lanthieri	1355374	S	1	0	1	0.00000
Aliarcobacter faecis	1564138	S	1	0	1	0.00000
[Arcobacter] porcinus	1935204	S	1	0	1	0.00000
Malaciobacter halophilus	197482	S	8	1	9	0.00000
Malaciobacter mytili	603050	S	2	0	2	0.00000
Malaciobacter molluscorum	1032072	S	1	0	1	0.00000
Arcobacter nitrofigilis	28199	S	3	0	3	0.00000
Arcobacter sp. FWKO B	2593672	S	3	0	3	0.00000
Arcobacter ellisii	913109	S	1	0	1	0.00000
Arcobacter venerupis	1054033	S	1	0	1	0.00000
Halarcobacter bivalviorum	663364	S	2	0	2	0.00000
Halarcobacter ebronensis	1462615	S	2	0	2	0.00000
Poseidonibacter lekithochrous	1904463	S	3	0	3	0.00000
Campylobacter sp. RM16192	1660080	S	2	1	3	0.00000
Campylobacter sp. RM16704	1500960	S	1	0	1	0.00000
Campylobacter sp. CCUG 57310	2517362	S	1	0	1	0.00000
Campylobacter lanienae	75658	S	4	0	4	0.00000
Campylobacter jejuni	197	S	3	8	11	0.00000
Campylobacter coli	195	S	3	0	3	0.00000
Campylobacter concisus	199	S	3	0	3	0.00000
Campylobacter sputorum	206	S	3	0	3	0.00000
Campylobacter blaseri	2042961	S	2	0	2	0.00000
Campylobacter geochelonis	1780362	S	2	0	2	0.00000
Campylobacter pinnipediorum	1965231	S	2	0	2	0.00000
Campylobacter showae	204	S	1	0	1	0.00000
Campylobacter mucosalis	202	S	1	0	1	0.00000
Campylobacter curvus	200	S	1	0	1	0.00000
Campylobacter hyointestinalis	198	S	1	0	1	0.00000
Campylobacter corcagiensis	1448857	S	1	0	1	0.00000
Campylobacter canadensis	449520	S	1	0	1	0.00000
Campylobacter subantarcticus	497724	S	1	-1	0	0.00000
Sulfurospirillum sp. UCH001	1581011	S	2	2	4	0.00000
Sulfurospirillum deleyianum	65553	S	2	0	2	0.00000
Sulfurospirillum barnesii	44674	S	1	0	1	0.00000
Helicobacter pylori	210	S	6	0	6	0.00000
Helicobacter apodemus	135569	S	3	0	3	0.00000
Helicobacter acinonychis	212	S	2	0	2	0.00000
Helicobacter mustelae	217	S	1	0	1	0.00000
Helicobacter cetorum	138563	S	1	0	1	0.00000
Helicobacter canadensis	123841	S	1	0	1	0.00000
Helicobacter bilis	37372	S	1	0	1	0.00000
Sulfurimonas sp. 1-1N	2590021	S	1	3	4	0.00000
Sulfurimonas sp. GYSZ_1	2590022	S	1	0	1	0.00000
Sulfurimonas sp. H1576	2672570	S	1	0	1	0.00000
Sulfurimonas gotlandica	1176482	S	3	0	3	0.00000
Candidatus Sulfurimonas baltica	2740404	S	1	0	1	0.00000
Candidatus Sulfurimonas marisnigri	2740405	S	1	0	1	0.00000
Hydrogenimonas urashimensis	2740515	S	3	0	3	0.00000
Nitratifractor salsuginis	269261	S	1	0	1	0.00000
Caminibacter mediatlanticus	291048	S	4	0	4	0.00000
Cetia pacifica	1424653	S	1	0	1	0.00000
Nitratiruptor sp. YY09-18	2724901	S	1	3	4	0.00000
Bdellovibrio sp. NC01	2220073	S	5	0	5	0.00000
Bdellovibrio sp. KM01	2748865	S	2	0	2	0.00000
Bdellovibrio sp. ZAP7	2231053	S	1	0	1	0.00000
Bdellovibrio bacteriovorus	959	S	5	0	5	0.00000
Bdellovibrio exovorus	453816	S	4	0	4	0.00000
Bacteriovorax stolpii	960	S	3	0	3	0.00000
Halobacteriovorax marinus	97084	S	1	0	1	0.00000
Acidithiobacillus ferrooxidans	920	S	3	0	3	0.00000
Acidithiobacillus caldus	33059	S	1	0	1	0.00000
Acidithiobacillus ferrivorans	160808	S	1	0	1	0.00000
Mariprofundus aestuarium	1921086	S	2	0	2	0.00000
Mariprofundus ferrinatatus	1921087	S	1	0	1	0.00000
Hydrogenophilus thermoluteolus	297	S	2	0	2	0.00000
Cutibacterium acnes	1747	S	1038	70	1108	0.00001
Cutibacterium granulosum	33011	S	11	0	11	0.00000
Cutibacterium avidum	33010	S	9	0	9	0.00000
Propionibacterium sp. oral taxon 193	671223	S	36	4	40	0.00000
Propionibacterium australiense	119981	S	1	0	1	0.00000
Propionibacterium acidifaciens	556499	S	1	0	1	0.00000
Microlunatus sagamiharensis	546874	S	8	0	8	0.00000
Microlunatus soli	630515	S	4	0	4	0.00000
Microlunatus phosphovorus	29405	S	3	0	3	0.00000
Microlunatus sp. KUDC0627	2596828	S	2	0	2	0.00000
Microlunatus sp. Gsoil 973	2672569	S	1	0	1	0.00000
Tessaracoccus flavescens	399497	S	3	1	4	0.00000
Tessaracoccus aquimaris	1332264	S	3	0	3	0.00000
Tessaracoccus defluvii	1285901	S	2	0	2	0.00000
Tessaracoccus flavus	1610493	S	1	0	1	0.00000
Tessaracoccus timonensis	2161816	S	1	0	1	0.00000
Acidipropionibacterium acidipropionici	1748	S	2	0	2	0.00000
Acidipropionibacterium jensenii	1749	S	1	0	1	0.00000
Acidipropionibacterium virtanenii	2057246	S	1	0	1	0.00000
Auraticoccus monumenti	675864	S	3	0	3	0.00000
Brevilactibacter sp. MC1595	2819349	S	3	0	3	0.00000
Propioniciclava sp. HDW11	2714937	S	1	0	1	0.00000
Raineyella sp. CBA3103	2662261	S	1	0	1	0.00000
Nocardioides sp. HDW12B	2714939	S	7	0	7	0.00000
Nocardioides sp. S5	2017486	S	5	0	5	0.00000
Nocardioides sp. zg-579	2663857	S	5	0	5	0.00000
Nocardioides sp. JQ2195	2592334	S	3	0	3	0.00000
Nocardioides sp. zg-1228	2763008	S	2	0	2	0.00000
Nocardioides sp. MC1495	2736757	S	2	0	2	0.00000
Nocardioides sp. HDW12A	2714938	S	2	0	2	0.00000
Nocardioides sp. dk884	2662361	S	2	1	3	0.00000
Nocardioides sp. JS614	196162	S	2	0	2	0.00000
Nocardioides sp. dk3136	2575373	S	1	0	1	0.00000
Nocardioides sp. HY056	2500546	S	1	0	1	0.00000
Nocardioides sp. WS12	2486272	S	1	0	1	0.00000
Nocardioides sp. 603	2483798	S	1	0	1	0.00000
Nocardioides sp. S-713	2760089	S	1	0	1	0.00000
Nocardioides sp. CF8	110319	S	1	0	1	0.00000
Nocardioides ungokensis	1643322	S	7	0	7	0.00000
Nocardioides aromaticivorans	200618	S	4	0	4	0.00000
Nocardioides daphniae	402297	S	4	0	4	0.00000
Nocardioides marinisabuli	419476	S	4	0	4	0.00000
Nocardioides cynanchi	2558918	S	4	0	4	0.00000
Nocardioides anomalus	2712223	S	4	0	4	0.00000
Nocardioides humi	449461	S	3	0	3	0.00000
Nocardioides dokdonensis	450734	S	3	0	3	0.00000
Nocardioides baekrokdamisoli	1804624	S	3	0	3	0.00000
Nocardioides sambongensis	2589074	S	3	0	3	0.00000
Nocardioides houyundeii	2045452	S	2	0	2	0.00000
Nocardioides mesophilus	433659	S	1	0	1	0.00000
Nocardioides euryhalodurans	2518370	S	1	0	1	0.00000
Nocardioides seonyuensis	2518371	S	1	0	1	0.00000
Aeromicrobium erythreum	2041	S	5	0	5	0.00000
Aeromicrobium sp. A1-2	2107713	S	4	0	4	0.00000
Aeromicrobium sp. zg-629	2663859	S	1	0	1	0.00000
Aeromicrobium yanjiei	2662028	S	4	0	4	0.00000
Aeromicrobium marinum	219314	S	1	0	1	0.00000
Aeromicrobium choanae	1736691	S	1	0	1	0.00000
Mumia sp. ZJ1417	2708082	S	3	0	3	0.00000
Micropruina glycogenica	75385	S	2	0	2	0.00000
Pimelobacter simplex	2045	S	1	0	1	0.00000
Friedmanniella luteola	546871	S	1	0	1	0.00000
Marmoricola scoriae	642780	S	1	0	1	0.00000
Kribbella flavida	182640	S	5	0	5	0.00000
Kribbella qitaiheensis	1544730	S	5	0	5	0.00000
Actinopolymorpha singaporensis	117157	S	4	0	4	0.00000
Rhodococcus sp. YL-1	1045808	S	9	27	36	0.00000
Rhodococcus sp. 008	1723645	S	8	30	38	0.00000
Rhodococcus sp. NJ-530	2490853	S	7	24	31	0.00000
Rhodococcus sp. P-2	2795031	S	5	0	5	0.00000
Rhodococcus sp. B7740	1564114	S	4	0	4	0.00000
Rhodococcus sp. PBTS 2	1653479	S	4	1	5	0.00000
Rhodococcus sp. WMMA185	679318	S	3	0	3	0.00000
Rhodococcus sp. AQ5-07	2054902	S	2	5	7	0.00000
Rhodococcus sp. BH4	1807790	S	2	7	9	0.00000
Rhodococcus sp. PBTS 1	1653478	S	1	0	1	0.00000
Rhodococcus sp. W8901	2742603	S	1	0	1	0.00000
Rhodococcus sp. ABRD24	2507582	S	1	0	1	0.00000
Rhodococcus sp. MTM3W5.2	1805827	S	1	0	1	0.00000
Rhodococcus sp. H-CA8f	1727214	S	1	3	4	0.00000
Rhodococcus sp. P1Y	1302308	S	1	0	1	0.00000
Rhodococcus erythropolis	1833	S	25	64	89	0.00000
Rhodococcus qingshengii	334542	S	18	67	85	0.00000
Rhodococcus fascians	1828	S	11	2	13	0.00000
Rhodococcus coprophilus	38310	S	6	0	6	0.00000
Rhodococcus ruber	1830	S	3	0	3	0.00000
Rhodococcus rhodochrous	1829	S	2	0	2	0.00000
Rhodococcus hoagii	43767	S	2	0	2	0.00000
Rhodococcus koreensis	99653	S	2	0	2	0.00000
Rhodococcus imtechensis	262776	S	2	5	7	0.00000
Rhodococcus triatomae	300028	S	2	0	2	0.00000
Rhodococcus opacus	37919	S	1	0	1	0.00000
Rhodococcus pyridinivorans	103816	S	1	2	3	0.00000
Nocardia asteroides	1824	S	12	2	14	0.00000
Nocardia brasiliensis	37326	S	7	0	7	0.00000
Nocardia mangyaensis	2213200	S	7	0	7	0.00000
Nocardia nova	37330	S	6	0	6	0.00000
Nocardia farcinica	37329	S	5	0	5	0.00000
Nocardia terpenica	455432	S	5	0	5	0.00000
Nocardia sp. CS682	1047172	S	4	0	4	0.00000
Nocardia sp. WCH-YHL-001	2755382	S	1	0	1	0.00000
Nocardia arthritidis	228602	S	3	0	3	0.00000
Nocardia cyriacigeorgica	135487	S	2	0	2	0.00000
Nocardia otitidiscaviarum	1823	S	1	0	1	0.00000
Nocardia seriolae	37332	S	1	0	1	0.00000
Nocardia wallacei	480035	S	1	0	1	0.00000
Mycolicibacterium sediminis	1286180	S	6	0	6	0.00000
Mycolicibacterium aubagnense	319707	S	5	0	5	0.00000
Mycolicibacterium goodii	134601	S	4	0	4	0.00000
Mycolicibacterium aurum	1791	S	4	0	4	0.00000
Mycolicibacterium chitae	1792	S	4	0	4	0.00000
Mycolicibacterium helvum	1534349	S	4	0	4	0.00000
Mycolicibacterium arabiense	1286181	S	4	0	4	0.00000
Mycolicibacterium boenickei	146017	S	4	11	15	0.00000
Mycolicibacterium tokaiense	39695	S	3	0	3	0.00000
Mycolicibacterium moriokaense	39691	S	3	0	3	0.00000
Mycolicibacterium duvalii	39688	S	3	0	3	0.00000
Mycolicibacterium rutilum	370526	S	2	0	2	0.00000
Mycolicibacterium frederiksbergense	117567	S	2	0	2	0.00000
Mycolicibacterium mageritense	53462	S	2	0	2	0.00000
Mycolicibacterium hassiacum	46351	S	2	0	2	0.00000
Mycolicibacterium parafortuitum	39692	S	2	0	2	0.00000
Mycolicibacterium phocaicum	319706	S	2	0	2	0.00000
Mycolicibacterium insubricum	444597	S	2	0	2	0.00000
Mycolicibacterium litorale	758802	S	2	0	2	0.00000
Mycolicibacterium chubuense	1800	S	2	0	2	0.00000
Mycolicibacterium smegmatis	1772	S	2	0	2	0.00000
Mycolicibacterium psychrotolerans	216929	S	1	0	1	0.00000
Mycolicibacterium mucogenicum	56689	S	1	0	1	0.00000
Mycolicibacterium celeriflavum	1249101	S	1	0	1	0.00000
Mycolicibacterium sarraceniae	1534348	S	1	0	1	0.00000
Mycolicibacterium sp. LJ126	2761578	S	1	0	1	0.00000
Mycolicibacterium alvei	67081	S	1	0	1	0.00000
Mycolicibacterium fortuitum	1766	S	1	0	1	0.00000
Mycolicibacterium poriferae	39694	S	1	0	1	0.00000
Mycolicibacterium fallax	1793	S	1	0	1	0.00000
Mycolicibacterium gadium	1794	S	1	0	1	0.00000
Mycolicibacterium rhodesiae	36814	S	1	0	1	0.00000
Mycolicibacterium pulveris	36813	S	1	0	1	0.00000
Mycolicibacterium confluentis	28047	S	1	0	1	0.00000
Mycobacterium intracellulare	1767	S	4	24	28	0.00000
Mycobacterium mantenii	560555	S	4	0	4	0.00000
Mycobacterium avium	1764	S	2	0	2	0.00000
Mycobacterium colombiense	339268	S	2	0	2	0.00000
Mycobacterium marseillense	701042	S	1	0	1	0.00000
Mycobacterium sp. YC-RL4	1682113	S	3	0	3	0.00000
Mycobacterium sp. MS1601	1936029	S	3	0	3	0.00000
Mycobacterium sp. EPa45	1545728	S	2	0	2	0.00000
Mycobacterium sp. JS623	212767	S	1	0	1	0.00000
Mycobacterium sp. ELW1	1547487	S	1	0	1	0.00000
Mycobacterium sp. QIA-37	1561223	S	1	1	2	0.00000
Mycobacterium sp. THAF192	2587868	S	1	0	1	0.00000
Mycobacterium sp. DL440	2675523	S	1	0	1	0.00000
Mycobacterium kansasii	1768	S	4	0	4	0.00000
Mycobacterium cookii	1775	S	4	0	4	0.00000
Mycobacterium stomatepiae	470076	S	2	0	2	0.00000
Mycobacterium heidelbergense	53376	S	1	0	1	0.00000
Mycobacterium parmense	185642	S	1	0	1	0.00000
Mycobacterium dioxanotrophicus	482462	S	4	0	4	0.00000
Mycobacterium leprae	1769	S	3	0	3	0.00000
Mycobacterium seoulense	386911	S	3	0	3	0.00000
Mycobacterium canettii	78331	S	1	2	3	0.00000
Mycobacterium conspicuum	44010	S	3	0	3	0.00000
Mycobacterium gordonae	1778	S	3	0	3	0.00000
Mycobacterium shinjukuense	398694	S	2	0	2	0.00000
Mycobacterium marinum	1781	S	2	0	2	0.00000
Mycobacterium xenopi	1789	S	2	0	2	0.00000
Mycobacterium noviomagense	459858	S	2	0	2	0.00000
Mycobacterium heckeshornense	110505	S	2	0	2	0.00000
Mycobacterium gallinarum	39689	S	2	0	2	0.00000
Mycobacterium ulcerans	1809	S	1	0	1	0.00000
Mycobacterium branderi	43348	S	1	0	1	0.00000
Mycobacterium riyadhense	486698	S	1	0	1	0.00000
Mycobacterium paraseoulense	590652	S	1	0	1	0.00000
Mycobacterium paragordonae	1389713	S	1	0	1	0.00000
Mycobacterium grossiae	1552759	S	1	0	1	0.00000
Mycobacterium haemophilum	29311	S	1	0	1	0.00000
Mycobacteroides abscessus	36809	S	8	0	8	0.00000
Mycobacteroides chelonae	1774	S	6	4	10	0.00000
Mycobacteroides immunogenum	83262	S	6	0	6	0.00000
[Mycobacterium] stephanolepidis	1520670	S	2	0	2	0.00000
Mycobacteroides salmoniphilum	404941	S	1	0	1	0.00000
Mycobacteroides saopaulense	1578165	S	1	0	1	0.00000
Mycolicibacter terrae	1788	S	4	0	4	0.00000
Mycolicibacter hiberniae	29314	S	1	0	1	0.00000
Mycolicibacter sinensis	875328	S	1	2	3	0.00000
Mycolicibacillus koreensis	1069220	S	1	0	1	0.00000
Corynebacterium sp. NML98-0116	702967	S	3	0	3	0.00000
Corynebacterium sp. zg-917	2763010	S	2	0	2	0.00000
Corynebacterium sp. 1864	2820399	S	1	0	1	0.00000
Corynebacterium sp. LMM-1652	2487892	S	1	0	1	0.00000
Corynebacterium sp. sy039	2599641	S	1	0	1	0.00000
Corynebacterium sp. zg-320	2768834	S	1	0	1	0.00000
Corynebacterium sp. 2019	2675218	S	1	0	1	0.00000
Corynebacterium sp. ZJ-599	2709394	S	1	0	1	0.00000
Corynebacterium terpenotabidum	89154	S	9	1	10	0.00000
Corynebacterium xerosis	1725	S	8	1	9	0.00000
Corynebacterium matruchotii	43768	S	6	0	6	0.00000
Corynebacterium tuberculostearicum	38304	S	6	2	8	0.00000
Corynebacterium kefirresidentii	1979527	S	5	2	7	0.00000
Corynebacterium sphenisci	191493	S	5	0	5	0.00000
Corynebacterium lactis	1231000	S	4	0	4	0.00000
Corynebacterium casei	160386	S	4	3	7	0.00000
Corynebacterium kroppenstedtii	161879	S	4	0	4	0.00000
Corynebacterium bovis	36808	S	4	0	4	0.00000
Corynebacterium yudongzhengii	2080740	S	4	0	4	0.00000
Corynebacterium macginleyi	38290	S	3	0	3	0.00000
Corynebacterium vitaeruminis	38305	S	3	0	3	0.00000
Corynebacterium jeikeium	38289	S	3	5	8	0.00000
Corynebacterium glaucum	187491	S	3	0	3	0.00000
Corynebacterium liangguodongii	2079535	S	2	0	2	0.00000
Corynebacterium aurimucosum	169292	S	2	0	2	0.00000
Corynebacterium glucuronolyticum	39791	S	2	0	2	0.00000
Corynebacterium variabile	1727	S	2	0	2	0.00000
Corynebacterium atypicum	191610	S	2	0	2	0.00000
Corynebacterium sanguinis	2594913	S	2	0	2	0.00000
Corynebacterium ulcerans	65058	S	2	0	2	0.00000
Corynebacterium testudinoris	136857	S	2	0	2	0.00000
Corynebacterium ureicelerivorans	401472	S	1	0	1	0.00000
Corynebacterium frankenforstense	1230998	S	1	0	1	0.00000
Corynebacterium simulans	146827	S	1	0	1	0.00000
Corynebacterium riegelii	156976	S	1	0	1	0.00000
Corynebacterium imitans	156978	S	1	0	1	0.00000
Corynebacterium provencense	1737425	S	1	0	1	0.00000
Corynebacterium stationis	1705	S	1	0	1	0.00000
Corynebacterium urealyticum	43771	S	1	0	1	0.00000
Corynebacterium ammoniagenes	1697	S	1	0	1	0.00000
Corynebacterium anserum	2684406	S	1	0	1	0.00000
Corynebacterium kutscheri	35755	S	1	0	1	0.00000
Corynebacterium mycetoides	38302	S	1	0	1	0.00000
Corynebacterium propinquum	43769	S	1	0	1	0.00000
Corynebacterium striatum	43770	S	1	0	1	0.00000
Corynebacterium segmentosum	43990	S	1	0	1	0.00000
Corynebacterium amycolatum	43765	S	1	8	9	0.00000
Gordonia bronchialis	2054	S	11	1	12	0.00000
Gordonia sp. KTR9	337191	S	3	0	3	0.00000
Gordonia sp. PDNC005	2811424	S	3	0	3	0.00000
Gordonia sp. HY186	2597659	S	2	0	2	0.00000
Gordonia sp. JH63	2698900	S	2	3	5	0.00000
Gordonia sp. YC-JH1	2059875	S	1	0	1	0.00000
Gordonia iterans	1004901	S	6	0	6	0.00000
Gordonia polyisoprenivorans	84595	S	5	0	5	0.00000
Gordonia terrae	2055	S	4	2	6	0.00000
Gordonia phthalatica	1136941	S	3	0	3	0.00000
Gordonia alkanivorans	84096	S	1	3	4	0.00000
Gordonia insulae	2420509	S	1	0	1	0.00000
Tsukamurella tyrosinosolvens	57704	S	16	2	18	0.00000
Tsukamurella paurometabola	2061	S	11	0	11	0.00000
Dietzia sp. oral taxon 368	712270	S	7	1	8	0.00000
Dietzia psychralcaliphila	139021	S	1	0	1	0.00000
Dietzia timorensis	499555	S	1	0	1	0.00000
Lawsonella clevelandensis	1528099	S	3	0	3	0.00000
Tomitella sp. HY172	2760083	S	2	0	2	0.00000
Segniliparus rotundus	286802	S	1	0	1	0.00000
Microbacterium sp. PM5	2014534	S	23	4	27	0.00000
Microbacterium sp. No. 7	1714373	S	6	1	7	0.00000
Microbacterium sp. BH-3-3-3	1906742	S	5	0	5	0.00000
Microbacterium sp. A18JL241	2782166	S	5	0	5	0.00000
Microbacterium sp. 4R-513	2567934	S	4	0	4	0.00000
Microbacterium sp. JZ31	1906274	S	4	0	4	0.00000
Microbacterium sp. 10M-3C3	2483401	S	4	1	5	0.00000
Microbacterium sp. RG1	2489212	S	3	0	3	0.00000
Microbacterium sp. A18JL200	2782167	S	3	1	4	0.00000
Microbacterium sp. Nx66	2766784	S	3	4	7	0.00000
Microbacterium sp. 1S1	2606451	S	2	1	3	0.00000
Microbacterium sp. Se63.02b	2709304	S	2	0	2	0.00000
Microbacterium sp. YJN-G	2763257	S	2	0	2	0.00000
Microbacterium sp. Y-01	2048898	S	2	1	3	0.00000
Microbacterium sp. TPU 3598	1938334	S	2	0	2	0.00000
Microbacterium sp. XT11	367477	S	2	0	2	0.00000
Microbacterium sp. WY121	2782168	S	1	0	1	0.00000
Microbacterium sp. HY82	2708079	S	1	0	1	0.00000
Microbacterium sp. NY27	2782169	S	1	0	1	0.00000
Microbacterium sp. ABRD_28	2268461	S	1	0	1	0.00000
Microbacterium sp. CGR1	1696072	S	1	5	6	0.00000
Microbacterium hominis	162426	S	9	3	12	0.00000
Microbacterium aurum	36805	S	7	2	9	0.00000
Microbacterium lemovicicum	1072463	S	7	1	8	0.00000
Microbacterium caowuchunii	2614638	S	4	0	4	0.00000
Microbacterium esteraromaticum	57043	S	3	0	3	0.00000
Microbacterium foliorum	104336	S	3	1	4	0.00000
Microbacterium wangchenii	2541726	S	3	1	4	0.00000
Microbacterium oleivorans	273677	S	3	0	3	0.00000
Microbacterium pygmaeum	370764	S	3	0	3	0.00000
Microbacterium lushaniae	2614639	S	2	0	2	0.00000
Microbacterium testaceum	2033	S	2	0	2	0.00000
Microbacterium sediminis	904291	S	2	1	3	0.00000
Microbacterium hydrocarbonoxydans	273678	S	2	0	2	0.00000
Microbacterium chocolatum	84292	S	2	0	2	0.00000
Microbacterium oxydans	82380	S	2	1	3	0.00000
Microbacterium oryzae	743009	S	1	0	1	0.00000
Microbacterium amylolyticum	936337	S	1	0	1	0.00000
Microbacterium endophyticum	1526412	S	1	0	1	0.00000
Microbacterium protaetiae	2509458	S	1	0	1	0.00000
Microbacterium schleiferi	69362	S	1	0	1	0.00000
Curtobacterium flaccumfaciens	2035	S	16	3	19	0.00000
Curtobacterium sp. Csp2	2495430	S	3	1	4	0.00000
Curtobacterium sp. BH-2-1-1	1905847	S	2	0	2	0.00000
Curtobacterium sp. YC1	2795488	S	2	0	2	0.00000
Curtobacterium pusillum	69373	S	1	0	1	0.00000
Rathayibacter sp. VKM Ac-2759	2609252	S	3	0	3	0.00000
Rathayibacter sp. VKM Ac-2801	2609255	S	3	0	3	0.00000
Rathayibacter sp. VKM Ac-2760	2609253	S	2	0	2	0.00000
Rathayibacter sp. VKM Ac-2805	2609258	S	2	1	3	0.00000
Rathayibacter sp. VKM Ac-2762	2609254	S	1	0	1	0.00000
Rathayibacter sp. VKM Ac-2804	2609257	S	1	0	1	0.00000
Rathayibacter festucae	110937	S	5	1	6	0.00000
Rathayibacter tritici	33888	S	1	0	1	0.00000
Rathayibacter iranicus	59737	S	1	0	1	0.00000
Rathayibacter toxicus	145458	S	1	0	1	0.00000
Rathayibacter tanaceti	1671680	S	1	0	1	0.00000
Leifsonia xyli	1575	S	10	0	10	0.00000
Leifsonia sp. 21MFCrub1.1	1798223	S	5	1	6	0.00000
Leifsonia sp. PS1209	2724914	S	3	0	3	0.00000
Leifsonia shinshuensis	150026	S	4	0	4	0.00000
Agromyces sp. G127AT	2781962	S	6	1	7	0.00000
Agromyces sp. KACC 19306	2592652	S	2	0	2	0.00000
Agromyces sp. LHK192	2498704	S	1	0	1	0.00000
Agromyces aureus	453304	S	4	0	4	0.00000
Agromyces protaetiae	2509455	S	3	0	3	0.00000
Agromyces flavus	589382	S	1	0	1	0.00000
Agromyces badenianii	2080742	S	1	0	1	0.00000
Protaetiibacter sp. SSC-01	2759943	S	6	0	6	0.00000
Protaetiibacter intestinalis	2419774	S	4	0	4	0.00000
Rhodoluna limnophila	232537	S	6	0	6	0.00000
Rhodoluna lacicola	529884	S	1	0	1	0.00000
Candidatus Aquiluna sp. UB-MaderosW2red	1855377	S	1	0	1	0.00000
Agrococcus jejuensis	399736	S	3	0	3	0.00000
Agrococcus sp. SGAir0287	2070347	S	3	0	3	0.00000
Agrococcus carbonis	684552	S	2	0	2	0.00000
Clavibacter michiganensis	28447	S	5	0	5	0.00000
Clavibacter sp. DM1	2768071	S	2	0	2	0.00000
Leucobacter coleopterorum	2714933	S	4	0	4	0.00000
Leucobacter muris	1935379	S	1	0	1	0.00000
Leucobacter sp. CX169	2813744	S	1	0	1	0.00000
Leucobacter viscericola	2714935	S	1	0	1	0.00000
Herbiconiux sp. SALV-R1	2735133	S	6	0	6	0.00000
Plantibacter sp. PA-3-X8	2480625	S	3	0	3	0.00000
Plantibacter sp. M259	2583822	S	1	0	1	0.00000
Salinibacterium hongtaonis	2079791	S	2	0	2	0.00000
Salinibacterium sp. UTAS2018	2508880	S	2	0	2	0.00000
Microcella alkaliphila	279828	S	4	0	4	0.00000
Humibacter sp. BT305	2282656	S	2	7	9	0.00000
Humibacter sp. WJ7-1	2599293	S	2	0	2	0.00000
Gryllotalpicola protaetiae	2419771	S	4	0	4	0.00000
Marisediminicola antarctica	674079	S	3	0	3	0.00000
Frondihabitans sp. 762G35	1446794	S	2	0	2	0.00000
Frondihabitans sp. PAMC 28766	1795630	S	1	0	1	0.00000
Glaciihabitans sp. INWT7	2596912	S	2	0	2	0.00000
Mycetocola zhujimingii	2079792	S	1	0	1	0.00000
Mycetocola sp. JXN-3	2116510	S	1	0	1	0.00000
Frigoribacterium sp. NBH87	2596916	S	1	0	1	0.00000
Microterricola viridarii	412690	S	1	0	1	0.00000
Diaminobutyricimonas sp. LJ205	2683590	S	1	0	1	0.00000
Lysinimonas sp. KACC 19322	2592654	S	1	0	1	0.00000
Cnuibacter physcomitrellae	1619308	S	1	3	4	0.00000
Agreia sp. COWG	2773266	S	1	0	1	0.00000
Arthrobacter sp. QXT-31	1357915	S	5	0	5	0.00000
Arthrobacter sp. PAMC 25486	1494608	S	4	0	4	0.00000
Arthrobacter sp. D5-1	1477518	S	4	1	5	0.00000
Arthrobacter sp. 24S4-2	2575374	S	4	0	4	0.00000
Arthrobacter sp. NEB 688	904039	S	4	0	4	0.00000
Arthrobacter sp. YC-RL1	1652545	S	3	0	3	0.00000
Arthrobacter sp. YN	2020486	S	3	0	3	0.00000
Arthrobacter sp. ZXY-2	1806905	S	1	9	10	0.00000
Arthrobacter sp. ERGS1:01	1704044	S	1	0	1	0.00000
Arthrobacter sp. PM3	2017685	S	1	0	1	0.00000
Arthrobacter sp. PAMC25564	2565366	S	1	0	1	0.00000
Arthrobacter alpinus	656366	S	7	0	7	0.00000
Arthrobacter crystallopoietes	37928	S	4	0	4	0.00000
Arthrobacter citreus	1670	S	3	0	3	0.00000
Arthrobacter agilis	37921	S	3	0	3	0.00000
Arthrobacter dokdonellae	2211210	S	3	0	3	0.00000
Arthrobacter woluwensis	156980	S	1	0	1	0.00000
Paenarthrobacter sp. YJN-D	2735317	S	40	8	48	0.00000
Paenarthrobacter ureafaciens	37931	S	4	4	8	0.00000
Paenarthrobacter aurescens	43663	S	2	2	4	0.00000
Kocuria rhizophila	72000	S	15	6	21	0.00000
Kocuria palustris	71999	S	9	1	10	0.00000
Kocuria flava	446860	S	5	0	5	0.00000
Kocuria sp. TGY1120_3	2711329	S	2	0	2	0.00000
Kocuria sp. KD4	2719588	S	1	0	1	0.00000
Kocuria varians	1272	S	2	0	2	0.00000
Kocuria rosea	1275	S	1	0	1	0.00000
Kocuria turfanensis	388357	S	1	0	1	0.00000
Rothia terrae	396015	S	9	4	13	0.00000
Rothia mucilaginosa	43675	S	5	0	5	0.00000
Rothia dentocariosa	2047	S	3	0	3	0.00000
Rothia aeria	172042	S	3	0	3	0.00000
Rothia kristinae	37923	S	2	0	2	0.00000
Rothia nasimurium	85336	S	2	0	2	0.00000
Rothia amarae	169480	S	1	0	1	0.00000
Micrococcus luteus	1270	S	9	5	14	0.00000
Micrococcus sp. KBS0714	1179670	S	3	12	15	0.00000
Pseudarthrobacter sp. YJ56	2697569	S	4	0	4	0.00000
Pseudarthrobacter sp. BIM B-2242	2772401	S	3	0	3	0.00000
Pseudarthrobacter sp. NBSH8	2596911	S	2	0	2	0.00000
Pseudarthrobacter sulfonivorans	121292	S	3	0	3	0.00000
Pseudarthrobacter phenanthrenivorans	361575	S	2	0	2	0.00000
Pseudarthrobacter equi	728066	S	2	0	2	0.00000
Pseudarthrobacter chlorophenolicus	85085	S	1	0	1	0.00000
Glutamicibacter arilaitensis	256701	S	7	1	8	0.00000
Glutamicibacter nicotianae	37929	S	2	1	3	0.00000
Glutamicibacter creatinolyticus	162496	S	1	0	1	0.00000
Citricoccus sp. SGAir0253	2567881	S	2	0	2	0.00000
Sinomonas atrocyanea	37927	S	1	0	1	0.00000
Sinomonas sp. R1AF57	2020377	S	1	0	1	0.00000
Zhihengliuella sp. ISTPL4	2058657	S	1	1	2	0.00000
Dermacoccus nishinomiyaensis	1274	S	70	9	79	0.00000
Dermacoccus sp. PAMC28757	2762331	S	2	0	2	0.00000
Luteipulveratus mongoliensis	571913	S	5	0	5	0.00000
Cellulosimicrobium sp. 72-3	2731680	S	3	1	4	0.00000
Cellulosimicrobium sp. TH-20	1980001	S	2	1	3	0.00000
Cellulosimicrobium sp. BI34T	2587808	S	2	0	2	0.00000
Isoptericola dokdonensis	372663	S	4	0	4	0.00000
Isoptericola variabilis	139208	S	2	0	2	0.00000
Xylanimonas cellulosilytica	186189	S	3	0	3	0.00000
Xylanimonas allomyrinae	2509459	S	1	0	1	0.00000
Xylanimicrobium sp. FW10M-9	2509457	S	3	1	4	0.00000
Janibacter limosus	53458	S	5	0	5	0.00000
Janibacter melonis	262209	S	4	0	4	0.00000
Janibacter indicus	857417	S	1	1	2	0.00000
Janibacter sp. YB324	2761047	S	1	1	2	0.00000
Phycicoccus endophyticus	1690220	S	3	0	3	0.00000
Phycicoccus sp. HDW14	2714941	S	3	0	3	0.00000
Pedococcus dokdonensis	443156	S	2	0	2	0.00000
Cellulomonas sp. PSBB021	2003551	S	2	0	2	0.00000
Cellulomonas sp. H30R-01	2704467	S	2	0	2	0.00000
Cellulomonas sp. Y8	2591145	S	1	0	1	0.00000
Cellulomonas sp. JZ18	2654191	S	1	0	1	0.00000
Cellulomonas fimi	1708	S	2	0	2	0.00000
Cellulomonas flavigena	1711	S	1	0	1	0.00000
Cellulomonas taurus	2729175	S	1	0	1	0.00000
Pseudactinotalea sp. HY158	2654547	S	5	0	5	0.00000
Oerskovia sp. KBS0722	1179673	S	3	0	3	0.00000
Actinotalea sp. JY-7876	2758442	S	2	0	2	0.00000
Ornithinimicrobium sp. HY006	2508882	S	5	0	5	0.00000
Ornithinimicrobium sp. AMA3305	2283195	S	3	0	3	0.00000
Ornithinimicrobium pratense	2593973	S	4	0	4	0.00000
Serinicoccus marinus	247333	S	4	0	4	0.00000
Serinicoccus profundi	1078471	S	3	0	3	0.00000
Serinicoccus chungangensis	767452	S	1	0	1	0.00000
Brevibacterium sp. CS2	2575923	S	5	0	5	0.00000
Brevibacterium sp. YB235	1496080	S	2	1	3	0.00000
Brevibacterium sp. PAMC23299	2762330	S	1	6	7	0.00000
Brevibacterium casei	33889	S	4	0	4	0.00000
Brevibacterium luteolum	199591	S	2	0	2	0.00000
Brevibacterium aurantiacum	273384	S	1	0	1	0.00000
Brevibacterium sandarakinum	629680	S	1	0	1	0.00000
Brachybacterium faecium	43669	S	4	0	4	0.00000
Brachybacterium saurashtrense	556288	S	3	0	3	0.00000
Brachybacterium vulturis	2017484	S	3	0	3	0.00000
Brachybacterium avium	2017485	S	2	0	2	0.00000
Brachybacterium ginsengisoli	1331682	S	1	0	1	0.00000
Dermabacter jinjuensis	1667168	S	1	0	1	0.00000
Beutenbergia cavernae	84757	S	3	0	3	0.00000
Miniimonas sp. S16	2171623	S	3	0	3	0.00000
Georgenia faecalis	2483799	S	3	0	3	0.00000
Georgenia sp. Z294	2585135	S	1	0	1	0.00000
Haloactinobacterium sp. RN3S43	2779775	S	2	0	2	0.00000
Ruania sp. HY168	2603206	S	1	0	1	0.00000
Haloactinobacterium sp. HY164	2675754	S	1	0	1	0.00000
Sanguibacter keddieii	60920	S	1	0	1	0.00000
Sanguibacter sp. HDW7	2714931	S	1	0	1	0.00000
Kytococcus sedentarius	1276	S	2	0	2	0.00000
Austwickia chelonae	100225	S	1	0	1	0.00000
Streptomyces sp. SN-593	659352	S	7	0	7	0.00000
Streptomyces sp. SYP-A7193	2662065	S	6	2	8	0.00000
Streptomyces sp. TLI_053	1855352	S	6	0	6	0.00000
Streptomyces sp. MBT27	1488356	S	5	0	5	0.00000
Streptomyces sp. CRXT-Y-14	2768069	S	4	0	4	0.00000
Streptomyces sp. NHF165	2175864	S	4	0	4	0.00000
Streptomyces sp. PBH53	1577075	S	4	0	4	0.00000
Streptomyces sp. NEAU-sy36	2751189	S	4	0	4	0.00000
Streptomyces sp. CRXT-G-22	2768066	S	4	0	4	0.00000
Streptomyces sp. W1SF4	2305220	S	4	0	4	0.00000
Streptomyces sp. CMB-StM0423	2059884	S	3	1	4	0.00000
Streptomyces sp. RPA4-2	2721244	S	3	0	3	0.00000
Streptomyces sp. JB150	2714844	S	3	0	3	0.00000
Streptomyces sp. QMT-12	2717324	S	3	0	3	0.00000
Streptomyces sp. WAC 01438	2203204	S	3	0	3	0.00000
Streptomyces sp. 2323.1	1938841	S	3	0	3	0.00000
Streptomyces sp. SCSIO 3032	1264596	S	3	0	3	0.00000
Streptomyces sp. 3214.6	1882757	S	3	0	3	0.00000
Streptomyces sp. M2	646637	S	3	0	3	0.00000
Streptomyces sp. CB00271	2750025	S	3	0	3	0.00000
Streptomyces sp. ZYC-3	2797636	S	3	0	3	0.00000
Streptomyces sp. RTd22	1841249	S	3	1	4	0.00000
Streptomyces sp. So13.3	2136173	S	3	0	3	0.00000
Streptomyces sp. HM190	2695266	S	2	0	2	0.00000
Streptomyces sp. Tue 6075	1661694	S	2	0	2	0.00000
Streptomyces sp. SM18	1736046	S	2	0	2	0.00000
Streptomyces sp. WAC 01529	2203205	S	2	0	2	0.00000
Streptomyces sp. GS7	2692234	S	2	0	2	0.00000
Streptomyces sp. DSM 40868	2721173	S	2	0	2	0.00000
Streptomyces sp. SAT1	1849967	S	2	0	2	0.00000
Streptomyces sp. ID38640	1265399	S	2	0	2	0.00000
Streptomyces sp. TN58	234612	S	2	0	2	0.00000
Streptomyces sp. CB01881	2078691	S	2	0	2	0.00000
Streptomyces sp. SUK 48	2582831	S	2	0	2	0.00000
Streptomyces sp. Rer75	2750011	S	2	0	2	0.00000
Streptomyces sp. HSG2	2797167	S	2	0	2	0.00000
Streptomyces sp. CRPJ-33	2768068	S	2	0	2	0.00000
Streptomyces sp. INR7	2607753	S	2	0	2	0.00000
Streptomyces sp. YIM 121038	2136401	S	1	0	1	0.00000
Streptomyces sp. QHH-9511	2684468	S	1	0	1	0.00000
Streptomyces sp. HF10	2692233	S	1	0	1	0.00000
Streptomyces sp. P3	2135430	S	1	0	1	0.00000
Streptomyces sp. SGAir0924	2109593	S	1	3	4	0.00000
Streptomyces sp. SCUT-3	2684469	S	1	0	1	0.00000
Streptomyces sp. endophyte_N2	2153485	S	1	0	1	0.00000
Streptomyces sp. CB09001	2083284	S	1	0	1	0.00000
Streptomyces sp. CLI2509	1984801	S	1	5	6	0.00000
Streptomyces sp. Sge12	1972846	S	1	1	2	0.00000
Streptomyces sp. CdTB01	1725411	S	1	0	1	0.00000
Streptomyces sp. CFMR 7	1649184	S	1	0	1	0.00000
Streptomyces sp. CCM_MD2014	1561022	S	1	0	1	0.00000
Streptomyces sp. S8	1837283	S	1	0	1	0.00000
Streptomyces sp. RLB1-33	2721243	S	1	0	1	0.00000
Streptomyces sp. XC 2026	2782004	S	1	0	1	0.00000
Streptomyces sp. AgN23	1188315	S	1	0	1	0.00000
Streptomyces sp. C8S0	2585716	S	1	0	1	0.00000
Streptomyces sp. Mg1	465541	S	1	0	1	0.00000
Streptomyces sp. SirexAA-E	862751	S	1	0	1	0.00000
Streptomyces sp. NA04227	2742136	S	1	0	1	0.00000
Streptomyces sp. NA02950	2742137	S	1	0	1	0.00000
Streptomyces lividans	1916	S	20	114	134	0.00000
Streptomyces venezuelae	54571	S	15	1	16	0.00000
Streptomyces cattleya	29303	S	8	0	8	0.00000
Streptomyces griseorubiginosus	67304	S	7	0	7	0.00000
Streptomyces tsukubensis	83656	S	7	0	7	0.00000
Streptomyces fagopyri	2662397	S	6	0	6	0.00000
Streptomyces vietnamensis	362257	S	6	0	6	0.00000
Streptomyces lunaelactis	1535768	S	6	0	6	0.00000
Streptomyces albus	1888	S	5	0	5	0.00000
Streptomyces nodosus	40318	S	5	0	5	0.00000
Streptomyces griseochromogenes	68214	S	5	0	5	0.00000
Streptomyces griseus	1911	S	3	1	4	0.00000
Streptomyces globisporus	1908	S	1	0	1	0.00000
Streptomyces hygroscopicus	1912	S	5	1	6	0.00000
Streptomyces antibioticus	1890	S	5	0	5	0.00000
Streptomyces gilvosporeus	553510	S	4	0	4	0.00000
Streptomyces atratus	1893	S	4	0	4	0.00000
Streptomyces seoulensis	73044	S	4	0	4	0.00000
Streptomyces cacaoi	1898	S	4	0	4	0.00000
Streptomyces ficellus	1977088	S	4	0	4	0.00000
Streptomyces alboflavus	67267	S	4	0	4	0.00000
Streptomyces niveus	193462	S	4	0	4	0.00000
Streptomyces broussonetiae	2686304	S	4	0	4	0.00000
Streptomyces albireticuli	1940	S	4	0	4	0.00000
Streptomyces nojiriensis	66374	S	4	0	4	0.00000
Streptomyces incarnatus	665007	S	4	0	4	0.00000
Streptomyces rapamycinicus	1226757	S	4	0	4	0.00000
Streptomyces griseoviridis	45398	S	4	0	4	0.00000
Streptomyces lydicus	47763	S	4	0	4	0.00000
Streptomyces armeniacus	83291	S	3	0	3	0.00000
Streptomyces aureoverticillatus	66871	S	3	0	3	0.00000
Streptomyces buecherae	2763006	S	3	0	3	0.00000
Streptomyces spectabilis	68270	S	3	0	3	0.00000
Streptomyces violaceusniger	68280	S	3	0	3	0.00000
Streptomyces phaeolivaceus	2653200	S	3	0	3	0.00000
Streptomyces davaonensis	348043	S	3	0	3	0.00000
Streptomyces cyaneochromogenes	2496836	S	3	0	3	0.00000
Streptomyces paludis	2282738	S	3	0	3	0.00000
Streptomyces harbinensis	1176198	S	3	0	3	0.00000
Streptomyces pluripotens	1355015	S	3	0	3	0.00000
Streptomyces capitiformicae	2014920	S	3	0	3	0.00000
Streptomyces clavuligerus	1901	S	3	0	3	0.00000
Streptomyces exfoliatus	1905	S	3	0	3	0.00000
Streptomyces chartreusis	1969	S	3	0	3	0.00000
Streptomyces kanamyceticus	1967	S	3	0	3	0.00000
Streptomyces tendae	1932	S	3	0	3	0.00000
Streptomyces leeuwenhoekii	1437453	S	2	0	2	0.00000
Streptomyces glomeroaurantiacus	68210	S	2	0	2	0.00000
Streptomyces mobaraensis	35621	S	2	0	2	0.00000
Streptomyces galilaeus	33899	S	2	0	2	0.00000
Streptomyces nitrosporeus	28894	S	2	0	2	0.00000
Streptomyces alboniger	132473	S	2	0	2	0.00000
Streptomyces vinaceus	1960	S	2	0	2	0.00000
Streptomyces rimosus	1927	S	2	0	2	0.00000
Streptomyces ferrugineus	1413221	S	2	0	2	0.00000
Streptomyces viridifaciens	48665	S	2	4	6	0.00000
Streptomyces albidoflavus	1886	S	1	0	1	0.00000
Streptomyces sampsonii	42239	S	1	1	2	0.00000
Streptomyces formicae	1616117	S	2	0	2	0.00000
Streptomyces lincolnensis	1915	S	2	0	2	0.00000
Streptomyces lavendulae	1914	S	2	0	2	0.00000
Streptomyces tirandamycinicus	2174846	S	2	0	2	0.00000
Streptomyces cadmiisoli	2184053	S	2	0	2	0.00000
Streptomyces glaucescens	1907	S	2	0	2	0.00000
Streptomyces ambofaciens	1889	S	2	0	2	0.00000
Streptomyces actuosus	1885	S	2	0	2	0.00000
Streptomyces collinus	42684	S	2	0	2	0.00000
Streptomyces gardneri	66892	S	2	0	2	0.00000
Streptomyces globosus	68209	S	2	0	2	0.00000
Streptomyces hawaiiensis	67305	S	2	0	2	0.00000
Streptomyces subrutilus	36818	S	2	0	2	0.00000
Streptomyces alfalfae	1642299	S	1	1	2	0.00000
Streptomyces roseochromogenus	285450	S	1	0	1	0.00000
Streptomyces rubrolavendulae	285473	S	1	0	1	0.00000
Streptomyces asterosporus	285570	S	1	0	1	0.00000
Streptomyces xiamenensis	408015	S	1	0	1	0.00000
Streptomyces hundungensis	1077946	S	1	0	1	0.00000
Streptomyces pristinaespiralis	38300	S	1	0	1	0.00000
Streptomyces cavourensis	67258	S	1	0	1	0.00000
Streptomyces violaceoruber	1935	S	1	0	1	0.00000
Streptomyces spongiicola	1690221	S	1	0	1	0.00000
Streptomyces qaidamensis	1783515	S	1	0	1	0.00000
Streptomyces nigra	1827580	S	1	0	1	0.00000
Streptomyces fodineus	1904616	S	1	0	1	0.00000
Streptomyces aquilus	2548456	S	1	0	1	0.00000
Streptomyces griseocarneus	51201	S	1	0	1	0.00000
Streptomyces bathyalis	2710756	S	1	0	1	0.00000
Streptomyces olivaceus	47716	S	1	0	1	0.00000
Streptomyces albulus	68570	S	1	0	1	0.00000
Streptomyces fulvissimus	68202	S	1	0	1	0.00000
Streptomyces parvulus	146923	S	1	0	1	0.00000
Streptomyces autolyticus	75293	S	1	0	1	0.00000
Streptomyces koyangensis	188770	S	1	0	1	0.00000
Streptomyces murinus	33900	S	1	0	1	0.00000
Streptomyces avermitilis	33903	S	1	0	1	0.00000
Streptomyces antimycoticus	68175	S	1	0	1	0.00000
Streptomyces noursei	1971	S	1	0	1	0.00000
Kitasatospora setae	2066	S	5	0	5	0.00000
Kitasatospora sp. MMS16-BH015	2018025	S	3	0	3	0.00000
Kitasatospora sp. NA04385	2742135	S	1	0	1	0.00000
Kitasatospora albolonga	68173	S	3	0	3	0.00000
Streptacidiphilus sp. PB12-B1b	2705012	S	6	0	6	0.00000
Streptacidiphilus sp. P02-A3a	2704468	S	4	0	4	0.00000
Streptacidiphilus bronchialis	2126346	S	1	0	1	0.00000
Micromonospora sp. WMMA2032	2039870	S	7	2	9	0.00000
Micromonospora sp. B006	2201999	S	5	2	7	0.00000
Micromonospora sp. 28ISP2-46	2749844	S	5	1	6	0.00000
Micromonospora sp. HM134	2583243	S	2	0	2	0.00000
Micromonospora sp. WMMC415	2675222	S	1	0	1	0.00000
Micromonospora echinofusca	47858	S	7	1	8	0.00000
Micromonospora narathiwatensis	299146	S	7	1	8	0.00000
Micromonospora chokoriensis	356851	S	6	1	7	0.00000
Micromonospora echinaurantiaca	47857	S	5	1	6	0.00000
Micromonospora echinospora	1877	S	5	0	5	0.00000
Micromonospora carbonacea	47853	S	3	0	3	0.00000
Micromonospora coxensis	356852	S	3	0	3	0.00000
Micromonospora sagamiensis	47875	S	3	0	3	0.00000
Micromonospora krabiensis	307121	S	3	0	3	0.00000
Micromonospora rifamycinica	291594	S	2	0	2	0.00000
Micromonospora maris	1003110	S	2	0	2	0.00000
Micromonospora tulbaghiae	479978	S	2	2	4	0.00000
Micromonospora siamensis	299152	S	2	0	2	0.00000
Micromonospora auratinigra	261654	S	2	0	2	0.00000
Micromonospora viridifaciens	1881	S	2	0	2	0.00000
Micromonospora inositola	47865	S	1	0	1	0.00000
Micromonospora craniellae	2294034	S	1	0	1	0.00000
Actinoplanes teichomyceticus	1867	S	11	1	12	0.00000
Actinoplanes sp. N902-109	649831	S	8	0	8	0.00000
Actinoplanes sp. OR16	946334	S	3	0	3	0.00000
Actinoplanes missouriensis	1866	S	6	0	6	0.00000
Actinoplanes derwentensis	113562	S	4	0	4	0.00000
Plantactinospora sp. KBS50	2024580	S	3	0	3	0.00000
Plantactinospora sp. BC1	2108470	S	1	4	5	0.00000
Phytohabitans suffuscus	624315	S	4	0	4	0.00000
Phytohabitans flavus	1076124	S	4	0	4	0.00000
Verrucosispora sp. NA02020	2742132	S	2	0	2	0.00000
Actinocatenispora thailandica	227318	S	2	0	2	0.00000
Salinispora tropica	168695	S	1	0	1	0.00000
Amycolatopsis sp. AA4	1896961	S	7	0	7	0.00000
Amycolatopsis sp. YIM 10	2653857	S	7	1	8	0.00000
Amycolatopsis sp. Hca4	2742131	S	5	1	6	0.00000
Amycolatopsis sp. FDAARGOS 1241	2778070	S	5	0	5	0.00000
Amycolatopsis sp. BJA-103	1911175	S	2	0	2	0.00000
Amycolatopsis mediterranei	33910	S	8	0	8	0.00000
Amycolatopsis orientalis	31958	S	2	0	2	0.00000
Amycolatopsis albispora	1804986	S	2	0	2	0.00000
Amycolatopsis methanolica	1814	S	1	0	1	0.00000
Pseudonocardia sp. AL041005-10	445576	S	12	2	14	0.00000
Pseudonocardia sp. HH130630-07	1690815	S	5	2	7	0.00000
Pseudonocardia sp. CGMCC 4.1532	2761535	S	3	0	3	0.00000
Pseudonocardia sp. HH130629-09	1641402	S	1	0	1	0.00000
Pseudonocardia dioxanivorans	240495	S	9	0	9	0.00000
Pseudonocardia broussonetiae	2736640	S	5	0	5	0.00000
Saccharopolyspora erythraea	1836	S	3	0	3	0.00000
Saccharopolyspora coralli	2665642	S	2	0	2	0.00000
Saccharopolyspora spinosa	60894	S	1	0	1	0.00000
Saccharopolyspora pogona	333966	S	1	2	3	0.00000
Saccharopolyspora sp. ASAGF58	2719023	S	1	2	3	0.00000
Saccharothrix sp. 6-C	2781735	S	6	0	6	0.00000
Saccharothrix syringae	103733	S	4	0	4	0.00000
Saccharothrix espanaensis	103731	S	2	0	2	0.00000
Saccharomonospora marina	632569	S	5	0	5	0.00000
Saccharomonospora azurea	40988	S	3	0	3	0.00000
Saccharomonospora glauca	40990	S	1	0	1	0.00000
Kibdelosporangium phytohabitans	860235	S	5	0	5	0.00000
Actinoalloteichus hymeniacidonis	340345	S	1	0	1	0.00000
Actinoalloteichus hoggarensis	1470176	S	1	1	2	0.00000
Alloactinosynnema sp. L-07	1653480	S	4	0	4	0.00000
Allokutzneria albata	211114	S	4	0	4	0.00000
Actinosynnema pretiosum	42197	S	2	1	3	0.00000
Kutzneria albida	43357	S	2	0	2	0.00000
Prauserella marina	530584	S	2	0	2	0.00000
Lentzea guizhouensis	1586287	S	2	0	2	0.00000
Actinomyces sp. zg-993	2763540	S	3	0	3	0.00000
Actinomyces sp. oral taxon 171	706438	S	2	0	2	0.00000
Actinomyces sp. oral taxon 169	712116	S	2	2	4	0.00000
Actinomyces sp. Chiba101	1851395	S	2	0	2	0.00000
Actinomyces sp. Z16	2079536	S	2	0	2	0.00000
Actinomyces sp. oral taxon 414	712122	S	1	0	1	0.00000
Actinomyces sp. ZJ34	2722820	S	1	0	1	0.00000
Actinomyces sp. HMT 175	2789425	S	1	2	3	0.00000
Actinomyces howellii	52771	S	2	0	2	0.00000
Actinomyces oris	544580	S	2	2	4	0.00000
Actinomyces wuliandei	2057743	S	2	0	2	0.00000
Actinomyces qiguomingii	2057800	S	2	0	2	0.00000
Actinomyces naeslundii	1655	S	1	0	1	0.00000
Actinomyces viscosus	1656	S	1	0	1	0.00000
Actinomyces radicidentis	111015	S	1	0	1	0.00000
Actinomyces gaoshouyii	1960083	S	1	0	1	0.00000
Actinomyces procaprae	2560010	S	1	0	1	0.00000
Schaalia odontolytica	1660	S	4	0	4	0.00000
Schaalia sp. ZJ405	2709403	S	1	0	1	0.00000
Pauljensenia hongkongensis	178339	S	4	0	4	0.00000
Flaviflexus sp. H23T48	2496867	S	2	0	2	0.00000
Flaviflexus salsibiostraticola	1282737	S	1	0	1	0.00000
Actinomadura sp. WMMA1423	2591108	S	7	0	7	0.00000
Actinomadura sp. WMMB 499	1219491	S	4	0	4	0.00000
Actinomadura verrucosospora	46165	S	5	1	6	0.00000
Streptosporangium roseum	2001	S	5	0	5	0.00000
Streptosporangium sp. 'caverna'	2202249	S	1	0	1	0.00000
Nonomuraea sp. ATCC 55076	1909395	S	4	0	4	0.00000
Thermobispora bispora	2006	S	2	0	2	0.00000
Thermobifida fusca	2021	S	5	0	5	0.00000
Nocardiopsis dassonvillei	2014	S	3	0	3	0.00000
Nocardiopsis gilva	280236	S	1	0	1	0.00000
Streptomonospora sp. M2	2498135	S	1	0	1	0.00000
Bifidobacterium longum	216816	S	4	0	4	0.00000
Bifidobacterium bifidum	1681	S	2	0	2	0.00000
Bifidobacterium adolescentis	1680	S	2	0	2	0.00000
Bifidobacterium eulemuris	1765219	S	2	0	2	0.00000
Bifidobacterium animalis	28025	S	2	0	2	0.00000
Bifidobacterium scardovii	158787	S	2	0	2	0.00000
Bifidobacterium indicum	1691	S	1	0	1	0.00000
Bifidobacterium pseudolongum	1694	S	1	0	1	0.00000
Bifidobacterium pseudocatenulatum	28026	S	1	0	1	0.00000
Gardnerella vaginalis	2702	S	7	1	8	0.00000
Gardnerella leopoldii	2792978	S	1	0	1	0.00000
Candidatus Planktophila sulfonica	1884904	S	10	0	10	0.00000
Candidatus Planktophila lacus	1884913	S	2	0	2	0.00000
Candidatus Planktophila dulcis	1884914	S	2	0	2	0.00000
Candidatus Planktophila versatilis	1884905	S	1	0	1	0.00000
Candidatus Planktophila vernalis	1884907	S	1	0	1	0.00000
Candidatus Nanopelagicus abundans	1884916	S	1	0	1	0.00000
Frankia sp. EAN1pec	298653	S	3	0	3	0.00000
Frankia sp. QA3	710111	S	3	0	3	0.00000
Frankia inefficax	298654	S	5	0	5	0.00000
Frankia alni	1859	S	3	0	3	0.00000
Nakamurella multipartita	53461	S	4	0	4	0.00000
Nakamurella sp. PAMC28650	2762325	S	2	0	2	0.00000
Nakamurella sp. s14-144	1902245	S	1	0	1	0.00000
Nakamurella panacisegetis	1090615	S	2	0	2	0.00000
Catenulispora acidiphila	304895	S	7	0	7	0.00000
Geodermatophilus obscurus	1861	S	4	0	4	0.00000
Blastococcus saxobsidens	138336	S	1	0	1	0.00000
Jiangella alkaliphila	419479	S	3	0	3	0.00000
Jiangella sp. DSM 45060	1798224	S	1	0	1	0.00000
Epidermidibacterium keratini	1891644	S	2	0	2	0.00000
Kineococcus radiotolerans	131568	S	2	0	2	0.00000
Acidothermus cellulolyticus	28049	S	2	0	2	0.00000
Jatrophihabitans sp. GAS493	1907575	S	1	0	1	0.00000
Actinopolyspora erythraea	414996	S	1	0	1	0.00000
Stackebrandtia nassauensis	283811	S	1	0	1	0.00000
Eggerthella sp. YY7918	502558	S	3	0	3	0.00000
Eggerthella sp. HF-1101	2690837	S	1	0	1	0.00000
Eggerthella lenta	84112	S	1	0	1	0.00000
Slackia heliotrinireducens	84110	S	4	0	4	0.00000
Gordonibacter pamelaeae	471189	S	1	0	1	0.00000
Gordonibacter urolithinfaciens	1335613	S	1	0	1	0.00000
Adlercreutzia equolifaciens	446660	S	1	-1	0	0.00000
Adlercreutzia sp. 8CFCBH1	2707299	S	1	0	1	0.00000
Phoenicibacter congonensis	1944646	S	1	0	1	0.00000
Parolsenella massiliensis	1871022	S	1	0	1	0.00000
Parolsenella catena	2003188	S	1	0	1	0.00000
Olsenella uli	133926	S	1	0	1	0.00000
Ilumatobacter coccineus	467094	S	9	0	9	0.00000
Actinomarinicola tropica	2789776	S	7	0	7	0.00000
Rubrobacter radiotolerans	42256	S	5	0	5	0.00000
Rubrobacter sp. SCSIO 52909	2653851	S	2	0	2	0.00000
Rubrobacter sp. SCSIO 52915	2653852	S	1	0	1	0.00000
Rubrobacter indicoceani	2051957	S	2	0	2	0.00000
Rubrobacter xylanophilus	49319	S	1	0	1	0.00000
Baekduia soli	496014	S	3	0	3	0.00000
Conexibacter sp. SYSU D00693	2812560	S	4	0	4	0.00000
Conexibacter woesei	191495	S	3	0	3	0.00000
Euzebya sp. DY32-46	1608957	S	4	0	4	0.00000
Egibacter rhizosphaerae	1670831	S	1	0	1	0.00000
Bacillus cereus	1396	S	160	142	302	0.00000
Bacillus thuringiensis	1428	S	9	45	54	0.00000
Bacillus wiedmannii	1890302	S	3	0	3	0.00000
Bacillus pseudomycoides	64104	S	2	0	2	0.00000
Bacillus cytotoxicus	580165	S	2	0	2	0.00000
Bacillus luti	2026191	S	2	0	2	0.00000
Bacillus mycoides	1405	S	1	0	1	0.00000
Bacillus sp. PAMC26568	2760090	S	3	0	3	0.00000
Bacillus sp. Y1	352858	S	3	0	3	0.00000
Bacillus sp. S3	486398	S	3	0	3	0.00000
Bacillus sp. V3	2795526	S	2	0	2	0.00000
Bacillus sp. 1NLA3E	666686	S	2	0	2	0.00000
Bacillus sp. FJAT-42376	2014076	S	2	0	2	0.00000
Bacillus sp. OxB-1	98228	S	1	0	1	0.00000
Bacillus sp. DSL-17	2567941	S	1	0	1	0.00000
Bacillus sp. SYJ	2529386	S	1	0	1	0.00000
Bacillus sp. BD59S	2499213	S	1	0	1	0.00000
Bacillus sp. FJAT-45348	2011012	S	1	0	1	0.00000
Bacillus sp. HD4P25	2779776	S	1	0	1	0.00000
Bacillus subtilis	1423	S	3	2	5	0.00000
Bacillus velezensis	492670	S	2	3	5	0.00000
Bacillus atrophaeus	1452	S	1	0	1	0.00000
Bacillus sonorensis	119858	S	1	0	1	0.00000
Bacillus tequilensis	227866	S	1	0	1	0.00000
Bacillus vini	1476025	S	6	0	6	0.00000
Bacillus cellulosilyticus	1413	S	2	0	2	0.00000
Bacillus gobiensis	1441095	S	2	0	2	0.00000
Bacillus dafuensis	1742359	S	2	0	2	0.00000
Bacillus vietnamensis	218284	S	2	0	2	0.00000
Bacillus freudenreichii	1783501	S	1	0	1	0.00000
Bacillus ciccensis	1670641	S	1	0	1	0.00000
Bacillus circulans	1397	S	1	0	1	0.00000
Bacillus marisflavi	189381	S	1	0	1	0.00000
Priestia megaterium	1404	S	74	23	97	0.00000
Priestia filamentosa	1402861	S	3	0	3	0.00000
Priestia flexa	86664	S	2	0	2	0.00000
Lysinibacillus sp. SGAir0095	2070463	S	3	0	3	0.00000
Lysinibacillus sp. YS11	2072025	S	3	1	4	0.00000
Lysinibacillus sp. 2017	2169540	S	1	0	1	0.00000
Lysinibacillus sp. FJAT-51161	2590012	S	1	0	1	0.00000
Lysinibacillus timonensis	2086577	S	2	0	2	0.00000
Virgibacillus sp. SK37	403957	S	2	1	3	0.00000
Virgibacillus sp. Bac330	2419841	S	1	1	2	0.00000
Virgibacillus sp. MSP4-1	2700081	S	1	0	1	0.00000
Virgibacillus necropolis	163877	S	1	0	1	0.00000
Anoxybacillus caldiproteolyticus	247480	S	2	0	2	0.00000
Anoxybacillus flavithermus	33934	S	1	0	1	0.00000
Anoxybacillus kamchatkensis	196180	S	1	2	3	0.00000
Anoxybacillus amylolyticus	294699	S	1	0	1	0.00000
Oceanobacillus iheyensis	182710	S	3	0	3	0.00000
Oceanobacillus zhaokaii	2052660	S	2	0	2	0.00000
Oceanobacillus kimchii	746691	S	1	0	1	0.00000
Caldibacillus thermoamylovorans	35841	S	5	0	5	0.00000
Geobacillus sp. E263	391290	S	1	0	1	0.00000
Geobacillus sp. 46C-IIa	1963025	S	1	0	1	0.00000
Geobacillus subterraneus	129338	S	1	1	2	0.00000
Peribacillus butanolivorans	421767	S	2	0	2	0.00000
Peribacillus simplex	1478	S	1	0	1	0.00000
Peribacillus asahii	228899	S	1	0	1	0.00000
Neobacillus cucumis	1740721	S	3	0	3	0.00000
Neobacillus mesonae	1193713	S	1	0	1	0.00000
Alkalihalobacillus miscanthi	2598861	S	2	1	3	0.00000
Mesobacillus foraminis	279826	S	2	0	2	0.00000
Mesobacillus jeotgali	129985	S	1	0	1	0.00000
Amphibacillus xylanus	1449	S	3	0	3	0.00000
Weizmannia coagulans	1398	S	2	0	2	0.00000
Fictibacillus phosphorivorans	1221500	S	2	0	2	0.00000
Salicibibacter kimchii	2099786	S	2	0	2	0.00000
Anaerobacillus isosaccharinicus	1532552	S	2	0	2	0.00000
Paraliobacillus zengyii	2213194	S	2	0	2	0.00000
Aeribacillus pallidus	33936	S	1	0	1	0.00000
Lentibacillus amyloliquefaciens	1472767	S	1	0	1	0.00000
Pontibacillus sp. HMF3514	2692425	S	1	0	1	0.00000
Pradoshia sp. D12	2651284	S	1	0	1	0.00000
Parageobacillus genomosp. 1	1295642	S	1	0	1	0.00000
Sediminibacillus sp. DP4-553-S	2729421	S	1	0	1	0.00000
Staphylococcus epidermidis	1282	S	33	5	38	0.00000
Staphylococcus aureus	1280	S	19	32	51	0.00000
Staphylococcus capitis	29388	S	14	2	16	0.00000
Staphylococcus haemolyticus	1283	S	10	1	11	0.00000
Staphylococcus succinus	61015	S	7	0	7	0.00000
Staphylococcus saprophyticus	29385	S	6	0	6	0.00000
Staphylococcus cohnii	29382	S	6	1	7	0.00000
Staphylococcus hominis	1290	S	6	0	6	0.00000
Staphylococcus sp. 17KM0847	2583989	S	2	0	2	0.00000
Staphylococcus sp. SB1-57	2813777	S	1	4	5	0.00000
Staphylococcus saccharolyticus	33028	S	5	0	5	0.00000
Staphylococcus warneri	1292	S	4	1	5	0.00000
Staphylococcus equorum	246432	S	4	3	7	0.00000
Staphylococcus xylosus	1288	S	3	0	3	0.00000
Staphylococcus pasteuri	45972	S	3	0	3	0.00000
Staphylococcus auricularis	29379	S	3	0	3	0.00000
Staphylococcus debuckii	2044912	S	3	0	3	0.00000
Staphylococcus delphini	53344	S	1	0	1	0.00000
Staphylococcus pseudintermedius	283734	S	1	0	1	0.00000
Staphylococcus caprae	29380	S	1	0	1	0.00000
Staphylococcus lugdunensis	28035	S	1	0	1	0.00000
Staphylococcus pseudoxylosus	2282419	S	1	0	1	0.00000
Staphylococcus schleiferi	1295	S	1	0	1	0.00000
Staphylococcus hyicus	1284	S	1	0	1	0.00000
Staphylococcus lutrae	155085	S	1	0	1	0.00000
Staphylococcus pettenkoferi	170573	S	1	0	1	0.00000
Staphylococcus simulans	1286	S	1	0	1	0.00000
Mammaliicoccus lentus	42858	S	3	0	3	0.00000
Mammaliicoccus vitulinus	71237	S	2	0	2	0.00000
Mammaliicoccus fleurettii	150056	S	1	0	1	0.00000
Paenibacillus sp. UniB2	2726185	S	5	0	5	0.00000
Paenibacillus sp. FSL R7-0273	1536772	S	4	0	4	0.00000
Paenibacillus sp. TB2019	2810347	S	2	0	2	0.00000
Paenibacillus sp. B01	2660554	S	2	0	2	0.00000
Paenibacillus sp. FSL H7-0357	1536774	S	2	0	2	0.00000
Paenibacillus sp. FSL H7-0737	1536775	S	2	0	2	0.00000
Paenibacillus sp. JZ16	1906272	S	1	0	1	0.00000
Paenibacillus sp. E222	2748863	S	1	0	1	0.00000
Paenibacillus sp. URB8-2	2741301	S	1	0	1	0.00000
Paenibacillus sp. 37	2607911	S	1	0	1	0.00000
Paenibacillus sp. BIHB4019	1870819	S	1	0	1	0.00000
Paenibacillus sp. 32O-W	1695218	S	1	0	1	0.00000
Paenibacillus sp. Y412MC10	481743	S	1	0	1	0.00000
Paenibacillus sp. FSL R5-0345	1536770	S	1	0	1	0.00000
Paenibacillus lycopersici	2704462	S	5	0	5	0.00000
Paenibacillus cellulosilyticus	375489	S	3	0	3	0.00000
Paenibacillus glucanolyticus	59843	S	3	1	4	0.00000
Paenibacillus terrae	159743	S	3	0	3	0.00000
Paenibacillus rhizovicinus	2704463	S	2	0	2	0.00000
Paenibacillus physcomitrellae	1619311	S	2	0	2	0.00000
Paenibacillus crassostreae	1763538	S	2	0	2	0.00000
Paenibacillus chitinolyticus	79263	S	2	0	2	0.00000
Paenibacillus psychroresistens	1778678	S	2	0	2	0.00000
Paenibacillus polymyxa	1406	S	1	1	2	0.00000
Paenibacillus xylanexedens	528191	S	1	0	1	0.00000
Paenibacillus guangzhouensis	1473112	S	1	0	1	0.00000
Paenibacillus antarcticus	253703	S	1	0	1	0.00000
Paenibacillus kribbensis	172713	S	1	0	1	0.00000
Paenibacillus stellifer	169760	S	1	0	1	0.00000
Paenibacillus naphthalenovorans	162209	S	1	0	1	0.00000
Paenibacillus albus	2495582	S	1	0	1	0.00000
Paenibacillus mucilaginosus	61624	S	1	-1	0	0.00000
Paenibacillus protaetiae	2509456	S	1	0	1	0.00000
Paenibacillus larvae	1464	S	1	266	267	0.00000
Brevibacillus brevis	1393	S	6	0	6	0.00000
Brevibacillus sp. 7WMA2	2683193	S	3	1	4	0.00000
Brevibacillus sp. SCSIO 07484	2496837	S	1	0	1	0.00000
Brevibacillus laterosporus	1465	S	3	4	7	0.00000
Brevibacillus choshinensis	54911	S	1	0	1	0.00000
Brevibacillus formosus	54913	S	1	0	1	0.00000
Cohnella sp. LGH	1619153	S	3	0	3	0.00000
Cohnella sp. KS 22	2598458	S	1	0	1	0.00000
Cohnella sp. MFER-1	2728023	S	1	0	1	0.00000
Cohnella candidum	2674991	S	2	0	2	0.00000
Cohnella abietis	2507935	S	1	0	1	0.00000
Thermobacillus composti	377615	S	2	0	2	0.00000
Planococcus donghaensis	414778	S	2	0	2	0.00000
Planococcus versutus	1302659	S	2	0	2	0.00000
Planococcus antarcticus	161360	S	1	0	1	0.00000
Planococcus rifietoensis	200991	S	1	0	1	0.00000
Planococcus sp. MB-3u-03	2058136	S	1	0	1	0.00000
Sporosarcina ureae	1571	S	3	0	3	0.00000
Sporosarcina sp. P33	1930764	S	1	0	1	0.00000
Planomicrobium glaciei	459472	S	3	0	3	0.00000
Ureibacillus thermosphaericus	51173	S	1	0	1	0.00000
Ureibacillus thermophilus	367743	S	1	0	1	0.00000
Solibacillus silvestris	76853	S	2	0	2	0.00000
Jeotgalibacillus malaysiensis	1508404	S	1	0	1	0.00000
Paenisporosarcina antarctica	417367	S	1	0	1	0.00000
Alicyclobacillus acidocaldarius	405212	S	3	0	3	0.00000
Alicyclobacillus sp. SO9	2665646	S	2	0	2	0.00000
Tumebacillus algifaecis	1214604	S	1	1	2	0.00000
Listeria monocytogenes	1639	S	3	0	3	0.00000
Listeria innocua	1642	S	2	1	3	0.00000
Listeria ivanovii	1638	S	1	0	1	0.00000
Listeria seeligeri	1640	S	1	0	1	0.00000
Laceyella sacchari	37482	S	2	0	2	0.00000
Novibacillus thermophilus	1471761	S	2	0	2	0.00000
Kroppenstedtia pulmonis	1380685	S	1	0	1	0.00000
Staphylospora marina	2490858	S	1	0	1	0.00000
Gemella haemolysans	1379	S	1	0	1	0.00000
Gemella morbillorum	29391	S	1	0	1	0.00000
Gemella sanguinis	84135	S	1	0	1	0.00000
Sporolactobacillus terrae	269673	S	2	0	2	0.00000
Streptococcus thermophilus	1308	S	9	1	10	0.00000
Streptococcus gordonii	1302	S	6	0	6	0.00000
Streptococcus mitis	28037	S	6	2	8	0.00000
Streptococcus sanguinis	1305	S	4	0	4	0.00000
Streptococcus equi	1336	S	3	0	3	0.00000
Streptococcus oralis	1303	S	2	1	3	0.00000
Streptococcus parauberis	1348	S	2	0	2	0.00000
Streptococcus uberis	1349	S	2	0	2	0.00000
Streptococcus troglodytae	1111760	S	2	0	2	0.00000
Streptococcus mutans	1309	S	2	0	2	0.00000
Streptococcus salivarius	1304	S	2	2	4	0.00000
Streptococcus himalayensis	1888195	S	1	0	1	0.00000
Streptococcus marmotae	1825069	S	1	0	1	0.00000
Streptococcus halotolerans	1814128	S	1	0	1	0.00000
Streptococcus respiraculi	2021971	S	1	0	1	0.00000
Streptococcus anginosus	1328	S	1	1	2	0.00000
Streptococcus merionis	400065	S	1	0	1	0.00000
Streptococcus chenjunshii	2173853	S	1	0	1	0.00000
Streptococcus australis	113107	S	1	1	2	0.00000
Streptococcus cristatus	45634	S	1	0	1	0.00000
Streptococcus sp. oral taxon 064	712624	S	1	3	4	0.00000
Streptococcus suis	1307	S	1	0	1	0.00000
Streptococcus pneumoniae	1313	S	1	0	1	0.00000
Streptococcus pyogenes	1314	S	1	0	1	0.00000
Streptococcus parasanguinis	1318	S	1	0	1	0.00000
Lactococcus lactis	1358	S	24	7	31	0.00000
Lactococcus cremoris	1359	S	7	1	8	0.00000
Lactococcus garvieae	1363	S	5	1	6	0.00000
Lactococcus allomyrinae	2419773	S	1	0	1	0.00000
Lactobacillus amylovorus	1604	S	3	1	4	0.00000
Lactobacillus johnsonii	33959	S	3	0	3	0.00000
Lactobacillus helveticus	1587	S	2	0	2	0.00000
Lactobacillus terrae	2269374	S	2	0	2	0.00000
Lactobacillus amylolyticus	83683	S	2	0	2	0.00000
Lactobacillus iners	147802	S	1	0	1	0.00000
Lactobacillus sp. wkB8	1545702	S	1	0	1	0.00000
Lactobacillus kefiranofaciens	267818	S	1	0	1	0.00000
Lactobacillus acidophilus	1579	S	1	0	1	0.00000
Lactobacillus jensenii	109790	S	1	0	1	0.00000
Lactobacillus crispatus	47770	S	1	0	1	0.00000
Limosilactobacillus fermentum	1613	S	6	3	9	0.00000
Limosilactobacillus reuteri	1598	S	2	0	2	0.00000
Limosilactobacillus pontis	35787	S	1	0	1	0.00000
Limosilactobacillus mucosae	97478	S	1	0	1	0.00000
Ligilactobacillus agilis	1601	S	3	0	3	0.00000
Ligilactobacillus murinus	1622	S	3	0	3	0.00000
Ligilactobacillus salivarius	1624	S	3	0	3	0.00000
Leuconostoc carnosum	1252	S	2	0	2	0.00000
Leuconostoc mesenteroides	1245	S	1	0	1	0.00000
Leuconostoc pseudomesenteroides	33968	S	1	0	1	0.00000
Leuconostoc sp. LN180020	2571156	S	1	3	4	0.00000
Paucilactobacillus hokkaidonensis	1193095	S	8	1	9	0.00000
Weissella hellenica	46256	S	3	0	3	0.00000
Weissella paramesenteroides	1249	S	2	0	2	0.00000
Weissella soli	155866	S	2	0	2	0.00000
Lacticaseibacillus paracasei	1597	S	5	0	5	0.00000
Lacticaseibacillus rhamnosus	47715	S	1	0	1	0.00000
Loigolactobacillus coryniformis	1610	S	3	0	3	0.00000
Loigolactobacillus backii	375175	S	1	0	1	0.00000
Companilactobacillus crustorum	392416	S	2	0	2	0.00000
Companilactobacillus allii	1847728	S	1	0	1	0.00000
Companilactobacillus zhachilii	2304606	S	1	0	1	0.00000
Pediococcus pentosaceus	1255	S	1	0	1	0.00000
Pediococcus claussenii	187452	S	1	0	1	0.00000
Pediococcus acidilactici	1254	S	1	0	1	0.00000
Liquorilactobacillus mali	1618	S	2	0	2	0.00000
Liquorilactobacillus nagelii	82688	S	1	0	1	0.00000
Latilactobacillus sakei	1599	S	1	0	1	0.00000
Latilactobacillus curvatus	28038	S	1	0	1	0.00000
Lactiplantibacillus paraplantarum	60520	S	1	1	2	0.00000
Lentilactobacillus buchneri	1581	S	2	0	2	0.00000
Lapidilactobacillus dextrinicus	51664	S	1	0	1	0.00000
Apilactobacillus bombintestini	2419772	S	1	0	1	0.00000
Oenococcus sp. UCMA 16435	2259623	S	1	0	1	0.00000
Enterococcus faecalis	1351	S	8	1	9	0.00000
Enterococcus cecorum	44008	S	7	1	8	0.00000
Enterococcus faecium	1352	S	6	6	12	0.00000
Enterococcus mundtii	53346	S	3	0	3	0.00000
Enterococcus saigonensis	1805431	S	2	0	2	0.00000
Enterococcus hirae	1354	S	1	0	1	0.00000
Enterococcus avium	33945	S	1	0	1	0.00000
Enterococcus sp. CR-Ec1	2057791	S	1	2	3	0.00000
Vagococcus teuberi	519472	S	2	0	2	0.00000
Vagococcus penaei	633807	S	2	0	2	0.00000
Vagococcus zengguangii	2571750	S	1	0	1	0.00000
Tetragenococcus halophilus	51669	S	2	0	2	0.00000
Carnobacterium divergens	2748	S	2	0	2	0.00000
Carnobacterium maltaromaticum	2751	S	1	0	1	0.00000
Carnobacterium inhibens	147709	S	1	0	1	0.00000
Carnobacterium sp. 17-4	208596	S	1	0	1	0.00000
Jeotgalibaca porci	1868793	S	1	0	1	0.00000
Jeotgalibaca arthritidis	1868794	S	1	1	2	0.00000
Dolosigranulum pigrum	29394	S	1	0	1	0.00000
Aerococcus viridans	1377	S	1	0	1	0.00000
Aerococcus christensenii	87541	S	1	0	1	0.00000
Clostridium botulinum	1491	S	41	5	46	0.00000
Clostridium perfringens	1502	S	15	0	15	0.00000
Clostridium intestinale	36845	S	8	0	8	0.00000
Clostridium sp. JN-1	2483110	S	2	0	2	0.00000
Clostridium sp. 'deep sea'	2779445	S	2	0	2	0.00000
Clostridium sp. DL-VIII	641107	S	1	0	1	0.00000
Clostridium sp. BNL1100	755731	S	1	0	1	0.00000
Clostridium sp. JN-9	2507159	S	1	0	1	0.00000
Clostridium beijerinckii	1520	S	6	2	8	0.00000
Clostridium saccharoperbutylacetonicum	36745	S	6	0	6	0.00000
Clostridium novyi	1542	S	6	0	6	0.00000
Clostridium sporogenes	1509	S	5	6	11	0.00000
Clostridium acetobutylicum	1488	S	4	0	4	0.00000
Clostridium taeniosporum	394958	S	4	0	4	0.00000
Clostridium saccharobutylicum	169679	S	4	0	4	0.00000
Clostridium tetani	1513	S	4	0	4	0.00000
Clostridium butyricum	1492	S	3	0	3	0.00000
Clostridium isatidis	182773	S	3	0	3	0.00000
Clostridium gasigenes	94869	S	3	0	3	0.00000
Clostridium baratii	1561	S	3	0	3	0.00000
Clostridium cellulovorans	1493	S	3	0	3	0.00000
Clostridium formicaceticum	1497	S	3	0	3	0.00000
Clostridium tyrobutyricum	1519	S	3	0	3	0.00000
Clostridium kluyveri	1534	S	3	0	3	0.00000
Clostridium cochlearium	1494	S	2	0	2	0.00000
Clostridium septicum	1504	S	2	0	2	0.00000
Clostridium estertheticum	238834	S	2	0	2	0.00000
Clostridium drakei	332101	S	2	0	2	0.00000
Clostridium chauvoei	46867	S	1	0	1	0.00000
Clostridium aceticum	84022	S	1	0	1	0.00000
Clostridium autoethanogenum	84023	S	1	1	2	0.00000
Clostridium argentinense	29341	S	1	0	1	0.00000
Clostridium scatologenes	1548	S	1	0	1	0.00000
Clostridium pasteurianum	1501	S	1	0	1	0.00000
Clostridium bornimense	1216932	S	1	0	1	0.00000
Candidatus Arthromitus sp. SFB-rat-Yit	1041504	S	2	0	2	0.00000
Candidatus Arthromitus sp. SFB-mouse-NL	1508644	S	2	1	3	0.00000
Caloranaerobacter azorensis	116090	S	3	0	3	0.00000
Alkaliphilus metalliredigens	208226	S	1	0	1	0.00000
Alkaliphilus oremlandii	461876	S	1	0	1	0.00000
Hungatella hathewayi	154046	S	2	0	2	0.00000
Hathewaya histolytica	1498	S	2	0	2	0.00000
Geosporobacter ferrireducens	1424294	S	1	0	1	0.00000
Roseburia intestinalis	166486	S	63	10	73	0.00000
Roseburia hominis	301301	S	4	1	5	0.00000
Blautia sp. SC05B48	2479767	S	2	2	4	0.00000
Blautia sp. LZLJ-3	2779518	S	1	0	1	0.00000
Blautia obeum	40520	S	1	0	1	0.00000
Anaerostipes caccae	105841	S	3	0	3	0.00000
Anaerostipes hadrus	649756	S	2	0	2	0.00000
Anaerocolumna sp. CTTW	2736602	S	2	0	2	0.00000
Anaerocolumna cellulosilytica	433286	S	1	0	1	0.00000
Anaerocolumna sedimenticola	2696063	S	1	0	1	0.00000
Lachnoclostridium phocaeense	1871021	S	2	0	2	0.00000
[Clostridium] scindens	29347	S	1	0	1	0.00000
Lachnoclostridium phytofermentans	66219	S	1	0	1	0.00000
Cellulosilyticum lentocellum	29360	S	1	3	4	0.00000
Lachnoanaerobaculum umeaense	617123	S	3	0	3	0.00000
Anaerobutyricum hallii	39488	S	3	0	3	0.00000
Coprococcus sp. ART55/1	751585	S	2	0	2	0.00000
Coprococcus comes	410072	S	1	0	1	0.00000
Butyrivibrio proteoclasticus	43305	S	2	0	2	0.00000
Herbinix luporum	1679721	S	2	0	2	0.00000
[Ruminococcus] gnavus	33038	S	2	0	2	0.00000
Lachnospira eligens	39485	S	2	0	2	0.00000
Pseudobutyrivibrio xylanivorans	185007	S	1	0	1	0.00000
Enterocloster clostridioformis	1531	S	1	0	1	0.00000
Romboutsia ilealis	1115758	S	6	0	6	0.00000
Romboutsia sp. CE17	2724150	S	5	0	5	0.00000
Clostridioides difficile	1496	S	7	1	8	0.00000
Paeniclostridium sordellii	1505	S	4	0	4	0.00000
Acetoanaerobium sticklandii	1511	S	2	0	2	0.00000
Filifactor alocis	143361	S	1	0	1	0.00000
Peptacetobacter hiranonis	89152	S	1	0	1	0.00000
Ruminococcus champanellensis	1161942	S	3	0	3	0.00000
Ruminococcus bicirculans	1160721	S	2	0	2	0.00000
Ruminococcus albus	1264	S	1	0	1	0.00000
Faecalibacterium prausnitzii	853	S	6	1	7	0.00000
Acetivibrio saccincola	1677857	S	2	0	2	0.00000
Acetivibrio thermocellus	1515	S	1	-1	0	0.00000
Acetivibrio clariflavus	288965	S	1	0	1	0.00000
Ruminiclostridium herbifermentans	2488810	S	3	1	4	0.00000
Ruminiclostridium cellulolyticum	1521	S	1	0	1	0.00000
Flavonifractor plautii	292800	S	1	0	1	0.00000
Caproiciproducens sp. NJN-50	2507162	S	1	0	1	0.00000
Ruthenibacterium lactatiformans	1550024	S	1	0	1	0.00000
Thermoclostridium stercorarium	1510	S	1	-1	0	0.00000
Pseudoclostridium thermosuccinogenes	84032	S	1	0	1	0.00000
Desulfitobacterium dichloroeliminans	233055	S	3	0	3	0.00000
Desulfitobacterium dehalogenans	36854	S	2	0	2	0.00000
Desulfosporosinus youngiae	339862	S	3	0	3	0.00000
Desulfosporosinus meridiei	79209	S	1	0	1	0.00000
Desulfosporosinus acidiphilus	885581	S	1	0	1	0.00000
Syntrophobotulus glycolicus	51197	S	2	0	2	0.00000
Desulfotomaculum reducens	59610	S	1	0	1	0.00000
Thermincola potens	863643	S	1	0	1	0.00000
Desulfofarcimen acetoxidans	58138	S	1	0	1	0.00000
Monoglobus pectinilyticus	1981510	S	4	0	4	0.00000
Thermaerobacter sp. PB12/4term	2293838	S	1	0	1	0.00000
Thermaerobacter sp. FW80	2546351	S	1	0	1	0.00000
Thermaerobacter marianensis	73919	S	1	0	1	0.00000
Mogibacterium pumilum	86332	S	1	0	1	0.00000
Mogibacterium diversum	114527	S	1	0	1	0.00000
Aminipila sp. JN-18	2507160	S	1	0	1	0.00000
Eubacterium sp. NSJ-61	2764325	S	2	0	2	0.00000
Eubacterium limosum	1736	S	1	0	1	0.00000
Acetobacterium sp. KB-1	2184575	S	1	0	1	0.00000
Alkalibacter sp. ES005	2815577	S	1	0	1	0.00000
Christensenella sp. Marseille-P3954	2086585	S	2	0	2	0.00000
Petrocella atlantisensis	2173034	S	2	0	2	0.00000
Symbiobacterium thermophilum	2734	S	1	0	1	0.00000
Caldicellulosiruptor kronotskyensis	413889	S	4	0	4	0.00000
Caldicellulosiruptor sp. YA01	2806205	S	4	0	4	0.00000
Caldicellulosiruptor owensensis	55205	S	1	0	1	0.00000
Thermoanaerobacterium thermosaccharolyticum	1517	S	2	0	2	0.00000
Thermoanaerobacterium xylanolyticum	29329	S	1	0	1	0.00000
Thermoanaerobacterium sp. RBIITD	1550240	S	1	0	1	0.00000
Thermoanaerobacter kivui	2325	S	1	2	3	0.00000
Carboxydothermus hydrogenoformans	129958	S	3	0	3	0.00000
Moorella thermoacetica	1525	S	1	0	1	0.00000
Thermanaeromonas toyohensis	161154	S	1	0	1	0.00000
Caldanaerobacter subterraneus	911092	S	1	0	1	0.00000
Thermodesulfobium narugense	184064	S	1	0	1	0.00000
Thermodesulfobium acidiphilum	1794699	S	1	0	1	0.00000
Halanaerobium hydrogeniformans	656519	S	1	0	1	0.00000
Halothermothrix orenii	31909	S	1	0	1	0.00000
Halocella sp. SP3-1	2382161	S	1	0	1	0.00000
Acetohalobium arabaticum	28187	S	2	0	2	0.00000
Anoxybacter fermentans	1323375	S	1	0	1	0.00000
Natranaerobius thermophilus	375929	S	1	0	1	0.00000
Koleobacter methoxysyntrophicus	2751313	S	1	0	1	0.00000
Veillonella parvula	29466	S	5	0	5	0.00000
Veillonella nakazawae	2682456	S	2	0	2	0.00000
Veillonella atypica	39777	S	1	0	1	0.00000
Megasphaera elsdenii	907	S	3	0	3	0.00000
Megasphaera stantonii	2144175	S	1	0	1	0.00000
Dialister massiliensis	2161821	S	1	1	2	0.00000
Megamonas hypermegale	158847	S	4	0	4	0.00000
Megamonas funiformis	437897	S	3	0	3	0.00000
Pelosinus fermentans	365349	S	3	0	3	0.00000
Pelosinus sp. UFO1	484770	S	1	0	1	0.00000
Methylomusa anaerophila	1930071	S	2	0	2	0.00000
Phascolarctobacterium faecium	33025	S	4	0	4	0.00000
Phascolarctobacterium sp. Marseille-Q4147	2823317	S	1	0	1	0.00000
Acidaminococcus intestini	187327	S	2	0	2	0.00000
Finegoldia magna	1260	S	5	1	6	0.00000
Anaerococcus prevotii	33034	S	1	0	1	0.00000
Anaerococcus vaginalis	33037	S	1	0	1	0.00000
Anaerococcus mediterraneensis	1870984	S	1	0	1	0.00000
Peptoniphilus harei	54005	S	1	0	1	0.00000
Tissierellia sp. JN-28	2507161	S	2	0	2	0.00000
Schnuerera ultunensis	45497	S	2	0	2	0.00000
Keratinibaculum paraultunense	1278232	S	1	0	1	0.00000
Gudongella oleilytica	1582259	S	1	0	1	0.00000
Gottschalkia acidurici	1556	S	4	0	4	0.00000
Sedimentibacter sp. zth1	2816908	S	3	0	3	0.00000
Ezakiella massiliensis	1852374	S	2	0	2	0.00000
Erysipelothrix rhusiopathiae	1648	S	2	0	2	0.00000
Erysipelothrix piscisicarius	2485784	S	2	0	2	0.00000
Erysipelothrix inopinata	225084	S	1	0	1	0.00000
Erysipelothrix sp. HDW6C	2714930	S	1	0	1	0.00000
Erysipelatoclostridium ramosum	1547	S	3	0	3	0.00000
Amedibacterium intestinale	2583452	S	3	1	4	0.00000
Faecalibaculum rodentium	1702221	S	1	0	1	0.00000
Turicibacter sanguinis	154288	S	2	0	2	0.00000
Turicibacter sp. H121	1712675	S	2	0	2	0.00000
endosymbiont 'TC1' of Trimyema compressum	243899	S	1	0	1	0.00000
Nostoc sp. CENA543	1869241	S	9	0	9	0.00000
Nostoc sp. NIES-4103	2005458	S	8	0	8	0.00000
Nostoc sp. PCC 7524	28072	S	6	0	6	0.00000
Nostoc sp. PCC 7107	317936	S	4	1	5	0.00000
Nostoc sp. TCL26-01	2576904	S	4	0	4	0.00000
Nostoc sp. 'Peltigera membranacea cyanobiont' N6	1261031	S	3	0	3	0.00000
Nostoc sp. 'Lobaria pulmonaria (5183) cyanobiont'	1618022	S	3	0	3	0.00000
Nostoc sp. C052	2576902	S	3	0	3	0.00000
Nostoc sp. C057	2576903	S	1	2	3	0.00000
Nostoc sp. UHCC 0702	2814655	S	1	0	1	0.00000
Nostoc carneum	374162	S	11	22	33	0.00000
Nostoc sphaeroides	446679	S	5	0	5	0.00000
Nostoc edaphicum	264686	S	2	0	2	0.00000
Nostoc punctiforme	272131	S	1	0	1	0.00000
Nostoc flagelliforme	1306274	S	1	0	1	0.00000
Anabaena sp. YBS01	2490939	S	8	82	90	0.00000
Anabaena sp. WA102	1647413	S	2	3	5	0.00000
Anabaena cylindrica	1165	S	3	0	3	0.00000
Cylindrospermum stagnale	142864	S	1	0	1	0.00000
Trichormus azollae	1164	S	1	0	1	0.00000
Calothrix sp. NIES-2098	1954171	S	8	6	14	0.00000
Calothrix sp. PCC 7507	99598	S	6	1	7	0.00000
Calothrix sp. NIES-2100	1954172	S	3	2	5	0.00000
Calothrix sp. 336/3	1337936	S	1	0	1	0.00000
Calothrix sp. NIES-3974	2005462	S	1	0	1	0.00000
Calothrix parasitica	1973486	S	26	0	26	0.00000
Calothrix brevissima	938406	S	4	1	5	0.00000
Calothrix parietina	32054	S	3	0	3	0.00000
Rivularia sp. PCC 7116	373994	S	8	0	8	0.00000
Microchaete diplosiphon	1197	S	3	5	8	0.00000
Dolichospermum sp. UHCC 0315A	1914871	S	2	14	16	0.00000
Dolichospermum compactum	136073	S	1	1	2	0.00000
Cylindrospermopsis curvispora	747548	S	2	0	2	0.00000
Sphaerospermopsis kisseleviana	289435	S	2	0	2	0.00000
Anabaenopsis circularis	109266	S	1	0	1	0.00000
Fischerella sp. NIES-4106	2005456	S	6	0	6	0.00000
Fischerella sp. NIES-3754	1752063	S	2	1	3	0.00000
Scytonema sp. NIES-4073	2005464	S	2	0	2	0.00000
Brasilonema sennae	1397703	S	2	0	2	0.00000
Tolypothrix sp. PCC 7910	2099387	S	2	1	3	0.00000
Oscillatoria nigro-viridis	482564	S	104	2	106	0.00000
Moorea producens	1155739	S	4	0	4	0.00000
Planktothrix agardhii	1160	S	27	14	41	0.00000
Planktothrix rubescens	59512	S	6	2	8	0.00000
Trichodesmium erythraeum	1206	S	3	0	3	0.00000
Microcoleus sp. PCC 7113	1173027	S	1	0	1	0.00000
Oxynema sp. AP17	2064643	S	1	0	1	0.00000
Crinalium epipsammum	241425	S	3	0	3	0.00000
[Phormidium] sp. ETS-05	222819	S	2	0	2	0.00000
Cyanothece sp. PCC 7425	395961	S	1	0	1	0.00000
Geitlerinema sp. PCC 7407	1173025	S	1	0	1	0.00000
Microcystis aeruginosa	1126	S	23	2	25	0.00000
Microcystis viridis	44822	S	1	0	1	0.00000
Gloeothece citriformis	2546356	S	6	0	6	0.00000
Gloeothece verrucosa	2546359	S	4	0	4	0.00000
Halothece sp. PCC 7418	65093	S	1	0	1	0.00000
Geminocystis sp. NIES-3708	1615909	S	3	0	3	0.00000
Geminocystis herdmanii	669359	S	2	0	2	0.00000
Chondrocystis sp. NIES-4102	2005460	S	1	0	1	0.00000
Cyanobacterium aponinum	379064	S	3	0	3	0.00000
Synechococcus sp. BIOS-E4-1	1400864	S	3	0	3	0.00000
Synechococcus sp. PCC 7502	1173263	S	3	0	3	0.00000
Synechococcus sp. PCC 7336	195250	S	3	0	3	0.00000
Synechococcus sp. CBW1107	2789857	S	2	0	2	0.00000
Synechococcus sp. WH 8103	29410	S	1	0	1	0.00000
Synechococcus sp. SynAce01	1916956	S	1	0	1	0.00000
Synechococcus sp. NOUM97013	1442555	S	1	0	1	0.00000
Synechococcus sp. BOUM118	1442552	S	1	0	1	0.00000
Synechococcus sp. BMK-MC-1	1442551	S	1	0	1	0.00000
Synechococcus sp. CBW1108	1353147	S	1	0	1	0.00000
Synechococcus sp. PCC 7003	374981	S	1	0	1	0.00000
Synechococcus sp. CB0101	232348	S	1	0	1	0.00000
Synechococcus sp. RS9902	221345	S	1	0	1	0.00000
Synechococcus sp. CC9605	110662	S	1	0	1	0.00000
Synechococcus sp. PCC 6312	195253	S	1	0	1	0.00000
Synechococcus sp. PCC 7002	32049	S	1	0	1	0.00000
Synechococcus sp. MIT S9220	166309	S	1	0	1	0.00000
Synechococcus sp. WH 8109	166314	S	1	0	1	0.00000
Synechococcus sp. WH 8101	59932	S	1	0	1	0.00000
Synechococcus lividus	33070	S	1	0	1	0.00000
Cyanobium sp. NS01	261284	S	3	0	3	0.00000
Cyanobium sp. NIES-981	1851505	S	2	0	2	0.00000
Cyanobium gracile	59930	S	3	0	3	0.00000
Acaryochloris marina	155978	S	34	0	34	0.00000
Prochlorococcus marinus	1219	S	13	3	16	0.00000
Prochlorococcus sp. MIT 0801	1501269	S	1	1	2	0.00000
Leptolyngbya sp. NIES-3755	1752064	S	5	0	5	0.00000
Leptolyngbya sp. BL0902	1115757	S	2	0	2	0.00000
Leptolyngbya boryana	1184	S	1	0	1	0.00000
Pseudanabaena sp. ABRG5-3	685565	S	2	0	2	0.00000
Pseudanabaena sp. PCC 7367	82654	S	1	0	1	0.00000
Synechocystis sp. CACIAM 05	1933929	S	1	0	1	0.00000
Chamaesiphon minutus	1173032	S	1	0	1	0.00000
Halomicronema hongdechloris	1209493	S	1	0	1	0.00000
Stanieria cyanosphaera	102116	S	2	0	2	0.00000
Stanieria sp. NIES-3757	1807358	S	1	0	1	0.00000
Pleurocapsa minor	54308	S	1	0	1	0.00000
Gloeobacter violaceus	33072	S	2	1	3	0.00000
Gloeomargarita lithophora	1188228	S	3	0	3	0.00000
Mycoplasma sp. Zaradi2	547987	S	3	0	3	0.00000
Mycoplasma sp. (ex Biomphalaria glabrata)	1749074	S	1	0	1	0.00000
Mycoplasma sp. NEAQ87857	2683967	S	1	0	1	0.00000
Mycoplasma sp. C264-NAS	2726117	S	1	0	1	0.00000
Mycoplasma hominis	2098	S	3	0	3	0.00000
Mycoplasma hyosynoviae	29559	S	3	0	3	0.00000
Mycoplasma capricolum	2095	S	1	1	2	0.00000
Mycoplasma mycoides	2102	S	1	0	1	0.00000
Mycoplasma putrefaciens	2123	S	3	0	3	0.00000
Mycoplasma iowae	2116	S	2	0	2	0.00000
Mycoplasma yeatsii	51365	S	2	0	2	0.00000
Mycoplasma bovoculi	45362	S	1	0	1	0.00000
Mycoplasma conjunctivae	45361	S	1	0	1	0.00000
Mycoplasma haemofelis	29501	S	1	0	1	0.00000
Mycoplasma penetrans	28227	S	1	0	1	0.00000
Mycoplasma crocodyli	50052	S	1	0	1	0.00000
Mycoplasma salivarium	2124	S	1	0	1	0.00000
Mycoplasma anserisalpingitidis	519450	S	1	0	1	0.00000
Mycoplasma tullyi	1612150	S	1	0	1	0.00000
Mycoplasma bovirhinis	29553	S	3	0	3	0.00000
Mycoplasma canis	29555	S	3	0	3	0.00000
Mycoplasma gallopavonis	76629	S	3	0	3	0.00000
Mycoplasma citelli	171281	S	2	0	2	0.00000
Mycoplasma anatis	171279	S	2	0	2	0.00000
Mycoplasma bovis	28903	S	2	0	2	0.00000
Mycoplasma meleagridis	29561	S	2	0	2	0.00000
Mycoplasma glycophilum	171285	S	1	0	1	0.00000
Mycoplasma cynos	171284	S	1	0	1	0.00000
Mycoplasma columbinum	114881	S	1	0	1	0.00000
Spiroplasma sp. TIUS-1	216963	S	1	0	1	0.00000
Spiroplasma alleghenense	216931	S	3	0	3	0.00000
Spiroplasma phoeniceum	47835	S	2	0	2	0.00000
Spiroplasma helicoides	216938	S	2	0	2	0.00000
Spiroplasma culicicola	216935	S	2	0	2	0.00000
Spiroplasma citri	2133	S	2	1	3	0.00000
Spiroplasma tabanidicola	324079	S	2	0	2	0.00000
Spiroplasma gladiatoris	2143	S	2	0	2	0.00000
Spiroplasma poulsonii	2138	S	2	0	2	0.00000
Spiroplasma kunkelii	47834	S	1	0	1	0.00000
Spiroplasma chinense	216932	S	1	0	1	0.00000
Spiroplasma chrysopicola	216933	S	1	0	1	0.00000
Spiroplasma apis	2137	S	1	0	1	0.00000
Spiroplasma turonicum	216946	S	1	0	1	0.00000
Spiroplasma floricola	216937	S	1	0	1	0.00000
Spiroplasma litorale	216942	S	1	0	1	0.00000
Spiroplasma sabaudiense	216944	S	1	0	1	0.00000
Mesoplasma tabanidae	219745	S	4	0	4	0.00000
Mesoplasma florum	2151	S	2	0	2	0.00000
Mesoplasma lactucae	138853	S	1	0	1	0.00000
Mesoplasma chauliocola	216427	S	1	0	1	0.00000
Mesoplasma coleopterae	324078	S	1	0	1	0.00000
Entomoplasma melaleucae	81459	S	1	0	1	0.00000
Acholeplasma axanthum	29552	S	2	0	2	0.00000
Acholeplasma laidlawii	2148	S	1	0	1	0.00000
Aster yellows witches'-broom phytoplasma	229545	S	1	1	2	0.00000
Deinococcus sp. S14-83	2489213	S	3	0	3	0.00000
Deinococcus sp. NW-56	2080419	S	2	0	2	0.00000
Deinococcus sp. D7000	2755035	S	2	0	2	0.00000
Deinococcus proteolyticus	55148	S	4	0	4	0.00000
Deinococcus geothermalis	68909	S	3	0	3	0.00000
Deinococcus irradiatisoli	2202254	S	3	0	3	0.00000
Deinococcus deserti	310783	S	2	0	2	0.00000
Deinococcus ficus	317577	S	2	0	2	0.00000
Deinococcus wulumuqiensis	980427	S	2	0	2	0.00000
Deinococcus actinosclerus	1768108	S	2	1	3	0.00000
Deinococcus peraridilitoris	432329	S	1	0	1	0.00000
Deinococcus gobiensis	502394	S	1	0	1	0.00000
Deinococcus swuensis	1182571	S	1	0	1	0.00000
Deinococcus radiodurans	1299	S	1	0	1	0.00000
Thermus thermophilus	274	S	2	0	2	0.00000
Thermus scotoductus	37636	S	2	0	2	0.00000
Thermus caldilimi	2483360	S	2	0	2	0.00000
Thermus sp. CCB_US3_UF1	1111069	S	2	0	2	0.00000
Thermus oshimai	56957	S	1	0	1	0.00000
Truepera radiovictrix	332249	S	1	0	1	0.00000
Candidatus Promineofilum breve	1806508	S	7	0	7	0.00000
Dehalococcoides mccartyi	61435	S	2	1	3	0.00000
Dehalogenimonas lykanthroporepellens	552810	S	2	0	2	0.00000
Roseiflexus sp. RS-1	357808	S	2	0	2	0.00000
Roseiflexus castenholzii	120962	S	1	0	1	0.00000
Chloroflexus aurantiacus	1108	S	1	-1	0	0.00000
Tepidiforma bonchosmolovskayae	2601677	S	4	0	4	0.00000
Sphaerobacter thermophilus	2057	S	1	0	1	0.00000
Thermomicrobium roseum	500	S	1	0	1	0.00000
Anaerolinea sp. 'rifampicinis'	2710758	S	1	0	1	0.00000
Pelolinea submarina	913107	S	1	0	1	0.00000
Caldilinea aerophila	133453	S	1	0	1	0.00000
Chthonomonas calidirosea	454171	S	1	0	1	0.00000
Fimbriimonas ginsengisoli	1005039	S	1	0	1	0.00000
Flavobacterium sp. M31R6	2739062	S	98	10	108	0.00000
Flavobacterium sp. Sr18	935222	S	13	1	14	0.00000
Flavobacterium sp. MDT1-60	1979344	S	11	1	12	0.00000
Flavobacterium sp. I3-2	2748319	S	9	8	17	0.00000
Flavobacterium sp. CLA17	2724135	S	9	1	10	0.00000
Flavobacterium sp. KBS0721	1179672	S	8	2	10	0.00000
Flavobacterium sp. HYN0086	2249356	S	5	1	6	0.00000
Flavobacterium sp. SLB02	2665645	S	5	1	6	0.00000
Flavobacterium sp. BB8	2816357	S	4	0	4	0.00000
Flavobacterium sp. P2-65	2748320	S	4	0	4	0.00000
Flavobacterium sp. 140616W15	2478552	S	4	0	4	0.00000
Flavobacterium sp. xlx-214	2654325	S	3	0	3	0.00000
Flavobacterium sp. LPB0248	2614441	S	2	1	3	0.00000
Flavobacterium sp. CJ74	2294119	S	1	0	1	0.00000
Flavobacterium psychrophilum	96345	S	27	2	29	0.00000
Flavobacterium nackdongense	2547394	S	26	1	27	0.00000
Flavobacterium gilvum	1492737	S	20	1	21	0.00000
Flavobacterium johnsoniae	986	S	19	5	24	0.00000
Flavobacterium columnare	996	S	17	2	19	0.00000
Flavobacterium indicum	312277	S	11	0	11	0.00000
Flavobacterium sangjuense	2518177	S	11	0	11	0.00000
Flavobacterium branchiophilum	55197	S	10	0	10	0.00000
Flavobacterium anhuiense	459526	S	10	3	13	0.00000
Flavobacterium commune	1306519	S	10	0	10	0.00000
Flavobacterium crocinum	2183896	S	10	2	12	0.00000
Flavobacterium haoranii	683124	S	9	1	10	0.00000
Flavobacterium nitrogenifigens	1617283	S	8	3	11	0.00000
Flavobacterium sediminis	2201181	S	8	5	13	0.00000
Flavobacterium crassostreae	1763534	S	8	1	9	0.00000
Flavobacterium faecale	1355330	S	8	0	8	0.00000
Flavobacterium magnum	2162713	S	4	0	4	0.00000
Flavobacterium album	2175091	S	2	0	2	0.00000
Flavobacterium arcticum	1784713	S	2	0	2	0.00000
Flavobacterium kingsejongi	1678728	S	2	0	2	0.00000
Flavobacterium alkalisoli	2602769	S	2	0	2	0.00000
Flavobacterium pallidum	2172098	S	1	0	1	0.00000
Polaribacter sp. Hel1_33_78	1336804	S	6	0	6	0.00000
Polaribacter sp. G4M1	2808900	S	6	0	6	0.00000
Polaribacter sp. MED152	313598	S	5	0	5	0.00000
Polaribacter sp. SA4-12	1312072	S	5	0	5	0.00000
Polaribacter sp. KT25b	1855336	S	4	0	4	0.00000
Polaribacter sp. L3A8	2686361	S	4	0	4	0.00000
Polaribacter sp. SA4-10	754397	S	3	0	3	0.00000
Polaribacter sp. ALD11	2058137	S	3	0	3	0.00000
Polaribacter sp. L12M9	2738844	S	2	0	2	0.00000
Polaribacter sp. BM10	1529069	S	1	4	5	0.00000
Polaribacter reichenbachii	996801	S	5	0	5	0.00000
Polaribacter vadi	1774273	S	4	0	4	0.00000
Polaribacter sejongensis	985043	S	3	0	3	0.00000
Polaribacter haliotis	1888915	S	3	0	3	0.00000
Capnocytophaga sp. oral taxon 878	1316596	S	2	0	2	0.00000
Capnocytophaga sp. H4358	1945658	S	2	1	3	0.00000
Capnocytophaga sp. oral taxon 864	1316593	S	1	0	1	0.00000
Capnocytophaga sp. FDAARGOS_737	2545799	S	1	0	1	0.00000
Capnocytophaga gingivalis	1017	S	6	0	6	0.00000
Capnocytophaga sputigena	1019	S	5	0	5	0.00000
Capnocytophaga canimorsus	28188	S	4	0	4	0.00000
Capnocytophaga haemolytica	45243	S	2	0	2	0.00000
Capnocytophaga endodontalis	2708117	S	2	0	2	0.00000
Capnocytophaga cynodegmi	28189	S	1	0	1	0.00000
Capnocytophaga stomatis	1848904	S	1	0	1	0.00000
Tenacibaculum sp. DSM 106434	2358479	S	7	1	8	0.00000
Tenacibaculum jejuense	584609	S	5	0	5	0.00000
Tenacibaculum dicentrarchi	669041	S	4	0	4	0.00000
Tenacibaculum maritimum	107401	S	3	0	3	0.00000
Tenacibaculum todarodis	1850252	S	3	0	3	0.00000
Tenacibaculum mesophilum	104268	S	1	0	1	0.00000
Myroides phaeus	702745	S	7	2	9	0.00000
Myroides odoratimimus	76832	S	4	6	10	0.00000
Myroides odoratus	256	S	2	0	2	0.00000
Myroides profundi	480520	S	2	0	2	0.00000
Myroides fluvii	2572594	S	2	0	2	0.00000
Myroides sp. A21	1583100	S	2	2	4	0.00000
Winogradskyella sp. PC-19	754417	S	4	0	4	0.00000
Winogradskyella sp. PG-2	754409	S	2	0	2	0.00000
Winogradskyella sp. J14-2	1936080	S	2	0	2	0.00000
Winogradskyella sediminis	1382466	S	6	0	6	0.00000
Winogradskyella forsetii	2686077	S	4	0	4	0.00000
Winogradskyella helgolandensis	2697010	S	3	0	3	0.00000
Winogradskyella schleiferi	2686078	S	2	0	2	0.00000
Nonlabens sp. Hel1_33_55	1336802	S	4	0	4	0.00000
Nonlabens sp. Ci31	2608253	S	4	0	4	0.00000
Nonlabens sp. SY33080	2719911	S	1	2	3	0.00000
Nonlabens spongiae	331648	S	3	0	3	0.00000
Nonlabens ponticola	2496866	S	3	0	3	0.00000
Aquimarina sp. AD1	1714848	S	7	0	7	0.00000
Aquimarina sp. BL5	1714860	S	4	0	4	0.00000
Aquimarina sp. AD10	1714849	S	2	0	2	0.00000
Aquimarina sp. TRL1	2736252	S	1	0	1	0.00000
Lacinutrix sp. Bg11-31	2057808	S	5	0	5	0.00000
Lacinutrix sp. WUR7	2653681	S	2	0	2	0.00000
Lacinutrix venerupis	1486034	S	5	1	6	0.00000
Cellulophaga sp. L1A9	2686362	S	5	1	6	0.00000
Cellulophaga baltica	76594	S	4	0	4	0.00000
Cellulophaga lytica	979	S	3	0	3	0.00000
Salegentibacter salegens	143223	S	6	0	6	0.00000
Salegentibacter sp. T436	1729720	S	4	2	6	0.00000
Algibacter sp. L1A34	2686365	S	4	0	4	0.00000
Algibacter sp. L3A6	2686366	S	3	0	3	0.00000
Algibacter alginicilyticus	1736674	S	2	0	2	0.00000
Maribacter sp. T28	1836467	S	5	1	6	0.00000
Maribacter sp. HTCC2170	313603	S	1	0	1	0.00000
Maribacter cobaltidurans	1178778	S	2	1	3	0.00000
Formosa agariphila	320324	S	4	0	4	0.00000
Formosa sp. Hel1_33_131	1336794	S	2	0	2	0.00000
Formosa sp. Hel1_31_208	1798225	S	1	0	1	0.00000
Formosa sediminum	2594004	S	2	0	2	0.00000
Zunongwangia profunda	398743	S	8	4	12	0.00000
Kordia antarctica	1218801	S	4	0	4	0.00000
Kordia sp. SMS9	2282170	S	1	0	1	0.00000
Aequorivita sp. KX20305	2803865	S	3	0	3	0.00000
Aequorivita sp. H23M31	2494375	S	1	0	1	0.00000
Aequorivita sublithincola	101385	S	2	0	2	0.00000
Psychroserpens sp. NJDZ02	2570561	S	5	4	9	0.00000
Tamlana carrageenivorans	2069432	S	5	0	5	0.00000
Arenibacter algicola	616991	S	5	0	5	0.00000
Changchengzhania lutea	2049305	S	5	0	5	0.00000
Olleya sp. Bg11-27	2058135	S	3	2	5	0.00000
Olleya aquimaris	639310	S	2	0	2	0.00000
Mariniflexile sp. TRM1-10	2027857	S	4	0	4	0.00000
Wenyingzhuangia fucanilytica	1790137	S	4	0	4	0.00000
Urechidicola croceus	1850246	S	4	1	5	0.00000
Dokdonia sp. Dokd-P16	2173169	S	2	2	4	0.00000
Psychroflexus torquis	57029	S	2	0	2	0.00000
Psychroflexus sp. ALD_RP9	2777186	S	2	0	2	0.00000
Muricauda sp. 501str8	2698672	S	2	0	2	0.00000
Muricauda ruestringensis	111501	S	1	0	1	0.00000
Muricauda lutaonensis	516051	S	1	0	1	0.00000
Gramella echinicola	279359	S	1	0	1	0.00000
Gramella salexigens	1913577	S	1	0	1	0.00000
Gramella sp. MAR_2010_147	1250205	S	1	0	1	0.00000
Antarcticibacterium arcticum	2585771	S	3	0	3	0.00000
Seonamhaeicola sp. S2-3	1936081	S	3	0	3	0.00000
Siansivirga zeaxanthinifaciens	762954	S	3	0	3	0.00000
Costertonia aggregata	343403	S	2	0	2	0.00000
Muriicola sp. MMS17-SY002	2507538	S	2	0	2	0.00000
Croceibacter atlanticus	313588	S	2	0	2	0.00000
Gillisia sp. Hel1_33_143	1336796	S	2	0	2	0.00000
Robiginitalea biformata	252307	S	2	0	2	0.00000
Leeuwenhoekiella sp. ZYFB001	2719912	S	2	0	2	0.00000
Lutibacter profundi	1622118	S	2	0	2	0.00000
Flagellimonas maritima	1383885	S	1	0	1	0.00000
Sediminicola sp. YIK13	1453352	S	1	0	1	0.00000
Flavivirga eckloniae	1803846	S	1	0	1	0.00000
Zobellia galactanivorans	63186	S	1	0	1	0.00000
Altibacter sp. ALE3EI	2562285	S	1	0	1	0.00000
Gilvibacter sp. SZ-19	754429	S	1	0	1	0.00000
Oceanihabitans sp. IOP_32	2529032	S	1	0	1	0.00000
Chryseobacterium sp. SNU WT5	2594269	S	13	2	15	0.00000
Chryseobacterium sp. 3008163	2478663	S	6	1	7	0.00000
Chryseobacterium sp. StRB126	878220	S	5	1	6	0.00000
Chryseobacterium sp. NBC 122	2547600	S	5	0	5	0.00000
Chryseobacterium sp. IHB B 17019	1721091	S	4	0	4	0.00000
Chryseobacterium sp. 6424	2039166	S	4	0	4	0.00000
Chryseobacterium sp. G0162	2487063	S	4	5	9	0.00000
Chryseobacterium sp. POL2	2713414	S	4	1	5	0.00000
Chryseobacterium sp. NEB161	2724619	S	4	3	7	0.00000
Chryseobacterium sp. T16E-39	2015076	S	2	0	2	0.00000
Chryseobacterium sp. JV274	1932669	S	1	0	1	0.00000
Chryseobacterium sp. G0186	2487064	S	1	0	1	0.00000
Chryseobacterium sp. G0201	2487065	S	1	0	1	0.00000
Chryseobacterium sp. cx-624	2758037	S	1	0	1	0.00000
Chryseobacterium aureum	2497456	S	12	2	14	0.00000
Chryseobacterium indologenes	253	S	8	3	11	0.00000
Chryseobacterium joostei	112234	S	7	3	10	0.00000
Chryseobacterium balustinum	246	S	7	2	9	0.00000
Chryseobacterium manosquense	2754694	S	6	11	17	0.00000
Chryseobacterium glaciei	1685010	S	5	1	6	0.00000
Chryseobacterium indoltheticum	254	S	4	0	4	0.00000
Chryseobacterium carnipullorum	1124835	S	4	1	5	0.00000
Chryseobacterium bernardetii	1241978	S	3	4	7	0.00000
Chryseobacterium arthrosphaerae	651561	S	3	1	4	0.00000
Chryseobacterium gleum	250	S	3	3	6	0.00000
Chryseobacterium camelliae	1265445	S	2	1	3	0.00000
Chryseobacterium shandongense	1493872	S	2	1	3	0.00000
Chryseobacterium nakagawai	1241982	S	1	1	2	0.00000
Chryseobacterium piperi	558152	S	1	0	1	0.00000
Kaistella jeonii	266749	S	16	1	17	0.00000
Kaistella flava (ex Peng et al. 2021)	2038776	S	11	1	12	0.00000
Kaistella antarctica	266748	S	10	1	11	0.00000
Kaistella carnis	1241979	S	3	0	3	0.00000
Kaistella daneshvariae	2487074	S	2	0	2	0.00000
Chryseobacterium haifense	421525	S	1	1	2	0.00000
Epilithonimonas vandammei	2487072	S	7	8	15	0.00000
Chryseobacterium lactis	1241981	S	2	2	4	0.00000
Chryseobacterium taklimakanense	536441	S	2	0	2	0.00000
Cloacibacterium normanense	237258	S	32	4	36	0.00000
Elizabethkingia meningoseptica	238	S	9	0	9	0.00000
Elizabethkingia bruuniana	1756149	S	4	7	11	0.00000
Elizabethkingia sp. JS20170427COW	2583851	S	3	0	3	0.00000
Elizabethkingia anophelis	1117645	S	2	0	2	0.00000
Empedobacter falsenii	343874	S	8	3	11	0.00000
Empedobacter brevis	247	S	5	1	6	0.00000
Empedobacter stercoris	1628248	S	2	0	2	0.00000
Apibacter sp. B3706	2656760	S	1	6	7	0.00000
Apibacter raozihei	2500547	S	5	0	5	0.00000
Ornithobacterium rhinotracheale	28251	S	3	0	3	0.00000
Riemerella anatipestifer	34085	S	3	0	3	0.00000
Bergeyella cardium	1585976	S	1	0	1	0.00000
Cruoricaptor ignavus	1118202	S	1	0	1	0.00000
Blattabacterium cuenoti	1653831	S	25	2	27	0.00000
Blattabacterium sp. (Mastotermes darwiniensis)	39768	S	3	0	3	0.00000
Blattabacterium sp. DPU	2715232	S	2	0	2	0.00000
Blattabacterium sp. (Blattella germanica)	624186	S	1	0	1	0.00000
Blattabacterium punctulatus	164514	S	3	0	3	0.00000
Owenweeksia hongkongensis	253245	S	1	0	1	0.00000
Croceimicrobium hydrocarbonivorans	2761580	S	1	0	1	0.00000
Fluviicola taffensis	191579	S	2	0	2	0.00000
Spirosoma sp. KUDC1026	2745947	S	111	4	115	0.00000
Spirosoma sp. KCTC 42546	2520506	S	6	0	6	0.00000
Spirosoma sp. PL0136	2710596	S	4	0	4	0.00000
Spirosoma sp. CJU-R4	2728024	S	3	0	3	0.00000
Spirosoma pollinicola	2057025	S	12	0	12	0.00000
Spirosoma endbachense	2666025	S	4	0	4	0.00000
Spirosoma montaniterrae	1178516	S	2	0	2	0.00000
Spirosoma aerolatum	1211326	S	2	0	2	0.00000
Spirosoma radiotolerans	1379870	S	2	0	2	0.00000
Spirosoma taeanense	2735870	S	2	0	2	0.00000
Spirosoma rigui	564064	S	1	0	1	0.00000
Spirosoma aureum	2692134	S	1	0	1	0.00000
Runella sp. SP2	2268026	S	12	0	12	0.00000
Runella sp. HYN0085	2259595	S	5	0	5	0.00000
Runella slithyformis	106	S	5	0	5	0.00000
Cytophaga hutchinsonii	985	S	9	0	9	0.00000
Aquirufa nivalisilvae	2516557	S	6	0	6	0.00000
Arcticibacterium luteifluviistationis	1784714	S	5	0	5	0.00000
Rhodocytophaga rosea	2704465	S	3	0	3	0.00000
Dyadobacter fermentans	94254	S	2	0	2	0.00000
Fibrella sp. ES10-3-2-2	1834519	S	1	0	1	0.00000
Hymenobacter sp. PAMC 26628	1484118	S	5	0	5	0.00000
Hymenobacter sp. S2-20-2	2761579	S	5	0	5	0.00000
Hymenobacter sp. APR13	1356852	S	4	2	6	0.00000
Hymenobacter sp. PAMC 26554	1484116	S	4	0	4	0.00000
Hymenobacter sp. NBH84	2596915	S	4	0	4	0.00000
Hymenobacter sp. TS19	2735321	S	4	0	4	0.00000
Hymenobacter sp. BRD67	2675877	S	2	0	2	0.00000
Hymenobacter sp. HDW8	2714932	S	2	5	7	0.00000
Hymenobacter sp. DG25A	1385663	S	1	0	1	0.00000
Hymenobacter sp. BRD128	2675878	S	1	0	1	0.00000
Hymenobacter sedentarius	1411621	S	6	0	6	0.00000
Hymenobacter qilianensis	1385715	S	2	0	2	0.00000
Hymenobacter nivis	1850093	S	2	0	2	0.00000
Hymenobacter jejuensis	2502781	S	2	0	2	0.00000
Hymenobacter busanensis	2607656	S	2	0	2	0.00000
Hymenobacter swuensis	1446467	S	1	0	1	0.00000
Hymenobacter oligotrophus	2319843	S	1	0	1	0.00000
Hymenobacter baengnokdamensis	2615203	S	1	0	1	0.00000
Hymenobacter russus	2724192	S	1	0	1	0.00000
Pontibacter akesuensis	388950	S	2	0	2	0.00000
Pontibacter sp. SGAir0037	2571030	S	2	0	2	0.00000
Pontibacter actiniarum	323450	S	1	0	1	0.00000
Pontibacter korlensis	400092	S	1	0	1	0.00000
Pontibacter russatus	2694929	S	1	0	1	0.00000
Pontibacter pudoricolor	2694930	S	1	0	1	0.00000
Rufibacter radiotolerans	1379910	S	2	0	2	0.00000
Rufibacter sp. DG15C	1379909	S	2	0	2	0.00000
Rufibacter tibetensis	512763	S	1	0	1	0.00000
Nibribacter ruber	2698458	S	2	0	2	0.00000
Cyclobacterium amurskyense	320787	S	5	0	5	0.00000
Cyclobacterium marinum	104	S	3	0	3	0.00000
Algoriphagus sp. Y33	2772483	S	3	0	3	0.00000
Algoriphagus machipongonensis	388413	S	2	0	2	0.00000
Aquiflexum balticum	280473	S	5	0	5	0.00000
Echinicola rosea	1807691	S	3	0	3	0.00000
Echinicola vietnamensis	390884	S	2	0	2	0.00000
Belliella baltica	232259	S	3	1	4	0.00000
Flammeovirga sp. MY04	1191459	S	8	0	8	0.00000
Flammeovirga pectinis	2494373	S	6	0	6	0.00000
Marivirga tractuosa	1006	S	8	2	10	0.00000
Chryseolinea soli	2321403	S	5	0	5	0.00000
Fulvivirga sp. S481	2810512	S	2	0	2	0.00000
Bernardetia litoralis	999	S	5	0	5	0.00000
Cardinium endosymbiont of Sogatella furcifera	650378	S	2	0	2	0.00000
Candidatus Amoebophilus asiaticus	281120	S	2	0	2	0.00000
Roseivirga pacifica	1267423	S	2	0	2	0.00000
Pedobacter sp. SW-16	2766984	S	32	5	37	0.00000
Pedobacter sp. HDW13	2714940	S	27	2	29	0.00000
Pedobacter sp. G11	2482728	S	14	1	15	0.00000
Pedobacter sp. KBS0701	2578106	S	13	2	15	0.00000
Pedobacter sp. PACM 27299	1727164	S	9	0	9	0.00000
Pedobacter sp. JBR3-12	2789740	S	9	0	9	0.00000
Pedobacter sp. CJ43	2605747	S	6	0	6	0.00000
Pedobacter sp. eg	2201271	S	5	0	5	0.00000
Pedobacter roseus	336820	S	20	4	24	0.00000
Pedobacter cryoconitis	188932	S	10	0	10	0.00000
Pedobacter suwonensis	332999	S	10	1	11	0.00000
Pedobacter ginsengisoli	363852	S	8	0	8	0.00000
Pedobacter steynii	430522	S	5	0	5	0.00000
Pedobacter heparinus	984	S	3	0	3	0.00000
Sphingobacterium sp. UDSM-2020	2795738	S	7	1	8	0.00000
Sphingobacterium sp. ML3W	1538644	S	6	1	7	0.00000
Sphingobacterium sp. DR205	2713573	S	2	0	2	0.00000
Sphingobacterium sp. B29	1933220	S	1	1	2	0.00000
Sphingobacterium sp. CZ-2	2557994	S	1	0	1	0.00000
Sphingobacterium sp. dk4302	2662364	S	1	0	1	0.00000
Sphingobacterium spiritivorum	258	S	10	5	15	0.00000
Sphingobacterium multivorum	28454	S	10	9	19	0.00000
Sphingobacterium thalpophilum	259	S	6	5	11	0.00000
Sphingobacterium hotanense	649196	S	6	1	7	0.00000
Sphingobacterium daejeonense	371142	S	4	0	4	0.00000
Sphingobacterium psychroaquaticum	561061	S	3	0	3	0.00000
Sphingobacterium lactis	797291	S	2	1	3	0.00000
Mucilaginibacter ginsenosidivorax	862126	S	6	0	6	0.00000
Mucilaginibacter sp. 14171R-50	2703789	S	4	0	4	0.00000
Mucilaginibacter sp. F39-2	2728022	S	1	0	1	0.00000
Mucilaginibacter xinganensis	1234841	S	4	0	4	0.00000
Mucilaginibacter gotjawali	1550579	S	4	0	4	0.00000
Mucilaginibacter celer	2305508	S	3	0	3	0.00000
Mucilaginibacter mali	2740462	S	3	0	3	0.00000
Mucilaginibacter ginsenosidivorans	398053	S	2	0	2	0.00000
Mucilaginibacter mallensis	652787	S	2	0	2	0.00000
Mucilaginibacter rubeus	2027860	S	2	7	9	0.00000
Mucilaginibacter paludis	423351	S	1	0	1	0.00000
Solitalea canadensis	995	S	9	0	9	0.00000
Olivibacter sp. LS-1	2592345	S	5	12	17	0.00000
Olivibacter sp. SDN3	2764720	S	2	0	2	0.00000
Pseudopedobacter saltans	151895	S	3	1	4	0.00000
Anseongella ginsenosidimutans	496056	S	2	0	2	0.00000
Chitinophaga sp. XS-30	2604421	S	5	0	5	0.00000
Chitinophaga sp. MD30	2033437	S	3	0	3	0.00000
Chitinophaga sp. 1303	2725414	S	1	6	7	0.00000
Chitinophaga pinensis	79329	S	9	1	10	0.00000
Chitinophaga caeni	2029983	S	4	0	4	0.00000
Chitinophaga alhagiae	2203219	S	2	0	2	0.00000
Chitinophaga agri	2703787	S	2	1	3	0.00000
Pseudobacter ginsenosidimutans	661488	S	28	2	30	0.00000
Arachidicoccus ginsenosidivorans	496057	S	9	1	10	0.00000
Arachidicoccus sp. B3-10	2545455	S	7	0	7	0.00000
Arachidicoccus sp. BS20	1850526	S	1	0	1	0.00000
Arachidicoccus soli	2341117	S	5	0	5	0.00000
Lacibacter sp. S13-6-6	2760713	S	15	0	15	0.00000
Panacibacter ginsenosidivorans	1813871	S	13	0	13	0.00000
Paraflavitalea soli	2315862	S	12	0	12	0.00000
Flavisolibacter tropicus	1492898	S	9	1	10	0.00000
Flavisolibacter ginsenosidimutans	661481	S	1	0	1	0.00000
Filimonas lacunae	477680	S	7	0	7	0.00000
Niastella koreensis	354356	S	6	0	6	0.00000
Niabella ginsenosidivorans	1176587	S	4	0	4	0.00000
Niabella soli	446683	S	1	0	1	0.00000
Flavihumibacter sp. SB-02	2676868	S	3	0	3	0.00000
Pseudocnuella soli	2502779	S	2	0	2	0.00000
Bacteroides eggerthii	28111	S	6	1	7	0.00000
Bacteroides thetaiotaomicron	818	S	5	0	5	0.00000
Bacteroides fragilis	817	S	4	3	7	0.00000
Bacteroides caccae	47678	S	4	0	4	0.00000
Bacteroides cellulosilyticus	246787	S	4	0	4	0.00000
Bacteroides sp. CBA7301	2715212	S	1	0	1	0.00000
Bacteroides sp. M10	2763022	S	1	2	3	0.00000
Bacteroides ovatus	28116	S	3	2	5	0.00000
Bacteroides caecimuris	1796613	S	3	0	3	0.00000
Bacteroides coprosuis	151276	S	2	0	2	0.00000
Bacteroides uniformis	820	S	1	0	1	0.00000
Phocaeicola dorei	357276	S	13	2	15	0.00000
Phocaeicola vulgatus	821	S	12	1	13	0.00000
Phocaeicola salanitronis	376805	S	5	0	5	0.00000
Prevotella dentalis	52227	S	4	0	4	0.00000
Prevotella sp. oral taxon 299	652716	S	3	0	3	0.00000
Prevotella sp. WR041	2801997	S	1	0	1	0.00000
Prevotella melaninogenica	28132	S	3	1	4	0.00000
Prevotella oris	28135	S	1	0	1	0.00000
Prevotella enoeca	76123	S	1	0	1	0.00000
Prevotella copri	165179	S	1	0	1	0.00000
Prevotella fusca	589436	S	1	0	1	0.00000
Prevotella scopos	589437	S	1	0	1	0.00000
Alistipes megaguti	2364787	S	3	0	3	0.00000
Alistipes communis	2585118	S	3	0	3	0.00000
Alistipes onderdonkii	328813	S	2	0	2	0.00000
Alistipes sp. dk3624	2662363	S	1	0	1	0.00000
Petrimonas mucosa	1642646	S	6	0	6	0.00000
Paludibacter propionicigenes	185300	S	8	0	8	0.00000
Coprobacter sp. 2CBH44	2751153	S	7	1	8	0.00000
Parabacteroides distasonis	823	S	2	1	3	0.00000
Parabacteroides sp. CT06	2025876	S	1	3	4	0.00000
Tannerella sp. oral taxon HOT-286	712710	S	2	0	2	0.00000
Butyricimonas virosa	544645	S	3	0	3	0.00000
Butyricimonas faecalis	2093856	S	1	0	1	0.00000
Odoribacter splanchnicus	28118	S	1	0	1	0.00000
Salinivirga cyanobacteriivorans	1307839	S	3	0	3	0.00000
Muribaculum intestinale	1796646	S	2	0	2	0.00000
Porphyromonas gingivalis	837	S	1	0	1	0.00000
Porphyromonas crevioricanis	393921	S	1	0	1	0.00000
Tenuifilum thalassicum	2590900	S	2	0	2	0.00000
Draconibacterium sp. M1	2706887	S	3	0	3	0.00000
Draconibacterium orientale	1168034	S	2	0	2	0.00000
Labilibaculum antarcticum	1717717	S	3	0	3	0.00000
Alkalitalea saponilacus	889453	S	1	0	1	0.00000
Haliscomenobacter hydrossis	2350	S	11	0	11	0.00000
Saprospira grandis	1008	S	1	0	1	0.00000
Rhodothermus marinus	29549	S	3	0	3	0.00000
Salinibacter ruber	146919	S	3	0	3	0.00000
Chlorobium phaeobacteroides	1096	S	6	0	6	0.00000
Chlorobium phaeovibrioides	1094	S	1	0	1	0.00000
Prosthecochloris aestuarii	1102	S	3	0	3	0.00000
Candidatus Cyclonatronum proteinivorum	1457365	S	1	0	1	0.00000
Gemmatimonas sp. TET16	2732249	S	7	0	7	0.00000
Gemmatimonas aurantiaca	173480	S	3	0	3	0.00000
Gemmatimonas phototrophica	1379270	S	2	0	2	0.00000
Gemmatirosa kalamazoonesis	861299	S	9	0	9	0.00000
Candidatus Cloacimonas acidaminovorans	456827	S	5	0	5	0.00000
Urbifossiella limnaea	2528023	S	39	2	41	0.00000
Gemmata obscuriglobus	114	S	11	0	11	0.00000
Gemmata massiliana	1210884	S	11	3	14	0.00000
Gemmata sp. SH-PL17	1630693	S	9	3	12	0.00000
Limnoglobus roseus	2598579	S	26	0	26	0.00000
Frigoriglobus tundricola	2774151	S	16	2	18	0.00000
Tuwongella immobilis	692036	S	1	0	1	0.00000
Planctomyces sp. SH-PL14	1632864	S	13	0	13	0.00000
Planctomyces sp. SH-PL62	1636152	S	5	2	7	0.00000
Gimesia panareensis	2527978	S	10	0	10	0.00000
Gimesia algae	2527971	S	2	0	2	0.00000
Gimesia chilikensis	2605989	S	2	0	2	0.00000
Gimesia maris	122	S	1	0	1	0.00000
Gimesia aquarii	2527964	S	1	0	1	0.00000
Gimesia fumaroli	2527976	S	1	0	1	0.00000
Maioricimonas rarisocia	2528026	S	10	0	10	0.00000
Planctopirus ephydatiae	2528019	S	4	0	4	0.00000
Planctopirus limnophila	120	S	2	0	2	0.00000
Fuerstia marisgermanicae	1891926	S	5	0	5	0.00000
Crateriforma conspicua	2527996	S	5	1	6	0.00000
Caulifigura coniformis	2527983	S	5	0	5	0.00000
Thalassoglobus polymorphus	2527994	S	5	0	5	0.00000
Alienimonas californiensis	2527989	S	4	0	4	0.00000
Rubinisphaera brasiliensis	119	S	2	0	2	0.00000
Calycomorphotria hydatis	2528027	S	2	0	2	0.00000
Polystyrenella longa	2528007	S	1	0	1	0.00000
Symmachiella dynata	2527995	S	1	0	1	0.00000
Pirellula sp. SH-Sr6A	1632865	S	5	0	5	0.00000
Pirellula staleyi	125	S	4	0	4	0.00000
Lignipirellula cremea	2528010	S	7	1	8	0.00000
Anatilimnocola aggregata	2528021	S	6	0	6	0.00000
Roseimaritima ulvae	980254	S	5	0	5	0.00000
Rosistilla oblonga	2527990	S	4	0	4	0.00000
Rosistilla carotiformis	2528017	S	1	0	1	0.00000
Rhodopirellula baltica	265606	S	4	0	4	0.00000
Bremerella volcania	2527984	S	4	0	4	0.00000
Stieleria maiorica	2795974	S	4	0	4	0.00000
Mariniblastus fucicola	980251	S	1	0	1	0.00000
Aureliella helgolandensis	2527968	S	1	0	1	0.00000
Lacipirellula limnantheis	2528024	S	11	1	12	0.00000
Lacipirellula parvula	2650471	S	7	0	7	0.00000
Bythopirellula goksoyri	1400387	S	5	0	5	0.00000
Botrimarina mediterranea	2528022	S	3	0	3	0.00000
Aeoliella mucimassa	2527972	S	2	0	2	0.00000
Pirellulimonas nuda	2528009	S	2	0	2	0.00000
Tautonia plasticadhaerens	2527974	S	14	0	14	0.00000
Aquisphaera giovannonii	406548	S	10	1	11	0.00000
Singulisphaera acidiphila	466153	S	5	1	6	0.00000
Isosphaera pallida	128	S	2	0	2	0.00000
Paludisphaera borealis	1387353	S	2	0	2	0.00000
Humisphaera borealis	2807512	S	6	0	6	0.00000
Phycisphaera mikurensis	547188	S	3	0	3	0.00000
Limihaloglobus sulfuriphilus	1851148	S	1	0	1	0.00000
Anaerohalosphaera lusitana	1936003	S	1	0	1	0.00000
Candidatus Kuenenia stuttgartiensis	174633	S	1	0	1	0.00000
Roseimicrobium sp. ORNL1	2711231	S	22	1	23	0.00000
Verrucomicrobium spinosum	2736	S	14	1	15	0.00000
Verrucomicrobium sp. GAS474	1882831	S	4	0	4	0.00000
Luteolibacter luteus	2728835	S	12	0	12	0.00000
Akkermansia muciniphila	239935	S	4	0	4	0.00000
Akkermansia glycaniphila	1679444	S	3	0	3	0.00000
Opitutus sp. GAS368	1882749	S	12	1	13	0.00000
Opitutus terrae	107709	S	8	0	8	0.00000
Nibricoccus aquaticus	2576891	S	5	0	5	0.00000
Ereboglobus luteus	1796921	S	4	0	4	0.00000
Lacunisphaera limnophila	1838286	S	3	0	3	0.00000
Coraliomargarita akajimensis	395922	S	3	0	3	0.00000
Methylacidimicrobium sp. AP8	2730359	S	2	0	2	0.00000
Methylacidimicrobium sp. B4	2796139	S	1	0	1	0.00000
Candidatus Xiphinematobacter sp. Idaho Grape	1704307	S	1	0	1	0.00000
Methylacidiphilum kamchatkense	431057	S	1	0	1	0.00000
Neochlamydia sp. S13	1353976	S	2	0	2	0.00000
Candidatus Protochlamydia naegleriophila	389348	S	1	1	2	0.00000
Parachlamydia acanthamoebae	83552	S	1	0	1	0.00000
Simkania negevensis	83561	S	2	0	2	0.00000
Waddlia chondrophila	71667	S	2	0	2	0.00000
Chlamydia abortus	83555	S	2	1	3	0.00000
Chlamydia avium	1457141	S	1	0	1	0.00000
Kiritimatiella glycovorans	1307763	S	4	4	8	0.00000
Candidatus Vampirococcus archaeovorus	1930593	S	1	0	1	0.00000
Fusobacterium nucleatum	851	S	7	2	9	0.00000
Fusobacterium varium	856	S	4	0	4	0.00000
Fusobacterium necrophorum	859	S	4	0	4	0.00000
Fusobacterium mortiferum	850	S	3	0	3	0.00000
Fusobacterium periodonticum	860	S	3	6	9	0.00000
Fusobacterium pseudoperiodonticum	2663009	S	2	0	2	0.00000
Fusobacterium gonidiaformans	849	S	1	0	1	0.00000
Fusobacterium ulcerans	861	S	1	0	1	0.00000
Fusobacterium hwasookii	1583098	S	1	0	1	0.00000
Ilyobacter polytropus	167642	S	1	0	1	0.00000
Leptotrichia trevisanii	109328	S	4	1	5	0.00000
Leptotrichia sp. oral taxon 212	712357	S	2	0	2	0.00000
Leptotrichia sp. oral taxon 498	712368	S	2	0	2	0.00000
Leptotrichia wadei	157687	S	3	1	4	0.00000
Leptotrichia hofstadii	157688	S	3	1	4	0.00000
Leptotrichia buccalis	40542	S	2	0	2	0.00000
Leptotrichia hongkongensis	554406	S	1	0	1	0.00000
Sebaldella termitidis	826	S	3	0	3	0.00000
Streptobacillus moniliformis	34105	S	1	0	1	0.00000
Sneathia vaginalis	187101	S	1	0	1	0.00000
Borrelia crocidurae	29520	S	3	2	5	0.00000
Borrelia sp. A-FGy1	2608247	S	2	0	2	0.00000
Borrelia hermsii	140	S	1	0	1	0.00000
Borrelia parkeri	141	S	1	-1	0	0.00000
Borrelia miyamotoi	47466	S	1	0	1	0.00000
Borrelia turcica	229155	S	1	0	1	0.00000
Borreliella burgdorferi	139	S	3	1	4	0.00000
Treponema succinifaciens	167	S	2	0	2	0.00000
Treponema socranskii	53419	S	2	0	2	0.00000
Treponema denticola	158	S	1	0	1	0.00000
Treponema brennaborense	81028	S	1	0	1	0.00000
Treponema parvum	138851	S	1	0	1	0.00000
Treponema caldarium	215591	S	1	0	1	0.00000
Treponema sp. RCC2812	2787628	S	1	0	1	0.00000
Sphaerochaeta pleomorpha	1131707	S	3	0	3	0.00000
Spirochaeta thermophila	154	S	2	0	2	0.00000
Leptospira biflexa	172	S	7	-7	0	0.00000
Leptospira interrogans	173	S	4	0	4	0.00000
Leptospira kmetyi	408139	S	2	0	2	0.00000
Leptospira borgpetersenii	174	S	1	0	1	0.00000
Leptospira tipperaryensis	2564040	S	1	0	1	0.00000
Turneriella parva	29510	S	4	0	4	0.00000
Brachyspira pilosicoli	52584	S	4	0	4	0.00000
Brachyspira hyodysenteriae	159	S	3	0	3	0.00000
Brachyspira hampsonii	1287055	S	3	0	3	0.00000
Brachyspira intermedia	84377	S	2	0	2	0.00000
Brachyspira murdochii	84378	S	1	0	1	0.00000
Granulicella mallensis	940614	S	4	0	4	0.00000
Granulicella sp. 5B5	1617967	S	1	0	1	0.00000
Acidobacterium sp. 4Y35	2763107	S	3	0	3	0.00000
Acidobacterium capsulatum	33075	S	1	0	1	0.00000
Terriglobus roseus	392734	S	2	0	2	0.00000
Terriglobus saanensis	870903	S	1	0	1	0.00000
Terriglobus albidus	1592106	S	1	0	1	0.00000
Edaphobacter sp. 4G125	2763071	S	2	0	2	0.00000
Candidatus Koribacter versatilis	658062	S	1	0	1	0.00000
Acidisarcina polymorpha	2211140	S	1	0	1	0.00000
Candidatus Solibacter usitatus	332163	S	4	0	4	0.00000
Paludibaculum fermentans	1473598	S	3	0	3	0.00000
Luteitalea pratensis	1855912	S	10	0	10	0.00000
Thermotomaculum hydrothermale	981385	S	2	0	2	0.00000
Chloracidobacterium thermophilum	458033	S	2	0	2	0.00000
Thermosipho sp. 1070	1437364	S	1	1	2	0.00000
Thermosipho sp. 1063	1462747	S	1	1	2	0.00000
Thermosipho sp. FR-w03	2814656	S	1	0	1	0.00000
Thermosipho melanesiensis	46541	S	1	0	1	0.00000
Fervidobacterium nodosum	2424	S	1	0	1	0.00000
Tepiditoga spiralis	2108365	S	3	0	3	0.00000
Petrotoga mobilis	69499	S	1	0	1	0.00000
Defluviitoga tunisiensis	1006576	S	1	0	1	0.00000
Mesotoga infera	1236046	S	1	0	1	0.00000
Athalassotoga saccharophila	1441386	S	1	0	1	0.00000
Candidatus Nitrospira inopinata	1715989	S	4	1	5	0.00000
Nitrospira moscoviensis	42253	S	2	0	2	0.00000
Nitrospira sp. KM1	1936990	S	1	0	1	0.00000
Leptospirillum ferrooxidans	180	S	1	1	2	0.00000
Candidatus Babela massiliensis	673862	S	5	0	5	0.00000
Candidatus Saccharimonas aalborgensis	1332188	S	3	0	3	0.00000
Candidatus Bipolaricaulis anaerobius	2026885	S	2	0	2	0.00000
Deferribacter desulfuricans	197162	S	5	0	5	0.00000
Denitrovibrio acetiphilus	118000	S	1	0	1	0.00000
Fretibacterium fastidiosum	651822	S	4	0	4	0.00000
Aminomonas paucivorans	81412	S	1	0	1	0.00000
Jonquetella anthropi	428712	S	1	0	1	0.00000
Thermodesulfobacterium commune	1741	S	1	0	1	0.00000
Thermodesulfobacterium geofontis	1295609	S	1	0	1	0.00000
Thermodesulfatator indicus	171695	S	2	0	2	0.00000
Thermosulfuriphilus ammonigenes	1936021	S	1	0	1	0.00000
Caldithrix abyssi	187145	S	4	0	4	0.00000
Thermocrinis ruber	75906	S	1	0	1	0.00000
Thermocrinis minervae	381751	S	1	0	1	0.00000
Hydrogenobaculum sp. Y04AAS1	380749	S	1	0	1	0.00000
Dictyoglomus turgidum	513050	S	1	1	2	0.00000
Caldisericum exile	693075	S	2	0	2	0.00000
Endomicrobium proavitum	1408281	S	1	0	1	0.00000
Abyssogena phaseoliformis symbiont	596095	S	1	0	1	0.00000
Haloterrigena salifodinae	2675099	S	3	0	3	0.00000
Haloterrigena longa	370324	S	1	0	1	0.00000
Haloterrigena daqingensis	588898	S	1	0	1	0.00000
Haloterrigena sp. KZCA68	2816475	S	1	0	1	0.00000
Natrinema versiforme	88724	S	2	0	2	0.00000
Natrinema pellirubrum	69525	S	1	0	1	0.00000
Natrinema pallidum	69527	S	1	0	1	0.00000
Halovivax ruber	387341	S	2	0	2	0.00000
Halovivax sp. KZCA124	2817025	S	2	0	2	0.00000
Halopiger xanaduensis	387343	S	4	0	4	0.00000
Natrialba magadii	13769	S	3	0	3	0.00000
Natronorubrum aibiense	348826	S	1	0	1	0.00000
Salinarchaeum sp. Harcht-Bsk1	1333523	S	1	0	1	0.00000
Halosimplex litoreum	1198301	S	6	0	6	0.00000
Halosimplex rubrum	869889	S	3	0	3	0.00000
Natronomonas sp. YPL13	1710540	S	2	0	2	0.00000
Natronomonas moolapensis	416273	S	1	0	1	0.00000
Halorientalis sp. IM1011	1932360	S	2	0	2	0.00000
Halorhabdus sp. CBA1104	1380432	S	1	0	1	0.00000
Halapricum salinum	1457250	S	1	0	1	0.00000
Salarchaeum sp. JOR-1	2599399	S	2	0	2	0.00000
Halanaeroarchaeum sulfurireducens	1604004	S	2	0	2	0.00000
Halobacterium hubeiense	1407499	S	1	0	1	0.00000
Haloferax mediterranei	2252	S	2	0	2	0.00000
Haloferax gibbonsii	35746	S	1	0	1	0.00000
Haloferax alexandrinus	114529	S	1	0	1	0.00000
Haloplanus rallus	1816183	S	2	0	2	0.00000
Halobellus limi	699433	S	1	0	1	0.00000
Halorubrum sp. BOL3-1	2497325	S	2	2	4	0.00000
Halorubrum trapanicum	29284	S	2	0	2	0.00000
Methanosarcina mazei	2209	S	5	0	5	0.00000
Methanosarcina barkeri	2208	S	2	0	2	0.00000
Methanosarcina thermophila	2210	S	1	0	1	0.00000
Methanocella paludicola	570267	S	2	0	2	0.00000
Methanocella arvoryzae	1175445	S	2	0	2	0.00000
Methanococcus maripaludis	39152	S	4	2	6	0.00000
Methanococcus aeolicus	42879	S	2	0	2	0.00000
Methanothermococcus okinawensis	155863	S	3	0	3	0.00000
Methanocaldococcus jannaschii	2190	S	1	0	1	0.00000
Methanocaldococcus fervens	83171	S	1	0	1	0.00000
Methanocaldococcus sp. FS406-22	644281	S	1	0	1	0.00000
Methanobacterium formicicum	2162	S	2	1	3	0.00000
Methanobacterium congolense	118062	S	1	0	1	0.00000
Methanosphaera sp. BMS	1789762	S	2	0	2	0.00000
Methanobrevibacter sp. AbM4	224719	S	1	0	1	0.00000
Methanothermus fervidus	2180	S	2	0	2	0.00000
Thermococcus profundus	49899	S	3	0	3	0.00000
Thermococcus sp. 4557	1042877	S	1	0	1	0.00000
Thermococcus sp. IRI35c	2016373	S	1	0	1	0.00000
Thermococcus litoralis	2265	S	1	0	1	0.00000
Thermococcus paralvinellae	582419	S	1	0	1	0.00000
Thermococcus guaymasensis	110164	S	1	0	1	0.00000
Palaeococcus pacificus	971279	S	1	0	1	0.00000
Archaeoglobus fulgidus	2234	S	2	-2	0	0.00000
Sulfolobus sp. A20	1891280	S	1	0	1	0.00000
Sulfolobus sp. E5-1-F	2663019	S	1	1	2	0.00000
Sulfolobus acidocaldarius	2285	S	1	0	1	0.00000
Acidianus sulfidivorans	312539	S	1	0	1	0.00000
Acidianus hospitalis	563177	S	1	0	1	0.00000
Saccharolobus solfataricus	2287	S	2	2	4	0.00000
Pyrobaculum calidifontis	181486	S	2	0	2	0.00000
Pyrobaculum neutrophilum	70771	S	1	0	1	0.00000
Thermoproteus uzoniensis	184117	S	1	0	1	0.00000
Thermofilum adornatum	1365176	S	1	0	1	0.00000
Fervidicoccus fontis	683846	S	2	0	2	0.00000
Caldisphaera lagunensis	200415	S	2	0	2	0.00000
Aeropyrum pernix	56636	S	1	0	1	0.00000
Candidatus Nitrosopumilus sediminis	1229909	S	2	0	2	0.00000
Candidatus Nitrosopumilus koreensis	1510466	S	2	0	2	0.00000
Nitrosopumilus ureiphilus	1470067	S	1	0	1	0.00000
Nitrosopumilus piranensis	1582439	S	1	0	1	0.00000
Nitrosarchaeum sp. AC2	2259673	S	3	0	3	0.00000
Candidatus Nitrosomarinus catalina	1898749	S	1	0	1	0.00000
Candidatus Nitrosopelagicus brevis	1410606	S	1	0	1	0.00000
Candidatus Nitrosotenuis aquarius	1846278	S	1	0	1	0.00000
Candidatus Nitrosocosmicus oleophilus	1353260	S	1	0	1	0.00000
Candidatus Nitrosocosmicus hydrocola	1826872	S	1	0	1	0.00000
Candidatus Prometheoarchaeum syntrophicum	2594042	S	5	0	5	0.00000
Thermoplasma acidophilum	2303	S	1	1	2	0.00000
Flavobacterium phage vB_FspS_filifjonk9-1	2686245	S	21	24	45	0.00000
Flavobacterium phage vB_FspS_tooticki6-1	2686279	S	6	15	21	0.00000
Flavobacterium phage vB_FspS_mymlan6-1	2686266	S	4	8	12	0.00000
Staphylococcus phage StB12	1147042	S	2	0	2	0.00000
Flavobacterium phage vB_FspS_snusmum6-1	2686273	S	2	1	3	0.00000
Flavobacterium phage vB_FspS_hattifnatt9-1	2686246	S	2	0	2	0.00000
Flavobacterium phage vB_FspS_snork6-1	2686270	S	2	11	13	0.00000
Sinorhizobium phage phiLM21	1524882	S	2	0	2	0.00000
Streptomyces phage Wofford	2283267	S	1	0	1	0.00000
Salicola phage CGphi29	754067	S	1	0	1	0.00000
Gordonia phage GMA1	1647470	S	1	0	1	0.00000
Pseudomonas phage Epa5	2719575	S	1	0	1	0.00000
Anoxybacillus phage A403	2099336	S	1	0	1	0.00000
Streptococcus phage SpSL1	1566990	S	1	0	1	0.00000
Cellulophaga phage phi19:1	1327970	S	1	0	1	0.00000
Proteus virus Isfahan	2560650	S	63	0	63	0.00000
Propionibacterium virus PHL152M00	1982295	S	1	0	1	0.00000
Propionibacterium virus Kubed	1982256	S	1	0	1	0.00000
Propionibacterium virus PHL070N00	1982279	S	1	0	1	0.00000
Propionibacterium virus P100A	1982265	S	1	0	1	0.00000
Propionibacterium virus PHL132N00	1982291	S	1	0	1	0.00000
Lactococcus phage M6162	1862961	S	1	2	3	0.00000
Lactococcus virus c2	31537	S	1	0	1	0.00000
Cellulophaga virus Cba121	1918193	S	2	1	3	0.00000
Caulobacter virus CcrBL9	2734192	S	1	0	1	0.00000
Caulobacter virus CcrPW	2734195	S	1	0	1	0.00000
Xanthomonas virus Xp10	232237	S	1	0	1	0.00000
Mycobacterium phage Aminay	2250291	S	1	0	1	0.00000
Xylella virus Sano	2560848	S	1	0	1	0.00000
Pseudomonas phage PaMx42	1175662	S	1	0	1	0.00000
Staphylococcus virus SEP9	1922247	S	1	0	1	0.00000
Gordonia virus Wizard	2170254	S	1	0	1	0.00000
Salmonella phage TS13	2500149	S	1	0	1	0.00000
Mycobacterium phage Bromden	2283252	S	1	0	1	0.00000
Mycobacterium phage DrLupo	2499037	S	1	0	1	0.00000
Polaribacter virus P12002L	1982245	S	1	0	1	0.00000
Flavobacterium phage Fpv20	1814283	S	1	43	44	0.00000
Rhodoferax phage P26218	1636270	S	5	0	5	0.00000
Cellulophaga phage phi14:2	1327990	S	2	0	2	0.00000
Cellulophaga phage phi18:3	1327983	S	1	0	1	0.00000
Pseudomonas phage O4	1784982	S	1	0	1	0.00000
Sulfitobacter phage NYA-2014a	1526550	S	1	4	5	0.00000
Serratia phage Parlo	2557554	S	1	0	1	0.00000
Sinorhizobium phage PBC5	179237	S	1	0	1	0.00000
Dinoroseobacter virus DFL12	2169868	S	1	0	1	0.00000
Sulfitobacter phage EE36phi1	490913	S	1	0	1	0.00000
Pseudomonas virus phCDa	2734187	S	1	0	1	0.00000
Escherichia virus Pollock	2170215	S	1	0	1	0.00000
Prochlorococcus phage P-TIM68	1542477	S	3	0	3	0.00000
Microcystis phage MaMV-DC	1357715	S	1	2	3	0.00000
Pseudomonas phage Persinger	2749430	S	1	0	1	0.00000
Rhizobium phage vB_RleM_PPF1	1498228	S	1	0	1	0.00000
Escherichia virus T4	10665	S	1	1	2	0.00000
Acinetobacter phage ZZ1	1049283	S	1	0	1	0.00000
Escherichia virus HX01	1914155	S	1	0	1	0.00000
Aeromonas virus 56	2560283	S	3	0	3	0.00000
Synechococcus virus ST4	2734145	S	3	0	3	0.00000
Acinetobacter virus AbP2	2560264	S	1	1	2	0.00000
Dickeya virus JA29	2734142	S	2	0	2	0.00000
Synechococcus virus AC2014fSyn7803C8	2734085	S	1	0	1	0.00000
Aeromonas virus 31	321023	S	1	0	1	0.00000
Prochlorococcus virus PSSM2	2734140	S	1	0	1	0.00000
Cronobacter virus GAP32	2560400	S	1	0	1	0.00000
Arthrobacter phage DrYang	2686080	S	1	0	1	0.00000
Synechococcus phage S-CAM8	754038	S	1	0	1	0.00000
Serratia virus CHI14	2560752	S	1	0	1	0.00000
Tetrasphaera virus TJE1	2560802	S	1	0	1	0.00000
Rheinheimera virus Barba19A	2734091	S	1	0	1	0.00000
Yersinia virus Yen9-04	2560849	S	1	0	1	0.00000
Curvibacter virus P26059B	2733926	S	4	0	4	0.00000
Pseudomonas phage PA11	347327	S	1	0	1	0.00000
Acinetobacter virus Petty	2733321	S	1	0	1	0.00000
Aeromonas virus AhSzw1	2733999	S	2	0	2	0.00000
Human betaherpesvirus 7	10372	S	8	0	8	0.00000
Leporid alphaherpesvirus 4	481315	S	1	0	1	0.00000
Canid alphaherpesvirus 1	170325	S	1	0	1	0.00000
Human gammaherpesvirus 4	10376	S	1	0	1	0.00000
Yellowstone lake phycodnavirus 2	1586714	S	3	0	3	0.00000
Yellowstone lake phycodnavirus 1	1586713	S	1	0	1	0.00000
Yellowstone lake phycodnavirus 3	1586715	S	1	0	1	0.00000
Paramecium bursaria Chlorella virus A1	381899	S	3	0	3	0.00000
Paramecium bursaria Chlorella virus 1	10506	S	1	0	1	0.00000
Orpheovirus IHUMI-LCC2	2023057	S	2	0	2	0.00000
Chrysochromulina ericina virus	455364	S	1	0	1	0.00000
Aureococcus anophagefferens virus	1474867	S	1	0	1	0.00000
Heterosigma akashiwo virus 01	97195	S	1	0	1	0.00000
Invertebrate iridescent virus 22	345198	S	1	1	2	0.00000
Moumouvirus	985782	S	1	0	1	0.00000
Choristoneura biennis entomopoxvirus	10288	S	1	0	1	0.00000
Anomala cuprea entomopoxvirus	62099	S	1	0	1	0.00000
Mimivirus-dependent virus Sputnik	1932927	S	1	0	1	0.00000
Deer mastadenovirus B	2170000	S	1	0	1	0.00000
Heliothis zea nudivirus	29250	S	5	0	5	0.00000
Esparto virus	2072209	S	1	0	1	0.00000
Lymantria dispar multiple nucleopolyhedrovirus	10449	S	3	0	3	0.00000
Hemileuca species nucleopolyhedrovirus	2560521	S	1	0	1	0.00000
Mollivirus sibericum	1678078	S	2	0	2	0.00000
Gokushovirinae Bog5712_52	1655649	S	1	0	1	0.00000
Taro bacilliform virus	178354	S	1	0	1	0.00000
