name	taxonomy_id	taxonomy_lvl	kraken_assigned_reads	added_reads	new_est_reads	fraction_total_reads
Homo sapiens	9606	S	1505389	2905	1508294	0.92317
Acidovorax sp. KKS102	358220	S	436	186	622	0.00038
Acidovorax sp. 1608163	2478662	S	225	33	258	0.00016
Acidovorax sp. JMULE5	2518343	S	177	33	210	0.00013
Acidovorax sp. T1	1858609	S	141	281	422	0.00026
Acidovorax sp. RAC01	1842533	S	81	29	110	0.00007
Acidovorax sp. HDW3	2714923	S	57	14	71	0.00004
Acidovorax sp. JS42	232721	S	25	497	522	0.00032
Acidovorax carolinensis	553814	S	201	145	346	0.00021
Acidovorax antarcticus	2743470	S	88	35	123	0.00008
Acidovorax avenae	80867	S	85	42	127	0.00008
Acidovorax monticola	1926868	S	55	13	68	0.00004
Acidovorax citrulli	80869	S	25	22	47	0.00003
Acidovorax cattleyae	80868	S	22	13	35	0.00002
Acidovorax ebreus	721785	S	2	22	24	0.00001
Variovorax sp. PAMC 28711	1795631	S	84	8	92	0.00006
Variovorax sp. HW608	1034889	S	66	6	72	0.00004
Variovorax sp. PAMC28562	2762323	S	49	2	51	0.00003
Variovorax sp. WDL1	207745	S	45	45	90	0.00006
Variovorax sp. RKNM96	2681552	S	44	16	60	0.00004
Variovorax sp. PBL-H6	434009	S	36	47	83	0.00005
Variovorax sp. RA8	662548	S	31	22	53	0.00003
Variovorax sp. PAMC26660	2762322	S	31	6	37	0.00002
Variovorax sp. 38R	2774875	S	30	36	66	0.00004
Variovorax sp. PBS-H4	434008	S	29	11	40	0.00002
Variovorax sp. SRS16	282217	S	21	49	70	0.00004
Variovorax sp. PBL-E5	434014	S	18	51	69	0.00004
Variovorax sp. PMC12	2126319	S	2	105	107	0.00007
Variovorax sp. PDNC026	2811425	S	1	39	40	0.00002
Variovorax paradoxus	34073	S	282	109	391	0.00024
Variovorax boronicumulans	436515	S	83	76	159	0.00010
Rhodoferax sp. AJA081-3	2752316	S	147	15	162	0.00010
Rhodoferax sp. PAMC29310	2822760	S	103	19	122	0.00007
Rhodoferax sp. BAB1	2741720	S	90	21	111	0.00007
Rhodoferax sediminis	2509614	S	217	26	243	0.00015
Rhodoferax saidenbachensis	1484693	S	198	27	225	0.00014
Rhodoferax ferrireducens	192843	S	109	8	117	0.00007
Rhodoferax koreense	1842727	S	108	49	157	0.00010
Rhodoferax antarcticus	81479	S	84	7	91	0.00006
Hydrogenophaga sp. RAC07	1842537	S	86	29	115	0.00007
Hydrogenophaga sp. PAMC20947	2565558	S	78	3	81	0.00005
Hydrogenophaga sp. PBL-H3	434010	S	73	56	129	0.00008
Hydrogenophaga sp. BPS33	2651974	S	73	29	102	0.00006
Hydrogenophaga sp. PBC	795665	S	63	32	95	0.00006
Hydrogenophaga sp. BA0156	2716225	S	62	30	92	0.00006
Hydrogenophaga sp. YM1	2806262	S	60	23	83	0.00005
Hydrogenophaga sp. NH-16	2184519	S	33	60	93	0.00006
Hydrogenophaga crassostreae	1763535	S	72	2	74	0.00005
Hydrogenophaga pseudoflava	47421	S	39	51	90	0.00006
Limnohabitans sp. 103DPR2	1678129	S	336	23	359	0.00022
Limnohabitans sp. 63ED37-2	1678128	S	318	30	348	0.00021
Comamonas testosteroni	285	S	116	134	250	0.00015
Comamonas aquatica	225991	S	95	30	125	0.00008
Comamonas kerstersii	225992	S	61	15	76	0.00005
Comamonas piscis	1562974	S	59	7	66	0.00004
Comamonas thiooxydans	363952	S	56	64	120	0.00007
Comamonas koreensis	160825	S	48	9	57	0.00003
Comamonas serinivorans	1082851	S	45	7	52	0.00003
Comamonas sp. NLF-7-7	2597701	S	36	12	48	0.00003
Polaromonas sp. JS666	296591	S	130	6	136	0.00008
Polaromonas sp. H6N	1840293	S	5	0	5	0.00000
Polaromonas sp. E10S	1840239	S	2	28	30	0.00002
Polaromonas sp. E5S	1840267	S	2	88	90	0.00006
Polaromonas sp. H8N	1840297	S	1	0	1	0.00000
Polaromonas naphthalenivorans	216465	S	243	27	270	0.00017
Polaromonas vacuolata	37448	S	67	9	76	0.00005
Diaphorobacter sp. HDW4A	2714924	S	85	53	138	0.00008
Diaphorobacter sp. HDW4B	2714925	S	56	4	60	0.00004
Diaphorobacter sp. JS3051	2792224	S	10	196	206	0.00013
Diaphorobacter sp. JS3050	2735554	S	9	189	198	0.00012
Diaphorobacter aerolatus	1288495	S	71	74	145	0.00009
Diaphorobacter ruginosibacter	1715720	S	38	4	42	0.00003
Diaphorobacter polyhydroxybutyrativorans	1546149	S	11	84	95	0.00006
Curvibacter sp. AEP1-3	1844971	S	291	14	305	0.00019
Ottowia sp. 27C	2816950	S	93	10	103	0.00006
Ottowia sp. oral taxon 894	1658672	S	53	4	57	0.00003
Ottowia oryzae	2109914	S	132	16	148	0.00009
Delftia acidovorans	80866	S	66	110	176	0.00011
Delftia sp. Cs1-4	742013	S	8	17	25	0.00002
Delftia sp. KV29	1170710	S	8	473	481	0.00029
Delftia sp. HK171	1920191	S	5	12	17	0.00001
Delftia lacustris	558537	S	17	87	104	0.00006
Delftia tsuruhatensis	180282	S	14	51	65	0.00004
Kinneretia sp. DAIF2	2714952	S	124	29	153	0.00009
Ramlibacter tataouinensis	94132	S	117	17	134	0.00008
Simplicispira suum	2109915	S	104	25	129	0.00008
Hylemonella gracilis	80880	S	93	8	101	0.00006
Alicycliphilus denitrificans	179636	S	92	160	252	0.00015
Serpentinomonas raichei	1458425	S	40	11	51	0.00003
Serpentinomonas mccroryi	1458426	S	35	10	45	0.00003
Schlegelella thermodepolymerans	215580	S	87	25	112	0.00007
Verminephrobacter eiseniae	364317	S	51	2	53	0.00003
Melaminivora sp. SC2-9	2109913	S	36	16	52	0.00003
Pulveribacter suum	2116657	S	36	8	44	0.00003
Candidatus Symbiobacter mobilis	1436290	S	23	0	23	0.00001
Polynucleobacter necessarius	576610	S	352	30	382	0.00023
Polynucleobacter duraquae	1835254	S	193	31	224	0.00014
Polynucleobacter asymbioticus	576611	S	100	17	117	0.00007
Polynucleobacter difficilis	556054	S	55	3	58	0.00004
Polynucleobacter wuianus	1743168	S	42	13	55	0.00003
Polynucleobacter sp. MWH-UH21B	1743174	S	27	3	30	0.00002
Polynucleobacter sp. LimPoW16	1743162	S	15	0	15	0.00001
Polynucleobacter paneuropaeus	2527775	S	30	2	32	0.00002
Polynucleobacter acidiphobus	556053	S	12	0	12	0.00001
Burkholderia multivorans	87883	S	24	12	36	0.00002
Burkholderia cepacia	292	S	21	28	49	0.00003
Burkholderia pyrrocinia	60550	S	17	11	28	0.00002
Burkholderia lata	482957	S	17	11	28	0.00002
Burkholderia vietnamiensis	60552	S	16	60	76	0.00005
Burkholderia cenocepacia	95486	S	13	25	38	0.00002
Burkholderia contaminans	488447	S	11	8	19	0.00001
Burkholderia ubonensis	101571	S	10	23	33	0.00002
Burkholderia anthina	179879	S	9	8	17	0.00001
Burkholderia stabilis	95485	S	9	7	16	0.00001
Burkholderia stagnalis	1503054	S	6	3	9	0.00001
Burkholderia ambifaria	152480	S	4	5	9	0.00001
Burkholderia metallica	488729	S	3	1	4	0.00000
Burkholderia seminalis	488731	S	3	1	4	0.00000
Burkholderia diffusa	488732	S	3	1	4	0.00000
Burkholderia pseudomultivorans	1207504	S	3	4	7	0.00000
Burkholderia territorii	1503055	S	3	1	4	0.00000
Burkholderia latens	488446	S	2	5	7	0.00000
Burkholderia sp. CCGE1003	640512	S	11	3	14	0.00001
Burkholderia sp. Bp7605	1740163	S	11	1	12	0.00001
Burkholderia sp. LA-2-3-30-S1-D2	1637862	S	8	5	13	0.00001
Burkholderia sp. DHOD12	2571746	S	7	0	7	0.00000
Burkholderia sp. PAMC 26561	1795043	S	6	4	10	0.00001
Burkholderia sp. KK1	1855726	S	4	5	9	0.00001
Burkholderia sp. RPE67	758796	S	4	6	10	0.00001
Burkholderia sp. THE68	758782	S	3	0	3	0.00000
Burkholderia sp. PAMC 28687	1795874	S	3	4	7	0.00000
Burkholderia sp. YI23	1097668	S	2	3	5	0.00000
Burkholderia sp. MS455	2811788	S	2	1	3	0.00000
Burkholderia sp. MSMB0856	1637869	S	2	1	3	0.00000
Burkholderia sp. NRF60-BP8	1637853	S	1	0	1	0.00000
Burkholderia sp. MS389	2811789	S	1	0	1	0.00000
Burkholderia pseudomallei	28450	S	25	43	68	0.00004
Burkholderia thailandensis	57975	S	8	2	10	0.00001
Burkholderia sp. MSMB617WGS	1637831	S	7	12	19	0.00001
Burkholderia sp. MSMB0852	1637841	S	4	5	9	0.00001
Burkholderia oklahomensis	342113	S	3	1	4	0.00000
Burkholderia sp. BDU8	1385592	S	3	0	3	0.00000
Burkholderia sp. BDU6	1385591	S	2	0	2	0.00000
Burkholderia sp. MSMB0266	1637837	S	2	1	3	0.00000
Burkholderia gladioli	28095	S	25	10	35	0.00002
Burkholderia glumae	337	S	18	7	25	0.00002
Burkholderia plantarii	41899	S	9	1	10	0.00001
Cupriavidus taiwanensis	164546	S	73	55	128	0.00008
Cupriavidus necator	106590	S	51	16	67	0.00004
Cupriavidus basilensis	68895	S	45	23	68	0.00004
Cupriavidus metallidurans	119219	S	31	26	57	0.00003
Cupriavidus oxalaticus	96344	S	26	11	37	0.00002
Cupriavidus pauculus	82633	S	22	7	29	0.00002
Cupriavidus campinensis	151783	S	18	8	26	0.00002
Cupriavidus pinatubonensis	248026	S	13	5	18	0.00001
Cupriavidus nantongensis	1796606	S	8	17	25	0.00002
Cupriavidus gilardii	82541	S	7	43	50	0.00003
Cupriavidus neocaledonicus	1040979	S	6	9	15	0.00001
Paraburkholderia sp. SOS3	1926494	S	63	5	68	0.00004
Paraburkholderia sp. 7MH5	2547399	S	10	1	11	0.00001
Paraburkholderia sp. PGU19	2735434	S	10	7	17	0.00001
Paraburkholderia sp. PGU16	2735433	S	6	2	8	0.00000
Paraburkholderia sp. Msb3	2604047	S	3	2	5	0.00000
Paraburkholderia aromaticivorans	2026199	S	33	15	48	0.00003
Paraburkholderia phytofirmans	261302	S	27	14	41	0.00003
Paraburkholderia megapolitana	420953	S	17	1	18	0.00001
Paraburkholderia tropica	92647	S	17	3	20	0.00001
Paraburkholderia acidisoli	2571748	S	12	2	14	0.00001
Paraburkholderia phymatum	148447	S	10	3	13	0.00001
Paraburkholderia caledonica	134536	S	10	1	11	0.00001
Paraburkholderia terricola	169427	S	9	2	11	0.00001
Paraburkholderia phenoliruptrix	252970	S	9	4	13	0.00001
Paraburkholderia caribensis	75105	S	9	5	14	0.00001
Paraburkholderia atlantica	2654982	S	8	1	9	0.00001
Paraburkholderia xenovorans	36873	S	8	7	15	0.00001
Paraburkholderia fungorum	134537	S	7	1	8	0.00000
Paraburkholderia sprentiae	948107	S	7	1	8	0.00000
Paraburkholderia hospita	169430	S	6	6	12	0.00001
Paraburkholderia ginsengisoli	311231	S	6	1	7	0.00000
Paraburkholderia caffeinilytica	1761016	S	6	1	7	0.00000
Paraburkholderia dokdonella	2211211	S	6	1	7	0.00000
Paraburkholderia graminis	60548	S	5	1	6	0.00000
Paraburkholderia acidiphila	2571747	S	3	0	3	0.00000
Paraburkholderia terrae	311230	S	3	4	7	0.00000
Paraburkholderia acidophila	265293	S	2	5	7	0.00000
Ralstonia solanacearum	305	S	60	42	102	0.00006
Ralstonia pickettii	329	S	33	18	51	0.00003
Ralstonia insidiosa	190721	S	32	10	42	0.00003
Ralstonia mannitolilytica	105219	S	13	10	23	0.00001
blood disease bacterium A2-HR MARDI	1944648	S	1	49	50	0.00003
Ralstonia pseudosolanacearum	1310165	S	1	3	4	0.00000
Pandoraea pnomenusa	93220	S	17	7	24	0.00001
Pandoraea thiooxydans	445709	S	15	0	15	0.00001
Pandoraea vervacti	656178	S	14	3	17	0.00001
Pandoraea faecigallinarum	656179	S	14	3	17	0.00001
Pandoraea oxalativorans	573737	S	13	5	18	0.00001
Pandoraea apista	93218	S	11	3	14	0.00001
Pandoraea norimbergensis	93219	S	11	1	12	0.00001
Pandoraea pulmonicola	93221	S	11	1	12	0.00001
Pandoraea fibrosis	1891094	S	11	3	14	0.00001
Pandoraea sputorum	93222	S	8	2	10	0.00001
Pandoraea sp. XY-2	2518599	S	1	0	1	0.00000
Caballeronia sp. M1242	2814653	S	7	2	9	0.00001
Caballeronia sp. SBC2	2705547	S	2	14	16	0.00001
Caballeronia insecticola	758793	S	10	2	12	0.00001
Lautropia mirabilis	47671	S	13	1	14	0.00001
Mycoavidus cysteinexigens	1553431	S	9	1	10	0.00001
Limnobacter sp. SAORIC-580	2732163	S	7	0	7	0.00000
Ephemeroptericola cinctiostellae	2268024	S	6	0	6	0.00000
Mycetohabitans rhizoxinica	412963	S	3	0	3	0.00000
Chitinimonas arctica	2594795	S	1	0	1	0.00000
Massilia sp. CCM 8941	2765360	S	87	37	124	0.00008
Massilia sp. NR 4-1	1678028	S	85	22	107	0.00007
Massilia sp. WG5	1707785	S	56	41	97	0.00006
Massilia sp. YMA4	1593482	S	52	40	92	0.00006
Massilia sp. LPB0304	2769491	S	43	27	70	0.00004
Massilia violaceinigra	2045208	S	78	27	105	0.00006
Massilia putida	1141883	S	64	27	91	0.00006
Massilia flava	871742	S	44	10	54	0.00003
Massilia umbonata	864828	S	39	18	57	0.00003
Massilia armeniaca	2072590	S	39	24	63	0.00004
Massilia oculi	945844	S	36	8	44	0.00003
Massilia albidiflava	321983	S	34	16	50	0.00003
Massilia lutea	321985	S	23	7	30	0.00002
Massilia plicata	321984	S	22	6	28	0.00002
Janthinobacterium sp. 1_2014MBL_MicDiv	1644131	S	53	17	70	0.00004
Janthinobacterium sp. Marseille	375286	S	30	8	38	0.00002
Janthinobacterium sp. LM6	1938606	S	29	17	46	0.00003
Janthinobacterium sp. HH102	1537274	S	15	36	51	0.00003
Janthinobacterium sp. 17J80-10	2497863	S	13	1	14	0.00001
Janthinobacterium sp. B9-8	1236179	S	12	4	16	0.00001
Janthinobacterium sp. PLB02	2808899	S	8	19	27	0.00002
Janthinobacterium agaricidamnosum	55508	S	75	41	116	0.00007
Janthinobacterium svalbardensis	368607	S	47	29	76	0.00005
Janthinobacterium tructae	2590869	S	44	28	72	0.00004
Janthinobacterium lividum	29581	S	25	43	68	0.00004
Duganella sp. AF9R3	2728021	S	325	63	388	0.00024
Duganella sp. GN2-R2	2728020	S	52	19	71	0.00004
Undibacterium sp. KW1	2058624	S	88	34	122	0.00007
Undibacterium sp. YM2	2058625	S	76	30	106	0.00006
Undibacterium parvum	401471	S	75	8	83	0.00005
Herbaspirillum robiniae	2014887	S	41	12	53	0.00003
Herbaspirillum seropedicae	964	S	34	11	45	0.00003
Herbaspirillum hiltneri	341045	S	31	3	34	0.00002
Herbaspirillum rubrisubalbicans	80842	S	26	7	33	0.00002
Herbaspirillum sp. meg3	2025949	S	26	2	28	0.00002
Herbaspirillum frisingense	92645	S	19	5	24	0.00001
Herbaspirillum huttiense	863372	S	17	6	23	0.00001
Collimonas pratensis	279113	S	59	15	74	0.00005
Collimonas fungivorans	158899	S	35	8	43	0.00003
Collimonas arenae	279058	S	23	3	26	0.00002
Noviherbaspirillum sp. UKPF54	2601898	S	18	2	20	0.00001
Glaciimonas sp. PAMC28666	2807626	S	13	0	13	0.00001
Herminiimonas arsenitoxidans	1809410	S	11	2	13	0.00001
Oxalobacter formigenes	847	S	4	0	4	0.00000
Rhizobacter gummiphilus	946333	S	183	33	216	0.00013
Rhizobacter sp. AJA081-3	2753607	S	174	38	212	0.00013
Sphaerotilus natans	34103	S	258	82	340	0.00021
Leptothrix cholodnii	34029	S	250	73	323	0.00020
Methylibium sp. Pch-M	2082386	S	37	34	71	0.00004
Methylibium sp. T29	1430884	S	4	15	19	0.00001
Methylibium petroleiphilum	105560	S	51	41	92	0.00006
Rubrivivax gelatinosus	28068	S	128	35	163	0.00010
Aquabacterium olei	1296669	S	122	32	154	0.00009
Thiomonas intermedia	926	S	34	9	43	0.00003
Thiomonas sp. X19	1050370	S	26	6	32	0.00002
Thiomonas arsenitoxydans	426114	S	14	18	32	0.00002
Paucibacter sp. KCTC 42545	1768242	S	96	19	115	0.00007
Mitsuaria sp. 7	1658665	S	86	17	103	0.00006
Roseateles depolymerans	76731	S	72	14	86	0.00005
Inhella inkyongensis	392593	S	57	8	65	0.00004
Xylophilus rhododendri	2697032	S	52	15	67	0.00004
Achromobacter xylosoxidans	85698	S	50	39	89	0.00005
Achromobacter sp. MFA1 R4	1881016	S	19	3	22	0.00001
Achromobacter sp. AONIH1	1758194	S	11	6	17	0.00001
Achromobacter sp. B7	2282475	S	11	1	12	0.00001
Achromobacter spanius	217203	S	36	7	43	0.00003
Achromobacter insolitus	217204	S	20	3	23	0.00001
Achromobacter denitrificans	32002	S	18	8	26	0.00002
Achromobacter pestifer	1353889	S	7	4	11	0.00001
Achromobacter deleyi	1353891	S	5	4	9	0.00001
Achromobacter ruhlandii	72557	S	2	46	48	0.00003
Bordetella sp. N	1746199	S	23	2	25	0.00002
Bordetella sp. H567	1697043	S	3	0	3	0.00000
Bordetella petrii	94624	S	25	22	47	0.00003
Bordetella genomosp. 9	1416803	S	16	2	18	0.00001
Bordetella hinzii	103855	S	15	4	19	0.00001
Bordetella bronchialis	463025	S	15	1	16	0.00001
Bordetella flabilis	463014	S	14	0	14	0.00001
Bordetella pseudohinzii	1331258	S	13	4	17	0.00001
Bordetella genomosp. 8	1416806	S	12	1	13	0.00001
Bordetella trematum	123899	S	8	2	10	0.00001
Bordetella genomosp. 13	463040	S	8	3	11	0.00001
Bordetella avium	521	S	6	0	6	0.00000
Bordetella bronchiseptica	518	S	5	25	30	0.00002
Bordetella holmesii	35814	S	4	0	4	0.00000
Bordetella parapertussis	519	S	2	19	21	0.00001
Bordetella pertussis	520	S	1	7	8	0.00000
Bordetella genomosp. 6	463024	S	1	2	3	0.00000
Alcaligenes faecalis	511	S	33	8	41	0.00003
Alcaligenes aquatilis	323284	S	6	10	16	0.00001
Alcaligenes sp. SORT26	2813780	S	4	0	4	0.00000
Pigmentiphaga aceris	1940612	S	22	2	24	0.00001
Pigmentiphaga sp. H8	2488560	S	15	1	16	0.00001
Orrella dioscoreae	1851544	S	24	5	29	0.00002
Pusillimonas sp. DMV24BSW_D	2716226	S	9	0	9	0.00001
Pusillimonas sp. T7-7	1007105	S	6	0	6	0.00000
Pusillimonas thiosulfatoxidans	2028345	S	8	0	8	0.00000
Castellaniella defragrans	75697	S	22	7	29	0.00002
Advenella kashmirensis	310575	S	9	1	10	0.00001
Advenella mimigardefordensis	302406	S	6	0	6	0.00000
Oligella ureolytica	90244	S	10	2	12	0.00001
Oligella urethralis	90245	S	1	0	1	0.00000
Pelistega ratti	2652177	S	5	0	5	0.00000
Kerstersia gyiorum	206506	S	4	0	4	0.00000
Taylorella equigenitalis	29575	S	2	1	3	0.00000
Paenalcaligenes hominis	643674	S	3	0	3	0.00000
Algicoccus marinus	2163011	S	3	0	3	0.00000
Basilea psittacipulmonis	1472345	S	1	0	1	0.00000
Sutterella wadsworthensis	40545	S	20	1	21	0.00001
Sutterella faecalis	2584944	S	5	0	5	0.00000
Sutterella megalosphaeroides	2494234	S	3	0	3	0.00000
Aquaspirillum sp. LM1	1938604	S	223	19	242	0.00015
Chromobacterium vaccinii	1108595	S	23	5	28	0.00002
Chromobacterium violaceum	536	S	15	4	19	0.00001
Chromobacterium phragmitis	2202141	S	10	2	12	0.00001
Chromobacterium sp. ATCC 53434	2059672	S	9	1	10	0.00001
Chromobacterium paludis	2605945	S	7	1	8	0.00000
Chromobacterium rhizoryzae	1778675	S	3	11	14	0.00001
Chromobacterium haemolyticum	394935	S	1	5	6	0.00000
Iodobacter fluviatilis	537	S	5	2	7	0.00000
Iodobacter sp. H11R3	2496266	S	2	0	2	0.00000
Aquitalea sp. USM4	1590041	S	15	9	24	0.00001
Aquitalea aquatilis	1537400	S	11	3	14	0.00001
Aquitalea denitrificans	519081	S	7	3	10	0.00001
Aquitalea magnusonii	332411	S	3	1	4	0.00000
Laribacter hongkongensis	168471	S	37	11	48	0.00003
Chitinibacter sp. 2T18	2739434	S	10	9	19	0.00001
Chitinibacter fontanus	1737446	S	2	0	2	0.00000
Vogesella sp. LIG4	1192162	S	13	1	14	0.00001
Deefgea sp. D17	2739061	S	13	2	15	0.00001
Pseudogulbenkiania sp. NH8B	748280	S	12	2	14	0.00001
Microvirgula aerodenitrificans	57480	S	11	1	12	0.00001
Jeongeupia sp. HS-3	1009682	S	7	0	7	0.00000
Jeongeupia sp. USM3	1906741	S	3	0	3	0.00000
Vitreoscilla filiformis	63	S	156	25	181	0.00011
Vitreoscilla sp. C1	96942	S	4	0	4	0.00000
Neisseria sp. ZJ785	2709396	S	6	0	6	0.00000
Neisseria sp. KEM232	655307	S	2	0	2	0.00000
Neisseria sp. 10022	1853276	S	2	0	2	0.00000
Neisseria animaloris	326522	S	8	1	9	0.00001
Neisseria elongata	495	S	8	2	10	0.00001
Neisseria shayeganii	607712	S	6	0	6	0.00000
Neisseria lactamica	486	S	6	8	14	0.00001
Neisseria meningitidis	487	S	6	7	13	0.00001
Neisseria wadsworthii	607711	S	5	0	5	0.00000
Neisseria dentiae	194197	S	5	0	5	0.00000
Neisseria animalis	492	S	5	0	5	0.00000
Neisseria canis	493	S	4	0	4	0.00000
Neisseria gonorrhoeae	485	S	4	3	7	0.00000
Neisseria weaveri	28091	S	3	0	3	0.00000
Neisseria subflava	28449	S	3	1	4	0.00000
Neisseria sicca	490	S	3	1	4	0.00000
Neisseria chenwenguii	1853278	S	3	0	3	0.00000
Neisseria zoodegmatis	326523	S	3	0	3	0.00000
Neisseria cinerea	483	S	3	1	4	0.00000
Neisseria brasiliensis	2666100	S	2	0	2	0.00000
Neisseria musculi	1815583	S	2	0	2	0.00000
Neisseria zalophi	640030	S	2	0	2	0.00000
Neisseria bacilliformis	267212	S	2	0	2	0.00000
Neisseria mucosa	488	S	2	1	3	0.00000
Neisseria flavescens	484	S	2	1	3	0.00000
Crenobacter cavernae	2290923	S	16	3	19	0.00001
Chitinolyticbacter meiyuanensis	682798	S	14	1	15	0.00001
Kingella denitrificans	502	S	6	3	9	0.00001
Kingella oralis	505	S	4	0	4	0.00000
Kingella kingae	504	S	2	0	2	0.00000
Conchiformibius steedae	153493	S	6	0	6	0.00000
Simonsiella muelleri	72	S	5	0	5	0.00000
Eikenella corrodens	539	S	3	1	4	0.00000
Alysiella filiformis	194196	S	4	0	4	0.00000
Snodgrassella alvi	1196083	S	2	0	2	0.00000
Azoarcus sp. DD4	2027405	S	28	15	43	0.00003
Azoarcus sp. M9-3-2	2016596	S	19	1	20	0.00001
Azoarcus sp. DN11	356837	S	18	10	28	0.00002
Azoarcus sp. KH32C	748247	S	12	1	13	0.00001
Azoarcus sp. CIB	198107	S	8	5	13	0.00001
Azoarcus communis	41977	S	25	6	31	0.00002
Azoarcus olearius	418699	S	20	6	26	0.00002
Azoarcus pumilus	2067960	S	6	0	6	0.00000
Thauera sp. MZ1T	85643	S	24	19	43	0.00003
Thauera sp. K11	2005884	S	20	8	28	0.00002
Thauera humireducens	1134435	S	21	5	26	0.00002
Thauera hydrothermalis	2184083	S	18	3	21	0.00001
Thauera aromatica	59405	S	17	14	31	0.00002
Thauera chlorobenzoica	96773	S	13	7	20	0.00001
Fluviibacter phosphoraccumulans	1751046	S	162	21	183	0.00011
Azospira restricta	404405	S	31	11	42	0.00003
Azospira sp. I09	1765049	S	14	30	44	0.00003
Azospira oryzae	146939	S	7	14	21	0.00001
Aromatoleum bremense	76115	S	12	6	18	0.00001
Aromatoleum petrolei	76116	S	12	5	17	0.00001
Aromatoleum aromaticum	551760	S	7	3	10	0.00001
Niveibacterium sp. HC41	2811415	S	21	1	22	0.00001
Oryzomicrobium terrae	1735038	S	8	1	9	0.00001
Rugosibacter aromaticivorans	1565605	S	8	1	9	0.00001
Dechloromonas sp. TW-R-39-2	2654218	S	41	5	46	0.00003
Dechloromonas sp. HYN0024	2231055	S	39	5	44	0.00003
Dechloromonas aromatica	259537	S	50	5	55	0.00003
Candidatus Methylopumilus rimovensis	2588535	S	79	7	86	0.00005
Candidatus Methylopumilus turicensis	1581680	S	36	5	41	0.00003
Candidatus Methylopumilus universalis	2588536	S	35	8	43	0.00003
Candidatus Methylopumilus planktonicus	1581557	S	25	6	31	0.00002
Methylotenera versatilis	1055487	S	52	7	59	0.00004
Methylotenera mobilis	359408	S	13	1	14	0.00001
Methylophilus medardicus	2588534	S	13	3	16	0.00001
Methylophilus sp. TWE2	1662285	S	13	2	15	0.00001
Methylovorus sp. MP688	887061	S	3	7	10	0.00001
Methylovorus glucosotrophus	266009	S	2	4	6	0.00000
Methylobacillus flagellatus	405	S	3	0	3	0.00000
Denitratisoma sp. DHT3	1981880	S	30	22	52	0.00003
Denitratisoma oestradiolicum	311182	S	18	2	20	0.00001
Sulfuritalea hydrogenivorans	748811	S	46	4	50	0.00003
Methyloversatilis sp. RAC08	1842540	S	21	1	22	0.00001
Sterolibacterium denitrificans	157592	S	14	2	16	0.00001
Nitrosomonas sp. Is79A3	261292	S	39	0	39	0.00002
Nitrosomonas sp. AL212	153948	S	9	11	20	0.00001
Nitrosomonas eutropha	916	S	8	1	9	0.00001
Nitrosomonas europaea	915	S	5	0	5	0.00000
Nitrosomonas ureae	44577	S	3	1	4	0.00000
Nitrosomonas communis	44574	S	1	0	1	0.00000
Nitrosomonas stercoris	1444684	S	1	0	1	0.00000
Nitrosospira briensis	35799	S	8	0	8	0.00000
Nitrosospira lacus	1288494	S	7	0	7	0.00000
Nitrosospira multiformis	1231	S	1	0	1	0.00000
Sulfuriferula plumbiphila	171865	S	14	2	16	0.00001
Sulfuriferula sp. AH1	1985873	S	10	1	11	0.00001
Sulfuriferula nivalis	2675298	S	10	0	10	0.00001
Sulfurimicrobium lacus	2715678	S	16	1	17	0.00001
Sulfuricella denitrificans	649841	S	11	0	11	0.00001
Usitatibacter rugosus	2732067	S	28	1	29	0.00002
Usitatibacter palustris	2732487	S	21	1	22	0.00001
Sideroxydans lithotrophicus	63745	S	19	1	20	0.00001
Gallionella capsiferriformans	370405	S	12	1	13	0.00001
Candidatus Nitrotoga sp. AM1P	2559597	S	6	0	6	0.00000
Ferriphaselus amnicola	1188319	S	5	0	5	0.00000
Sulfuritortus calidifontis	1914471	S	15	4	19	0.00001
Thiobacillus denitrificans	36861	S	9	0	9	0.00001
Candidatus Accumulibacter phosphatis	327160	S	30	1	31	0.00002
Casimicrobium huifangae	2591109	S	24	5	29	0.00002
Candidatus Kinetoplastibacterium blastocrithidii	233181	S	4	-4	0	0.00000
Candidatus Kinetoplastibacterium sorsogonicusi	1576550	S	4	1	5	0.00000
Candidatus Kinetoplastibacterium crithidii	33056	S	3	-3	0	0.00000
Candidatus Kinetoplastibacterium galatii	994695	S	2	3	5	0.00000
Candidatus Kinetoplastibacterium desouzaii	994692	S	1	1	2	0.00000
Candidatus Kinetoplastibacterium oncopeltii	994696	S	1	1	2	0.00000
Candidatus Profftella armatura	669502	S	2	0	2	0.00000
Candidatus Profftella armatura (Diaphorina cf. continua)	2661583	S	1	0	1	0.00000
Pseudomonas sp. CMR12a	658629	S	816	263	1079	0.00066
Pseudomonas sp. S150	2559074	S	191	226	417	0.00026
Pseudomonas sp. DTU12.3	2073078	S	56	6	62	0.00004
Pseudomonas sp. C27(2019)	2604941	S	52	2	54	0.00003
Pseudomonas sp. R84	1573712	S	48	5	53	0.00003
Pseudomonas sp. IzPS59	2774459	S	29	11	40	0.00002
Pseudomonas sp.	306	S	24	133	157	0.00010
Pseudomonas sp. 15A4	2804761	S	24	5	29	0.00002
Pseudomonas sp. LAB-08	143813	S	19	1	20	0.00001
Pseudomonas sp. MPC6	2498848	S	19	2	21	0.00001
Pseudomonas sp. ADAK13	2730847	S	19	3	22	0.00001
Pseudomonas sp. S49	1573720	S	18	6	24	0.00001
Pseudomonas sp. 7SR1	1881017	S	17	1	18	0.00001
Pseudomonas sp. URMO17WK12:I11	1283291	S	16	12	28	0.00002
Pseudomonas sp. Z003-0.4C(8344-21)	1855380	S	16	12	28	0.00002
Pseudomonas sp. DTU12.1	2654238	S	16	10	26	0.00002
Pseudomonas sp. LG1E9	2219057	S	15	2	17	0.00001
Pseudomonas sp. 31-12	2201356	S	15	2	17	0.00001
Pseudomonas sp. RU47	2005388	S	15	5	20	0.00001
Pseudomonas sp. ACM7	2052956	S	14	1	15	0.00001
Pseudomonas sp. CC6-YY-74	1930532	S	14	0	14	0.00001
Pseudomonas sp. S34	1573718	S	14	1	15	0.00001
Pseudomonas sp. S1-A32-2	2731681	S	14	0	14	0.00001
Pseudomonas sp. S09G 359	2054919	S	13	1	14	0.00001
Pseudomonas sp. 02C 26	2054914	S	13	0	13	0.00001
Pseudomonas sp. B10	118613	S	12	7	19	0.00001
Pseudomonas sp. SNU WT1	2518644	S	11	0	11	0.00001
Pseudomonas sp. K2W31S-8	2320867	S	11	0	11	0.00001
Pseudomonas sp. TUM18999	2725477	S	11	1	12	0.00001
Pseudomonas sp. gcc21	2726989	S	11	1	12	0.00001
Pseudomonas sp. Tri1	2823875	S	11	2	13	0.00001
Pseudomonas sp. ATCC 43928	676210	S	10	9	19	0.00001
Pseudomonas sp. M30-35	1981174	S	10	0	10	0.00001
Pseudomonas sp. DR 5-09	1534110	S	9	5	14	0.00001
Pseudomonas sp. DG56-2	2320270	S	9	0	9	0.00001
Pseudomonas sp. R5-89-07	658644	S	9	1	10	0.00001
Pseudomonas sp. StFLB209	1028989	S	8	0	8	0.00000
Pseudomonas sp. NIBRBAC000502773	2590776	S	8	3	11	0.00001
Pseudomonas sp. OIL-1	2706126	S	8	0	8	0.00000
Pseudomonas sp. S35	1573719	S	8	1	9	0.00001
Pseudomonas sp. UW4	1207075	S	7	4	11	0.00001
Pseudomonas sp. TMW 2.1634	1886807	S	7	24	31	0.00002
Pseudomonas sp. TCU-HL1	1856685	S	7	0	7	0.00000
Pseudomonas sp. LPB0260	2614442	S	7	0	7	0.00000
Pseudomonas sp. LBUM920	2126069	S	6	2	8	0.00000
Pseudomonas sp. NS1(2017)	2025658	S	6	1	7	0.00000
Pseudomonas sp. HLS-6	2049589	S	6	0	6	0.00000
Pseudomonas sp. ADAK18	2730848	S	6	0	6	0.00000
Pseudomonas sp. B11D7D	2735906	S	6	0	6	0.00000
Pseudomonas sp. DY-1	1755504	S	6	0	6	0.00000
Pseudomonas sp. R76	1573711	S	6	2	8	0.00000
Pseudomonas sp. s211(2017)	2045200	S	5	3	8	0.00000
Pseudomonas sp. FDAARGOS_380	2018067	S	5	3	8	0.00000
Pseudomonas sp. BIGb0427	2724470	S	5	0	5	0.00000
Pseudomonas sp. S-6-2	1931241	S	5	0	5	0.00000
Pseudomonas sp. R32	1573704	S	5	0	5	0.00000
Pseudomonas sp. Y39-6	2749807	S	5	18	23	0.00001
Pseudomonas sp. SCB32	2653853	S	5	0	5	0.00000
Pseudomonas sp. OST1909	2777367	S	5	16	21	0.00001
Pseudomonas sp. BIOMIG1BAC	1758730	S	5	3	8	0.00000
Pseudomonas sp. ATCC 13867	1294143	S	4	0	4	0.00000
Pseudomonas sp. J380	2605424	S	4	2	6	0.00000
Pseudomonas sp. ADAK22	2730851	S	4	1	5	0.00000
Pseudomonas sp. PONIH3	1636610	S	4	11	15	0.00001
Pseudomonas sp. MSPm1	2726956	S	4	0	4	0.00000
Pseudomonas sp. SK	2729423	S	4	0	4	0.00000
Pseudomonas sp. 14181154	2662033	S	3	2	5	0.00000
Pseudomonas sp. 09C 129	2054915	S	3	4	7	0.00000
Pseudomonas sp. CMR5c	658630	S	3	0	3	0.00000
Pseudomonas sp. BJP69	2597770	S	3	7	10	0.00001
Pseudomonas sp. SXM-1	2169583	S	3	6	9	0.00001
Pseudomonas sp. phDV1	253237	S	3	6	9	0.00001
Pseudomonas sp. Os17	1500686	S	3	2	5	0.00000
Pseudomonas sp. MPDS	2762896	S	3	2	5	0.00000
Pseudomonas sp. PDNC002	2811422	S	3	0	3	0.00000
Pseudomonas sp. Leaf58	1736226	S	3	0	3	0.00000
Pseudomonas sp. SDM007	2812000	S	3	0	3	0.00000
Pseudomonas sp. CCOS 191	1649877	S	3	1	4	0.00000
Pseudomonas sp. VLB120	69328	S	2	3	5	0.00000
Pseudomonas sp. B14-6	2738843	S	2	5	7	0.00000
Pseudomonas sp. ABC1	2748080	S	2	0	2	0.00000
Pseudomonas sp. CFSAN084952	2664899	S	2	8	10	0.00001
Pseudomonas sp. RtIB026	2749999	S	2	0	2	0.00000
Pseudomonas sp. R3-18-08	1173283	S	2	0	2	0.00000
Pseudomonas sp. MRSN12121	1611770	S	2	2	4	0.00000
Pseudomonas sp. LPH1	1898684	S	2	1	3	0.00000
Pseudomonas sp. LH1G9	2083055	S	2	6	8	0.00000
Pseudomonas sp. 13159349	2662034	S	1	7	8	0.00000
Pseudomonas sp. GR 6-02	1659194	S	1	1	2	0.00000
Pseudomonas sp. IB20	1702250	S	1	0	1	0.00000
Pseudomonas sp. ADPe	2774873	S	1	1	2	0.00000
Pseudomonas sp. MYb193	1827300	S	1	0	1	0.00000
Pseudomonas sp. 29A	2759706	S	1	168	169	0.00010
Pseudomonas sp. NC02	2067572	S	1	2	3	0.00000
Pseudomonas sp. R2-7-07	658641	S	1	1	2	0.00000
Pseudomonas sp. R4-35-07	658643	S	1	0	1	0.00000
Pseudomonas sp. THAF7b	2587845	S	1	1	2	0.00000
Pseudomonas sp. R4-39-08	1173288	S	1	0	1	0.00000
Pseudomonas sp. SWI44	2083053	S	1	0	1	0.00000
Pseudomonas oryzihabitans	47885	S	1271	159	1430	0.00088
Pseudomonas putida	303	S	148	111	259	0.00016
Pseudomonas fulva	47880	S	15	0	15	0.00001
Pseudomonas monteilii	76759	S	11	9	20	0.00001
Pseudomonas plecoglossicida	70775	S	4	2	6	0.00000
Pseudomonas fluorescens	294	S	900	395	1295	0.00079
Pseudomonas veronii	76761	S	47	114	161	0.00010
Pseudomonas protegens	380021	S	46	5	51	0.00003
Pseudomonas azotoformans	47878	S	42	14	56	0.00003
Pseudomonas tolaasii	29442	S	32	6	38	0.00002
Pseudomonas synxantha	47883	S	28	14	42	0.00003
Pseudomonas orientalis	76758	S	28	5	33	0.00002
Pseudomonas trivialis	200450	S	20	4	24	0.00001
Pseudomonas poae	200451	S	18	6	24	0.00001
Pseudomonas rhodesiae	76760	S	15	4	19	0.00001
Pseudomonas corrugata	47879	S	15	1	16	0.00001
Pseudomonas cedrina	651740	S	13	2	15	0.00001
Pseudomonas extremorientalis	169669	S	12	4	16	0.00001
Pseudomonas mediterranea	183795	S	11	1	12	0.00001
Pseudomonas libanensis	75588	S	7	6	13	0.00001
Pseudomonas migulae	78543	S	6	1	7	0.00000
Pseudomonas brenneri	129817	S	4	0	4	0.00000
Pseudomonas mucidolens	46679	S	4	0	4	0.00000
Pseudomonas mandelii	75612	S	2	4	6	0.00000
Pseudomonas koreensis	198620	S	281	81	362	0.00022
Pseudomonas aeruginosa	287	S	92	426	518	0.00032
Pseudomonas mendocina	300	S	33	5	38	0.00002
Pseudomonas alcaligenes	43263	S	25	6	31	0.00002
Pseudomonas nitroreducens	46680	S	9	3	12	0.00001
Pseudomonas multiresinivorans	95301	S	7	1	8	0.00000
Pseudomonas citronellolis	53408	S	13	12	25	0.00002
Pseudomonas furukawaii	1149133	S	7	0	7	0.00000
Pseudomonas oleovorans	301	S	4	8	12	0.00001
Pseudomonas resinovorans	53412	S	9	1	10	0.00001
Pseudomonas syringae	317	S	76	73	149	0.00009
Pseudomonas viridiflava	33069	S	36	1	37	0.00002
Pseudomonas asturiensis	1190415	S	24	0	24	0.00001
Pseudomonas cichorii	36746	S	12	0	12	0.00001
Pseudomonas savastanoi	29438	S	4	131	135	0.00008
Pseudomonas amygdali	47877	S	3	4	7	0.00000
Pseudomonas coronafaciens	53409	S	6	1	7	0.00000
Pseudomonas fuscovaginae	50340	S	3	1	4	0.00000
Pseudomonas syringae group genomosp. 3	251701	S	3	14	17	0.00001
Pseudomonas sp. Lz4W	1206777	S	2	4	6	0.00000
Pseudomonas chlororaphis	587753	S	69	39	108	0.00007
Pseudomonas fragi	296	S	50	41	91	0.00006
Pseudomonas lundensis	86185	S	26	1	27	0.00002
Pseudomonas stutzeri	316	S	85	19	104	0.00006
Pseudomonas xanthomarina	271420	S	7	0	7	0.00000
Pseudomonas balearica	74829	S	3	1	4	0.00000
Pseudomonas luteola	47886	S	1	0	1	0.00000
Pseudomonas psychrotolerans	237610	S	90	11	101	0.00006
Pseudomonas moraviensis	321662	S	45	19	64	0.00004
Pseudomonas allokribbensis	2774460	S	38	10	48	0.00003
Pseudomonas rhizosphaerae	216142	S	36	1	37	0.00002
Pseudomonas palleroniana	191390	S	35	3	38	0.00002
Pseudomonas graminis	158627	S	33	7	40	0.00002
Pseudomonas extremaustralis	359110	S	28	4	32	0.00002
Pseudomonas agarici	46677	S	26	0	26	0.00002
Pseudomonas granadensis	1421430	S	25	11	36	0.00002
Pseudomonas prosekii	1148509	S	23	2	25	0.00002
Pseudomonas arsenicoxydans	702115	S	22	2	24	0.00001
Pseudomonas yamanorum	515393	S	21	3	24	0.00001
Pseudomonas brassicacearum	930166	S	20	38	58	0.00004
Pseudomonas frederiksbergensis	104087	S	20	5	25	0.00002
Pseudomonas knackmussii	65741	S	20	5	25	0.00002
Pseudomonas psychrophila	122355	S	19	1	20	0.00001
Pseudomonas lurida	244566	S	18	3	21	0.00001
Pseudomonas gozinkensis	2774461	S	18	7	25	0.00002
Pseudomonas litoralis	797277	S	17	0	17	0.00001
Pseudomonas kribbensis	1628086	S	16	6	22	0.00001
Pseudomonas vancouverensis	95300	S	14	1	15	0.00001
Pseudomonas reinekei	395598	S	14	1	15	0.00001
Pseudomonas eucalypticola	2599595	S	13	0	13	0.00001
Pseudomonas taetrolens	47884	S	13	0	13	0.00001
Pseudomonas lini	163011	S	13	1	14	0.00001
Pseudomonas umsongensis	198618	S	13	1	14	0.00001
Pseudomonas antarctica	219572	S	13	2	15	0.00001
Pseudomonas otitidis	319939	S	12	0	12	0.00001
Pseudomonas viciae	2505979	S	12	2	14	0.00001
Pseudomonas entomophila	312306	S	12	1	13	0.00001
Pseudomonas simiae	321846	S	12	2	14	0.00001
Pseudomonas parafulva	157782	S	11	2	13	0.00001
Pseudomonas xinjiangensis	487184	S	10	0	10	0.00001
Pseudomonas sediminis	1691904	S	10	1	11	0.00001
Pseudomonas oryzae	1392877	S	9	0	9	0.00001
Pseudomonas silesiensis	1853130	S	9	1	10	0.00001
Pseudomonas versuta	1788301	S	9	0	9	0.00001
Pseudomonas alkylphenolica	237609	S	9	0	9	0.00001
Pseudomonas guangdongensis	1245526	S	8	0	8	0.00000
Pseudomonas atacamensis	2565368	S	8	6	14	0.00001
Pseudomonas sabulinigri	472181	S	7	0	7	0.00000
Pseudomonas saudiphocaensis	1499686	S	7	0	7	0.00000
Pseudomonas lalkuanensis	2604832	S	7	0	7	0.00000
Pseudomonas salegens	1434072	S	6	0	6	0.00000
Pseudomonas denitrificans (nom. rej.)	43306	S	6	0	6	0.00000
Pseudomonas lactis	1615674	S	6	4	10	0.00001
Pseudomonas cremoricolorata	157783	S	6	0	6	0.00000
Pseudomonas thivervalensis	86265	S	5	0	5	0.00000
Pseudomonas marincola	437900	S	4	0	4	0.00000
Pseudomonas pohangensis	364197	S	4	0	4	0.00000
Candidatus Pseudomonas adelgestsugas	1302376	S	4	0	4	0.00000
Pseudomonas sihuiensis	1274359	S	4	3	7	0.00000
Pseudomonas pelagia	553151	S	3	0	3	0.00000
Pseudomonas khazarica	2502979	S	3	3	6	0.00000
Pseudomonas glycinae	1785145	S	2	3	5	0.00000
Pseudomonas soli	1306993	S	2	5	7	0.00000
Pseudomonas alcaliphila	101564	S	1	0	1	0.00000
Pseudomonas asplenii	53407	S	1	0	1	0.00000
Azotobacter salinestris	69964	S	11	4	15	0.00001
Azotobacter chroococcum	353	S	5	1	6	0.00000
Azotobacter vinelandii	354	S	4	-4	0	0.00000
Entomomonas sp. F2A	2785331	S	6	0	6	0.00000
Entomomonas moraniae	2213226	S	3	0	3	0.00000
Oblitimonas alkaliphila	1697053	S	7	0	7	0.00000
Permianibacter aggregans	1510150	S	2	0	2	0.00000
Acinetobacter sp. TTH0-4	1646498	S	75	9	84	0.00005
Acinetobacter sp. CS-2	2798861	S	48	17	65	0.00004
Acinetobacter sp. NEB 394	2743575	S	39	56	95	0.00006
Acinetobacter sp. WCHAc010034	1879049	S	33	8	41	0.00003
Acinetobacter sp. WCHA45	2004644	S	32	30	62	0.00004
Acinetobacter sp. MYb10	1827285	S	29	5	34	0.00002
Acinetobacter sp. 10FS3-1	2563897	S	23	10	33	0.00002
Acinetobacter sp. YH12138	2601122	S	22	5	27	0.00002
Acinetobacter sp. ACNIH2	1758189	S	21	6	27	0.00002
Acinetobacter sp. TGL-Y2	1407071	S	14	0	14	0.00001
Acinetobacter sp. NCu2D-2	1608473	S	11	0	11	0.00001
Acinetobacter sp. WCHA55	2004646	S	10	6	16	0.00001
Acinetobacter sp. FDAARGOS_724	2545797	S	9	11	20	0.00001
Acinetobacter sp. Marseille-Q1620	2714110	S	8	0	8	0.00000
Acinetobacter sp. WCHAc010052	2004647	S	8	3	11	0.00001
Acinetobacter sp. ACNIH1	1636603	S	6	10	16	0.00001
Acinetobacter sp. NEB149	2725684	S	6	13	19	0.00001
Acinetobacter sp. C16S1	2609668	S	6	1	7	0.00000
Acinetobacter sp. LoGeW2-3	1808001	S	5	0	5	0.00000
Acinetobacter sp. FDAARGOS_493	2420300	S	4	82	86	0.00005
Acinetobacter sp. SWBY1	2079596	S	2	2	4	0.00000
Acinetobacter sp. BEC1-S18-ESBL-01	2675741	S	2	50	52	0.00003
Acinetobacter sp.	472	S	1	19	20	0.00001
Acinetobacter johnsonii	40214	S	204	176	380	0.00023
Acinetobacter baumannii	470	S	87	301	388	0.00024
Acinetobacter pittii	48296	S	17	19	36	0.00002
Acinetobacter seifertii	1530123	S	14	3	17	0.00001
Acinetobacter calcoaceticus	471	S	11	0	11	0.00001
Acinetobacter nosocomialis	106654	S	7	1	8	0.00000
Acinetobacter lactucae	1785128	S	2	0	2	0.00000
Acinetobacter lwoffii	28090	S	117	152	269	0.00016
Acinetobacter junii	40215	S	75	13	88	0.00005
Acinetobacter indicus	756892	S	47	13	60	0.00004
Acinetobacter haemolyticus	29430	S	45	13	58	0.00004
Acinetobacter schindleri	108981	S	40	15	55	0.00003
Acinetobacter guillouiae	106649	S	34	6	40	0.00002
Acinetobacter wuhouensis	1879050	S	33	10	43	0.00003
Acinetobacter bereziniae	106648	S	28	3	31	0.00002
Acinetobacter radioresistens	40216	S	28	2	30	0.00002
Acinetobacter ursingii	108980	S	26	7	33	0.00002
Acinetobacter lanii	2715163	S	23	0	23	0.00001
Acinetobacter wanghuae	2662362	S	20	0	20	0.00001
Acinetobacter equi	1324350	S	19	0	19	0.00001
Acinetobacter piscicola	2006115	S	18	5	23	0.00001
Acinetobacter defluvii	1871111	S	14	5	19	0.00001
Acinetobacter tandoii	202954	S	14	0	14	0.00001
Acinetobacter gyllenbergii	134534	S	13	0	13	0.00001
Acinetobacter cumulans	2136182	S	10	2	12	0.00001
Acinetobacter variabilis	70346	S	9	7	16	0.00001
Acinetobacter towneri	202956	S	8	9	17	0.00001
Acinetobacter shaoyimingii	2715164	S	8	0	8	0.00000
Acinetobacter larvae	1789224	S	7	0	7	0.00000
Acinetobacter dispersus	70348	S	7	0	7	0.00000
Acinetobacter baylyi	202950	S	5	0	5	0.00000
Acinetobacter venetianus	52133	S	4	0	4	0.00000
Acinetobacter soli	487316	S	3	0	3	0.00000
Acinetobacter chinensis	2004650	S	3	1	4	0.00000
Acinetobacter oleivorans	1148157	S	2	0	2	0.00000
Moraxella osloensis	34062	S	351	18	369	0.00023
Moraxella nonliquefaciens	478	S	3	0	3	0.00000
Moraxella bovis	476	S	2	0	2	0.00000
Moraxella catarrhalis	480	S	1	0	1	0.00000
Moraxella bovoculi	386891	S	1	0	1	0.00000
Psychrobacter sp. P11F6	1699621	S	29	3	32	0.00002
Psychrobacter sp. PRwf-1	349106	S	26	15	41	0.00003
Psychrobacter sp. DAB_AL43B	1028416	S	22	1	23	0.00001
Psychrobacter sp. AntiMn-1	1720344	S	15	6	21	0.00001
Psychrobacter sp.	56811	S	14	3	17	0.00001
Psychrobacter sp. P11G5	1699624	S	13	8	21	0.00001
Psychrobacter sp. YP14	2203895	S	8	4	12	0.00001
Psychrobacter sp. P11G3	1699623	S	7	0	7	0.00000
Psychrobacter sp. KCTC 72983	2733866	S	5	2	7	0.00000
Psychrobacter sp. 28M-43	2772254	S	4	0	4	0.00000
Psychrobacter sp. G	571800	S	3	6	9	0.00001
Psychrobacter sp. P2G3	1699622	S	3	1	4	0.00000
Psychrobacter sp. DAB_AL32B	1028414	S	1	0	1	0.00000
Psychrobacter urativorans	45610	S	16	1	17	0.00001
Psychrobacter cryohalolentis	330922	S	7	16	23	0.00001
Psychrobacter arcticus	334543	S	6	0	6	0.00000
Psychrobacter maritimus	256325	S	5	36	41	0.00003
Psychrobacter arenosus	256326	S	3	0	3	0.00000
Aquirhabdus parva	2283318	S	5	0	5	0.00000
Stenotrophomonas maltophilia	40324	S	1721	590	2311	0.00141
Stenotrophomonas sp. SAU14A_NAIMI4_5	2072413	S	6	1	7	0.00000
Stenotrophomonas sp. ESTM1D_MKCIP4_1	2072414	S	6	0	6	0.00000
Stenotrophomonas sp. YAU14D1_LEIMI4_1	2072407	S	5	4	9	0.00001
Stenotrophomonas sp. ZAC14D2_NAIMI4_7	2072405	S	4	1	5	0.00000
Stenotrophomonas sp. ZAC14A_NAIMI4_1	2072412	S	4	3	7	0.00000
Stenotrophomonas sp. ZAC14D2_NAIMI4_6	2072406	S	3	2	5	0.00000
Stenotrophomonas sp. YAU14A_MKIMI4_1	2072408	S	3	9	12	0.00001
Stenotrophomonas sp. LM091	1904944	S	22	1	23	0.00001
Stenotrophomonas sp. WZN-1	2005046	S	13	4	17	0.00001
Stenotrophomonas sp. 364	2691571	S	12	0	12	0.00001
Stenotrophomonas sp. 169	2770322	S	11	0	11	0.00001
Stenotrophomonas sp. NA06056	2742129	S	7	0	7	0.00000
Stenotrophomonas sp. G4	2303750	S	6	2	8	0.00000
Stenotrophomonas sp. CW117	2775920	S	6	47	53	0.00003
Stenotrophomonas sp. MYb57	1827305	S	3	4	7	0.00000
Stenotrophomonas sp. Pemsol	2040586	S	3	1	4	0.00000
Stenotrophomonas sp. ASS1	2282124	S	3	5	8	0.00000
Stenotrophomonas sp. SXG-1	2682487	S	1	1	2	0.00000
Stenotrophomonas rhizophila	216778	S	28	1	29	0.00002
Stenotrophomonas acidaminiphila	128780	S	10	7	17	0.00001
Stenotrophomonas indicatrix	2045451	S	1	1	2	0.00000
Xanthomonas campestris	339	S	71	0	71	0.00004
Xanthomonas euvesicatoria	456327	S	23	1323	1346	0.00082
Xanthomonas hortorum	56454	S	23	1	24	0.00001
Xanthomonas translucens	343	S	14	0	14	0.00001
Xanthomonas oryzae	347	S	14	0	14	0.00001
Xanthomonas fragariae	48664	S	13	0	13	0.00001
Xanthomonas citri	346	S	13	1	14	0.00001
Xanthomonas sp. SI	2724123	S	2	1	3	0.00000
Xanthomonas sp. GW	2724121	S	1	0	1	0.00000
Xanthomonas sp. SS	2724122	S	1	0	1	0.00000
Xanthomonas sp. LMG 31887	2775162	S	1	2	3	0.00000
Xanthomonas vasicola	56459	S	9	0	9	0.00001
Xanthomonas arboricola	56448	S	8	0	8	0.00000
Xanthomonas sacchari	56458	S	7	0	7	0.00000
Xanthomonas vesicatoria	56460	S	7	1	8	0.00000
Xanthomonas theicola	56464	S	5	0	5	0.00000
Xanthomonas cucurbitae	56453	S	3	0	3	0.00000
Xanthomonas albilineans	29447	S	3	0	3	0.00000
Xanthomonas hyacinthi	56455	S	2	0	2	0.00000
Xanthomonas euroxanthea	2259622	S	2	0	2	0.00000
Xanthomonas axonopodis	53413	S	1	0	1	0.00000
Lysobacter enzymogenes	69	S	52	9	61	0.00004
Lysobacter sp. TY2-98	2290922	S	16	0	16	0.00001
Lysobacter sp. HDW10	2714936	S	8	0	8	0.00000
Lysobacter sp. CW239	2762611	S	5	0	5	0.00000
Lysobacter sp. H21R20	2781022	S	5	2	7	0.00000
Lysobacter sp. H21R4	2781021	S	3	1	4	0.00000
Lysobacter sp. H23M47	2781024	S	2	3	5	0.00000
Lysobacter sp. H23M41	2781023	S	1	1	2	0.00000
Lysobacter alkalisoli	2591633	S	15	0	15	0.00001
Lysobacter arenosi	2795387	S	15	1	16	0.00001
Lysobacter capsici	435897	S	14	2	16	0.00001
Lysobacter oculi	2698682	S	12	0	12	0.00001
Lysobacter antibioticus	84531	S	11	1	12	0.00001
Lysobacter lycopersici	1324796	S	11	0	11	0.00001
Lysobacter soli	453783	S	9	0	9	0.00001
Lysobacter solisilvae	2763317	S	8	0	8	0.00000
Lysobacter gummosus	262324	S	7	1	8	0.00000
Lysobacter maris	1605891	S	5	0	5	0.00000
Thermomonas carbonis	1463158	S	44	2	46	0.00003
Thermomonas sp. SY21	2202149	S	13	1	14	0.00001
Thermomonas sp. XSG	2771436	S	12	2	14	0.00001
Thermomonas sp. HDW16	2714945	S	3	0	3	0.00000
Thermomonas brevis	215691	S	19	3	22	0.00001
Luteimonas sp. YGD11-2	2508168	S	16	2	18	0.00001
Luteimonas sp. JM171	1896164	S	9	0	9	0.00001
Luteimonas sp. MC1825	2761107	S	8	1	9	0.00001
Luteimonas sp. MC1572	2799325	S	7	0	7	0.00000
Luteimonas sp. MC1750	2799326	S	7	0	7	0.00000
Luteimonas chenhongjianii	2006110	S	16	0	16	0.00001
Luteimonas yindakuii	2565782	S	7	0	7	0.00000
Pseudoxanthomonas mexicana	128785	S	27	3	30	0.00002
Pseudoxanthomonas suwonensis	314722	S	19	0	19	0.00001
Pseudoxanthomonas spadix	415229	S	12	0	12	0.00001
Arenimonas daejeonensis	370777	S	38	0	38	0.00002
Pseudolysobacter antarcticus	2511995	S	10	0	10	0.00001
Xylella fastidiosa	2371	S	1	0	1	0.00000
Rhodanobacter denitrificans	666685	S	27	3	30	0.00002
Rhodanobacter sp. FDAARGOS 1247	2778082	S	17	2	19	0.00001
Rhodanobacter glycinis	582702	S	11	0	11	0.00001
Dyella sp. M7H15-1	2501295	S	12	0	12	0.00001
Dyella sp. G9	2763498	S	6	1	7	0.00000
Dyella caseinilytica	1849581	S	16	0	16	0.00001
Dyella thiooxydans	445710	S	6	0	6	0.00000
Dyella japonica	231455	S	5	1	6	0.00000
Luteibacter pinisoli	2589080	S	10	1	11	0.00001
Luteibacter rhizovicinus	242606	S	9	0	9	0.00001
Ahniella affigens	2021234	S	18	0	18	0.00001
Aerosticca soli	2010829	S	10	4	14	0.00001
Frateuria aurantia	81475	S	8	0	8	0.00000
Dokdonella koreensis	323415	S	8	0	8	0.00000
Klebsiella pneumoniae	573	S	195	688	883	0.00054
Klebsiella sp. STW0522-44	2681387	S	2	1	3	0.00000
Klebsiella sp. WP8-S18-ESBL-06	2675726	S	1	3	4	0.00000
Klebsiella sp. WP3-W18-ESBL-02	2675710	S	1	15	16	0.00001
Klebsiella grimontii	2058152	S	8	21	29	0.00002
Klebsiella oxytoca	571	S	7	2	9	0.00001
Klebsiella quasipneumoniae	1463165	S	6	7	13	0.00001
Klebsiella michiganensis	1134687	S	4	3	7	0.00000
Klebsiella variicola	244366	S	3	2	5	0.00000
Klebsiella huaxiensis	2153354	S	3	0	3	0.00000
Klebsiella aerogenes	548	S	2	0	2	0.00000
Klebsiella quasivariicola	2026240	S	1	0	1	0.00000
Enterobacter asburiae	61645	S	34	70	104	0.00006
Enterobacter cloacae	550	S	21	26	47	0.00003
Enterobacter hormaechei	158836	S	8	34	42	0.00003
Enterobacter roggenkampii	1812935	S	4	6	10	0.00001
Enterobacter ludwigii	299767	S	2	4	6	0.00000
Enterobacter cancerogenus	69218	S	1	0	1	0.00000
Enterobacter sp. E20	1560339	S	2	6	8	0.00000
Enterobacter sp. JUb54	2724468	S	2	0	2	0.00000
Enterobacter sp. RHBSTW-00175	2742639	S	1	0	1	0.00000
Enterobacter sp. RHB15-C17	2742619	S	1	0	1	0.00000
Enterobacter sp. E76	2596949	S	1	0	1	0.00000
Enterobacter bugandensis	881260	S	3	0	3	0.00000
Enterobacter soli	885040	S	3	0	3	0.00000
Enterobacter oligotrophicus	2478464	S	3	0	3	0.00000
Citrobacter freundii	546	S	19	45	64	0.00004
Citrobacter youngae	133448	S	2	3	5	0.00000
Citrobacter sp. BDA59-3	2781952	S	4	0	4	0.00000
Citrobacter sp. R56	1573676	S	3	0	3	0.00000
Citrobacter sp. CFNIH10	1920110	S	2	11	13	0.00001
Citrobacter sp. LY-1	2546350	S	2	0	2	0.00000
Citrobacter rodentium	67825	S	3	0	3	0.00000
Citrobacter koseri	545	S	1	0	1	0.00000
Citrobacter telavivum	2653932	S	1	0	1	0.00000
Escherichia coli	562	S	43	345	388	0.00024
Escherichia albertii	208962	S	6	50	56	0.00003
Escherichia marmotae	1499973	S	3	0	3	0.00000
Raoultella planticola	575	S	15	7	22	0.00001
Raoultella terrigena	577	S	6	5	11	0.00001
Raoultella ornithinolytica	54291	S	5	20	25	0.00002
Raoultella electrica	1259973	S	2	2	4	0.00000
Candidatus Hamiltonella defensa	138072	S	11	0	11	0.00001
secondary endosymbiont of Ctenarytaina eucalypti	1199245	S	3	0	3	0.00000
secondary endosymbiont of Heteropsylla cubana	134287	S	2	0	2	0.00000
Blochmannia endosymbiont of Camponotus (Colobopsis) obliquus	1505597	S	4	0	4	0.00000
Blochmannia endosymbiont of Polyrhachis (Hedomyrma) turneri	1505596	S	2	0	2	0.00000
Blochmannia endosymbiont of Colobopsis nipponica	2681987	S	2	0	2	0.00000
Blochmannia endosymbiont of Camponotus nipponensis	2681986	S	1	0	1	0.00000
Candidatus Tachikawaea gelatinosa	1410383	S	7	0	7	0.00000
secondary endosymbiont of Trabutina mannipara	1835721	S	3	0	3	0.00000
Candidatus Purcelliella pentastirinorum	472834	S	1	0	1	0.00000
Candidatus Hoaglandella endobia	1778263	S	1	0	1	0.00000
Candidatus Mikella endobia	1778264	S	1	0	1	0.00000
Candidatus Gullanella endobia	1070130	S	1	0	1	0.00000
Enterobacteriaceae endosymbiont of Donacia piscatrix	2675780	S	4	1	5	0.00000
Enterobacteriaceae endosymbiont of Macroplea appendiculata	2675790	S	4	0	4	0.00000
Enterobacteriaceae endosymbiont of Donacia bicoloricornis	2675772	S	4	0	4	0.00000
Enterobacteriaceae endosymbiont of Donacia versicolorea	2675788	S	3	3	6	0.00000
Enterobacteriaceae endosymbiont of Plateumaris pusilla	2675795	S	2	0	2	0.00000
Enterobacteriaceae endosymbiont of Donacia crassipes	2675776	S	2	0	2	0.00000
Enterobacteriaceae endosymbiont of Plateumaris rustica	2675796	S	1	0	1	0.00000
Enterobacteriaceae endosymbiont of Plateumaris consimilis	2675794	S	1	0	1	0.00000
Enterobacteriaceae endosymbiont of Donacia provostii	2675781	S	1	0	1	0.00000
Enterobacteriaceae endosymbiont of Macroplea mutica	2675791	S	1	0	1	0.00000
Buttiauxella sp. 3AFRM03	2479367	S	17	0	17	0.00001
Buttiauxella agrestis	82977	S	7	0	7	0.00000
Kosakonia radicincitans	283686	S	8	6	14	0.00001
Kosakonia pseudosacchari	1646340	S	3	1	4	0.00000
Kosakonia sacchari	1158459	S	1	0	1	0.00000
Kosakonia sp. CCTCC M2018092	2492396	S	1	1	2	0.00000
Leclercia sp. 119287	2681308	S	6	3	9	0.00001
Leclercia sp. 4-9-1-25	2815358	S	3	0	3	0.00000
Leclercia sp. 29361	2714951	S	2	0	2	0.00000
Leclercia adecarboxylata	83655	S	3	1	4	0.00000
Kluyvera ascorbata	51288	S	7	6	13	0.00001
Kluyvera genomosp. 3	2774055	S	6	0	6	0.00000
Kluyvera intermedia	61648	S	4	0	4	0.00000
Salmonella enterica	28901	S	11	114	125	0.00008
Salmonella bongori	54736	S	1	0	1	0.00000
Cronobacter malonaticus	413503	S	5	1	6	0.00000
Cronobacter condimenti	1163710	S	4	0	4	0.00000
Cronobacter sakazakii	28141	S	1	0	1	0.00000
Cronobacter dublinensis	413497	S	1	0	1	0.00000
Cronobacter universalis	535744	S	1	0	1	0.00000
Phytobacter ursingii	1972431	S	8	5	13	0.00001
Phytobacter sp. SCO41	1756993	S	1	1	2	0.00000
Cedecea neteri	158822	S	4	0	4	0.00000
Cedecea sp. FDAARGOS_727	2545798	S	1	0	1	0.00000
Jejubacter calystegiae	2579935	S	4	0	4	0.00000
[Enterobacter] lignolyticus	1334193	S	3	0	3	0.00000
Pluralibacter gergoviae	61647	S	1	0	1	0.00000
Lelliottia amnigena	61646	S	3	0	3	0.00000
Lelliottia sp. WB101	2153385	S	1	0	1	0.00000
Candidatus Riesia pediculicola	401619	S	3	0	3	0.00000
Pseudescherichia vulneris	566	S	3	0	3	0.00000
Scandinavium goeteborgense	1851514	S	3	0	3	0.00000
Shigella flexneri	623	S	2	7	9	0.00001
Atlantibacter hermannii	565	S	2	0	2	0.00000
Yokenella regensburgei	158877	S	1	0	1	0.00000
Pantoea agglomerans	549	S	85	6	91	0.00006
Pantoea vagans	470934	S	30	20	50	0.00003
Pantoea sp. PSNIH1	1484158	S	12	7	19	0.00001
Pantoea sp. MSR2	2052056	S	3	0	3	0.00000
Pantoea sp. CCBC3-3-1	2490851	S	3	0	3	0.00000
Pantoea sp. SO10	2575375	S	2	0	2	0.00000
Pantoea sp. At-9b	592316	S	1	0	1	0.00000
Pantoea dispersa	59814	S	11	1	12	0.00001
Pantoea ananatis	553	S	8	0	8	0.00000
Pantoea cypripedii	55209	S	3	0	3	0.00000
Pantoea rwandensis	1076550	S	3	0	3	0.00000
Pantoea stewartii	66269	S	1	0	1	0.00000
Pantoea eucalypti	470933	S	1	3	4	0.00000
Buchnera aphidicola	9	S	110	-3	107	0.00007
Erwinia gerundensis	1619313	S	14	0	14	0.00001
Erwinia sp. J780	2681984	S	6	0	6	0.00000
Erwinia sp. QL-Z3	2547962	S	5	4	9	0.00001
Candidatus Erwinia haradaeae	1922217	S	10	0	10	0.00001
Erwinia persicina	55211	S	9	0	9	0.00001
Erwinia billingiae	182337	S	8	2	10	0.00001
Erwinia pyrifoliae	79967	S	6	2	8	0.00000
Erwinia amylovora	552	S	4	0	4	0.00000
Mixta calida	665913	S	3	0	3	0.00000
Mixta gaviniae	665914	S	2	0	2	0.00000
Mixta intestinalis	1615494	S	2	0	2	0.00000
Tatumella citrea	53336	S	2	0	2	0.00000
Tatumella ptyseos	82987	S	2	0	2	0.00000
Serratia fonticola	47917	S	25	4	29	0.00002
Serratia marcescens	615	S	14	12	26	0.00002
Serratia plymuthica	82996	S	12	11	23	0.00001
Serratia rubidaea	61652	S	8	5	13	0.00001
Serratia proteamaculans	28151	S	7	0	7	0.00000
Serratia sp. JUb9	2724469	S	4	16	20	0.00001
Serratia sp. ATCC 39006	104623	S	2	0	2	0.00000
Serratia sp. 1D1416	2447890	S	1	1	2	0.00000
Serratia liquefaciens	614	S	5	2	7	0.00000
Serratia symbiotica	138074	S	2	0	2	0.00000
Serratia ficaria	61651	S	1	2	3	0.00000
Yersinia pestis	632	S	18	38	56	0.00003
Yersinia pseudotuberculosis	633	S	1	0	1	0.00000
Yersinia ruckeri	29486	S	13	1	14	0.00001
Yersinia enterocolitica	630	S	8	1	9	0.00001
Yersinia rohdei	29485	S	7	0	7	0.00000
Yersinia frederiksenii	29484	S	5	3	8	0.00000
Yersinia mollaretii	33060	S	3	0	3	0.00000
Yersinia massiliensis	419257	S	3	6	9	0.00001
Yersinia canariae	2607663	S	3	0	3	0.00000
Yersinia kristensenii	28152	S	2	6	8	0.00000
Yersinia entomophaga	935293	S	2	0	2	0.00000
Yersinia intermedia	631	S	1	3	4	0.00000
Yersinia aleksiciae	263819	S	1	0	1	0.00000
Rahnella aquatilis	34038	S	30	33	63	0.00004
Rahnella sp. ERMR1:05	1805933	S	9	0	9	0.00001
Rahnella aceris	2703885	S	4	3	7	0.00000
Nissabacter sp. SGAir0207	2126321	S	9	0	9	0.00001
Chania multitudinisentens	1639108	S	2	0	2	0.00000
Gibbsiella quercinecans	929813	S	1	0	1	0.00000
Rouxiella badensis	1646377	S	1	0	1	0.00000
Candidatus Fukatsuia symbiotica	1878942	S	1	0	1	0.00000
Pectobacterium odoriferum	78398	S	14	6	20	0.00001
Pectobacterium carotovorum	554	S	11	8	19	0.00001
Pectobacterium brasiliense	180957	S	8	4	12	0.00001
Pectobacterium parmentieri	1905730	S	8	2	10	0.00001
Pectobacterium versatile	2488639	S	7	5	12	0.00001
Pectobacterium wasabiae	55208	S	3	0	3	0.00000
Pectobacterium atrosepticum	29471	S	1	0	1	0.00000
Dickeya dianthicola	204039	S	10	2	12	0.00001
Dickeya zeae	204042	S	10	0	10	0.00001
Dickeya dadantii	204038	S	6	0	6	0.00000
Dickeya paradisiaca	69223	S	3	-3	0	0.00000
Dickeya solani	1089444	S	3	0	3	0.00000
Dickeya sp. NCPPB 3274	568766	S	2	0	2	0.00000
Dickeya sp. Secpp 1600	2037915	S	1	3	4	0.00000
Dickeya chrysanthemi	556	S	2	0	2	0.00000
Dickeya poaceiphila	568768	S	2	0	2	0.00000
Dickeya fangzhongdai	1778540	S	1	1	2	0.00000
Brenneria rubrifaciens	55213	S	8	3	11	0.00001
Brenneria goodwinii	1109412	S	3	3	6	0.00000
Lonsdalea populi	1172565	S	8	0	8	0.00000
Lonsdalea britannica	1082704	S	1	0	1	0.00000
Proteus mirabilis	584	S	18	5	23	0.00001
Proteus vulgaris	585	S	3	1	4	0.00000
Proteus hauseri	183417	S	2	0	2	0.00000
Proteus columbae	1987580	S	2	1	3	0.00000
Proteus terrae	1574161	S	1	4	5	0.00000
Providencia sneebia	516075	S	7	0	7	0.00000
Providencia rettgeri	587	S	5	6	11	0.00001
Providencia stuartii	588	S	2	7	9	0.00001
Providencia rustigianii	158850	S	2	0	2	0.00000
Providencia alcalifaciens	126385	S	1	0	1	0.00000
Providencia heimbachae	333962	S	1	0	1	0.00000
Xenorhabdus hominickii	351679	S	5	0	5	0.00000
Xenorhabdus bovienii	40576	S	4	0	4	0.00000
Xenorhabdus nematophila	628	S	2	0	2	0.00000
Xenorhabdus doucetiae	351671	S	2	0	2	0.00000
Xenorhabdus poinarii	40577	S	1	0	1	0.00000
Xenorhabdus budapestensis	290110	S	1	0	1	0.00000
Arsenophonus nasoniae	638	S	7	0	7	0.00000
Arsenophonus endosymbiont of Aphis craccivora	1231049	S	2	0	2	0.00000
Arsenophonus endosymbiont of Aleurodicus dispersus	235559	S	1	0	1	0.00000
Candidatus Arsenophonus lipoptenae	634113	S	1	0	1	0.00000
Photorhabdus laumondii	2218628	S	3	0	3	0.00000
Photorhabdus thracensis	230089	S	2	0	2	0.00000
Morganella morganii	582	S	3	0	3	0.00000
Edwardsiella hoshinae	93378	S	5	0	5	0.00000
Edwardsiella tarda	636	S	3	3	6	0.00000
Hafnia alvei	569	S	8	2	10	0.00001
Hafnia paralvei	546367	S	2	0	2	0.00000
Obesumbacterium proteus	82983	S	2	0	2	0.00000
Leminorella richardii	158841	S	6	0	6	0.00000
Pragia fontium	82985	S	6	0	6	0.00000
Jinshanibacter zhutongyuii	2498113	S	1	0	1	0.00000
Plesiomonas shigelloides	703	S	7	0	7	0.00000
Sodalis endosymbiont of Henestaris halophilus	1929246	S	4	0	4	0.00000
Halomonas sp. JS92-SW72	2306583	S	198	25	223	0.00014
Halomonas sp. MCCC 1A13718	2733488	S	11	0	11	0.00001
Halomonas sp. GFAJ-1	1118153	S	5	0	5	0.00000
Halomonas sp. PGE1	2730360	S	5	0	5	0.00000
Halomonas sp. THAF5a	2587844	S	5	0	5	0.00000
Halomonas sp. KO116	1504981	S	4	2	6	0.00000
Halomonas sp. THAF12	2587849	S	3	1	4	0.00000
Halomonas sp. HG01	1609967	S	2	0	2	0.00000
Halomonas sp. MCCC 1A13316	2733487	S	2	0	2	0.00000
Halomonas sp. HL-93	1666906	S	2	1	3	0.00000
Halomonas sp. N3-2A	2014541	S	2	1	3	0.00000
Halomonas sp. A40-4	2785909	S	1	0	1	0.00000
Halomonas sp. YLGW01	2773308	S	1	0	1	0.00000
Halomonas sp. SH5A2	2749040	S	1	0	1	0.00000
Halomonas sp. Y2R2	2562282	S	1	0	1	0.00000
Halomonas sp. BC-M4-5	2497861	S	1	0	1	0.00000
Halomonas sp. GT	1971364	S	1	0	1	0.00000
Halomonas meridiana	29570	S	15	5	20	0.00001
Halomonas elongata	2746	S	8	0	8	0.00000
Halomonas hydrothermalis	115561	S	8	5	13	0.00001
Halomonas beimenensis	475662	S	7	0	7	0.00000
Halomonas subglaciescola	29571	S	4	0	4	0.00000
Halomonas aestuarii	1897729	S	3	0	3	0.00000
Halomonas socia	1081866	S	3	0	3	0.00000
Halomonas chromatireducens	507626	S	3	0	3	0.00000
Halomonas piezotolerans	2609667	S	2	0	2	0.00000
Halomonas venusta	44935	S	2	1	3	0.00000
Halomonas alkaliphila	272774	S	1	4	5	0.00000
Halomonas titanicae	664683	S	1	4	5	0.00000
Halomonas campisalis	74661	S	1	7	8	0.00000
Salinicola tamaricis	1771309	S	12	0	12	0.00001
Candidatus Portiera aleyrodidarum	91844	S	7	0	7	0.00000
Zymobacter palmae	33074	S	1	0	1	0.00000
Cobetia sp. L2A1	2686360	S	3	0	3	0.00000
Cobetia sp. cqz5-12	2609415	S	2	5	7	0.00000
Cobetia sp. AM6	2661553	S	1	5	6	0.00000
Halotalea alkalilenta	376489	S	7	0	7	0.00000
Kushneria konosiri	698828	S	3	0	3	0.00000
Kushneria marisflavi	157779	S	2	0	2	0.00000
Kushneria phosphatilytica	657387	S	1	0	1	0.00000
Pistricoccus aurantiacus	1883414	S	5	0	5	0.00000
Chromohalobacter salexigens	158080	S	3	0	3	0.00000
Marinomonas sp. FW-1	2071621	S	8	4	12	0.00001
Marinomonas sp. MWYL1	400668	S	2	0	2	0.00000
Marinomonas primoryensis	178399	S	6	1	7	0.00000
Marinomonas mediterranea	119864	S	4	0	4	0.00000
Marinomonas arctica	383750	S	2	0	2	0.00000
Marinomonas posidonica	936476	S	2	0	2	0.00000
Marinomonas foliarum	491950	S	1	0	1	0.00000
Marinomonas algicola	2773454	S	1	0	1	0.00000
Marinobacterium georgiense	48076	S	7	0	7	0.00000
Marinobacterium aestuarii	1821621	S	6	0	6	0.00000
Marinobacterium sp. LSUCC0821	2668067	S	6	0	6	0.00000
Neptunomonas japonica	417574	S	12	0	12	0.00001
Neptunomonas concharum	1031538	S	4	0	4	0.00000
Neptunomonas phycophila	1572645	S	2	0	2	0.00000
Thalassolituus oleivorans	187493	S	6	0	6	0.00000
Nitrincola sp. KXZD1103	2614693	S	2	0	2	0.00000
Amphritea japonica	452627	S	2	0	2	0.00000
Bermanella marisrubri	207949	S	1	0	1	0.00000
Bacterioplanes sanyensis	1249553	S	1	0	1	0.00000
Alcanivorax sp. N3-2A	2014542	S	10	3	13	0.00001
Alcanivorax dieselolei	285091	S	3	1	4	0.00000
Alcanivorax xenomutans	1094342	S	3	1	4	0.00000
Alcanivorax pacificus	1306787	S	3	0	3	0.00000
Ketobacter alkanivorans	1917421	S	2	0	2	0.00000
Reinekea forsetii	1336806	S	6	0	6	0.00000
Gynuella sunshinyii	1445505	S	2	0	2	0.00000
Saccharospirillum mangrovi	2161747	S	1	0	1	0.00000
Spartinivicinus ruber	2683272	S	4	0	4	0.00000
Hahella sp. KA22	1628392	S	2	0	2	0.00000
Hahella chejuensis	158327	S	1	0	1	0.00000
Oleiphilus messinensis	141451	S	4	0	4	0.00000
Endozoicomonas montiporae	1027273	S	4	0	4	0.00000
Litoricola lipolytica	418701	S	3	0	3	0.00000
Kangiella koreensis	261964	S	2	0	2	0.00000
Kangiella geojedonensis	914150	S	1	0	1	0.00000
Shewanella sp. WE21	2029986	S	27	5	32	0.00002
Shewanella sp. Pdp11	2059264	S	11	6	17	0.00001
Shewanella sp. M2	2487742	S	8	0	8	0.00000
Shewanella sp. FJAT-51800	2814294	S	3	0	3	0.00000
Shewanella sp. SNU WT4	2590015	S	3	0	3	0.00000
Shewanella sp. FJAT-53726	2814295	S	2	1	3	0.00000
Shewanella sp. FJAT-52962	2814293	S	2	0	2	0.00000
Shewanella sp. FJAT-53720	2814292	S	2	1	3	0.00000
Shewanella sp. Arc9-LZ	2698686	S	2	0	2	0.00000
Shewanella sp. ANA-3	94122	S	2	1	3	0.00000
Shewanella sp. Scap07	2589987	S	1	0	1	0.00000
Shewanella sp. YLB-06	2593655	S	1	0	1	0.00000
Shewanella sp. MR-7	60481	S	1	0	1	0.00000
Shewanella sp. MR-4	60480	S	1	0	1	0.00000
Shewanella khirikhana	1965282	S	10	0	10	0.00001
Shewanella baltica	62322	S	10	2	12	0.00001
Shewanella donghaensis	238836	S	8	0	8	0.00000
Shewanella aestuarii	1028752	S	7	1	8	0.00000
Shewanella frigidimarina	56812	S	6	1	7	0.00000
Shewanella denitrificans	192073	S	6	0	6	0.00000
Shewanella algae	38313	S	5	1	6	0.00000
Shewanella piezotolerans	404011	S	5	0	5	0.00000
Shewanella amazonensis	60478	S	5	0	5	0.00000
Shewanella putrefaciens	24	S	4	4	8	0.00000
Shewanella maritima	2520507	S	2	0	2	0.00000
Shewanella livingstonensis	150120	S	2	0	2	0.00000
Shewanella litorisediminis	1173586	S	2	0	2	0.00000
Shewanella decolorationis	256839	S	2	0	2	0.00000
Shewanella violacea	60217	S	2	0	2	0.00000
Shewanella sediminis	271097	S	2	0	2	0.00000
Shewanella halifaxensis	271098	S	2	0	2	0.00000
Shewanella polaris	2588449	S	1	1	2	0.00000
Shewanella benthica	43661	S	1	0	1	0.00000
Shewanella loihica	359303	S	1	0	1	0.00000
Shewanella japonica	93973	S	1	1	2	0.00000
Parashewanella spongiae	342950	S	2	0	2	0.00000
Parashewanella tropica	2547970	S	1	0	1	0.00000
Marinobacter sp. LQ44	1749259	S	6	3	9	0.00001
Marinobacter sp. es.042	1761794	S	5	1	6	0.00000
Marinobacter sp. NP-4(2019)	2488665	S	5	0	5	0.00000
Marinobacter sp. Arc7-DN-1	2304594	S	4	0	4	0.00000
Marinobacter sp. LPB0319	2769486	S	4	0	4	0.00000
Marinobacter sp. LV10R510-11A	1415568	S	3	0	3	0.00000
Marinobacter sp. CP1	1671721	S	2	1	3	0.00000
Marinobacter sp. JH2	2547598	S	2	0	2	0.00000
Marinobacter sp. BSs20148	490759	S	1	0	1	0.00000
Marinobacter hydrocarbonoclasticus	2743	S	13	3	16	0.00001
Marinobacter salarius	1420917	S	8	0	8	0.00000
Marinobacter fonticola	2603215	S	3	0	3	0.00000
Marinobacter psychrophilus	330734	S	2	0	2	0.00000
Marinobacter salsuginis	418719	S	2	0	2	0.00000
Marinobacter salinus	1874317	S	1	0	1	0.00000
Alteromonas sp. RKMC-009	2267264	S	5	1	6	0.00000
Alteromonas sp. BL110	1714845	S	3	6	9	0.00001
Alteromonas macleodii	28108	S	3	2	5	0.00000
Alteromonas mediterranea	314275	S	3	1	4	0.00000
Alteromonas naphthalenivorans	715451	S	1	1	2	0.00000
Alteromonas pelagimontana	1858656	S	1	0	1	0.00000
Glaciecola amylolytica	2489595	S	18	0	18	0.00001
Hydrocarboniclastica marina	2259620	S	12	0	12	0.00001
Saliniradius amylolyticus	2183582	S	11	0	11	0.00001
Salinimonas lutimaris	914153	S	4	0	4	0.00000
Salinimonas sp. G2-b	2785918	S	3	0	3	0.00000
Salinimonas sp. KX18D6	2572577	S	1	0	1	0.00000
Salinimonas sediminis	2303538	S	2	0	2	0.00000
Paraglaciecola sp. L3A3	2686358	S	2	0	2	0.00000
Paraglaciecola sp. L1A13	2686359	S	1	0	1	0.00000
Paraglaciecola psychrophila	326544	S	2	0	2	0.00000
Paraglaciecola mesophila	197222	S	1	0	1	0.00000
Catenovulum sediminis	1740262	S	1	0	1	0.00000
Catenovulum sp. CCB-QB4	2172099	S	1	0	1	0.00000
Agarivorans gilvus	680279	S	1	0	1	0.00000
Lacimicrobium alkaliphilum	1526571	S	1	0	1	0.00000
Pseudoalteromonas sp. SM1988	2744479	S	5	0	5	0.00000
Pseudoalteromonas sp. DL-6	1390185	S	5	2	7	0.00000
Pseudoalteromonas sp. 1_2015MBL_MicDiv	1720343	S	3	3	6	0.00000
Pseudoalteromonas sp. A25	116092	S	2	0	2	0.00000
Pseudoalteromonas sp. PS1M3	87791	S	2	3	5	0.00000
Pseudoalteromonas sp. Bsw20308	283699	S	2	2	4	0.00000
Pseudoalteromonas sp. R3	1709477	S	2	0	2	0.00000
Pseudoalteromonas sp. GCY	2003316	S	1	0	1	0.00000
Pseudoalteromonas sp. THAF3	2587843	S	1	0	1	0.00000
Pseudoalteromonas luteoviolacea	43657	S	13	0	13	0.00001
Pseudoalteromonas rubra	43658	S	9	0	9	0.00001
Pseudoalteromonas spongiae	298657	S	9	0	9	0.00001
Pseudoalteromonas tunicata	314281	S	7	0	7	0.00000
Pseudoalteromonas agarivorans	176102	S	6	8	14	0.00001
Pseudoalteromonas shioyasakiensis	1190813	S	3	0	3	0.00000
Pseudoalteromonas ulvae	107327	S	3	0	3	0.00000
Pseudoalteromonas piratica	1348114	S	2	0	2	0.00000
Pseudoalteromonas arctica	394751	S	2	1	3	0.00000
Pseudoalteromonas translucida	166935	S	2	0	2	0.00000
Pseudoalteromonas phenolica	161398	S	2	0	2	0.00000
Pseudoalteromonas undina	43660	S	2	1	3	0.00000
Pseudoalteromonas prydzensis	182141	S	1	0	1	0.00000
Pseudoalteromonas arabiensis	874454	S	1	0	1	0.00000
Pseudoalteromonas marina	267375	S	1	1	2	0.00000
Pseudoalteromonas nigrifaciens	28109	S	1	2	3	0.00000
Pseudoalteromonas viridis	339617	S	1	0	1	0.00000
Pseudoalteromonas espejiana	28107	S	1	0	1	0.00000
Psychrosphaera aestuarii	1266052	S	1	0	1	0.00000
Psychrosphaera sp. MTZ26	2820710	S	1	0	1	0.00000
Colwellia sp. PAMC 21821	1816219	S	6	1	7	0.00000
Colwellia sp. PAMC 20917	1816218	S	3	0	3	0.00000
Colwellia sp. Arc7-D	2161872	S	2	0	2	0.00000
Colwellia sp. Arc7-635	2497879	S	2	0	2	0.00000
Colwellia psychrerythraea	28229	S	3	0	3	0.00000
Colwellia beringensis	1967665	S	3	0	3	0.00000
Thalassotalea sp. HSM 43	2552945	S	6	0	6	0.00000
Thalassotalea sp. PS06	2594005	S	1	0	1	0.00000
Thalassotalea crassostreae	1763536	S	1	0	1	0.00000
Litorilituus sediminis	718192	S	7	0	7	0.00000
Ferrimonas balearica	44012	S	5	0	5	0.00000
Ferrimonas lipolytica	2724191	S	5	0	5	0.00000
Psychromonas ingrahamii	357794	S	7	0	7	0.00000
Psychromonas sp. CNPT3	314282	S	2	0	2	0.00000
Idiomarina loihiensis	135577	S	2	-2	0	0.00000
Idiomarina piscisalsi	1096243	S	2	0	2	0.00000
Idiomarina sp. OT37-5b	2100422	S	2	0	2	0.00000
Moritella yayanosii	69539	S	2	0	2	0.00000
Moritella marina	90736	S	2	0	2	0.00000
Aeromonas media	651	S	131	96	227	0.00014
Aeromonas hydrophila	644	S	30	24	54	0.00003
Aeromonas veronii	654	S	29	9	38	0.00002
Aeromonas sp. CA23	2033032	S	8	1	9	0.00001
Aeromonas sp.	647	S	4	4	8	0.00000
Aeromonas sp. ASNIH2	1636607	S	3	14	17	0.00001
Aeromonas sp. 2692-1	2560029	S	3	7	10	0.00001
Aeromonas sp. ASNIH7	1920107	S	2	29	31	0.00002
Aeromonas sp. CU5	2033033	S	2	0	2	0.00000
Aeromonas sp. ASNIH3	1636608	S	1	22	23	0.00001
Aeromonas sp. ASNIH4	1636609	S	1	2	3	0.00000
Aeromonas caviae	648	S	13	35	48	0.00003
Aeromonas encheleia	73010	S	8	0	8	0.00000
Aeromonas simiae	218936	S	5	0	5	0.00000
Aeromonas salmonicida	645	S	3	9	12	0.00001
Aeromonas jandaei	650	S	2	0	2	0.00000
Aeromonas rivipollensis	948519	S	1	0	1	0.00000
Aeromonas allosaccharophila	656	S	1	0	1	0.00000
Aeromonas schubertii	652	S	1	0	1	0.00000
Tolumonas auensis	43948	S	22	2	24	0.00001
Oceanisphaera avium	1903694	S	4	1	5	0.00000
Oceanisphaera profunda	1416627	S	2	0	2	0.00000
Zobellella denitrificans	347534	S	7	0	7	0.00000
Oceanimonas sp. GK1	511062	S	3	0	3	0.00000
Dongshaea marina	2047966	S	2	0	2	0.00000
Succinivibrio dextrinosolvens	83771	S	7	0	7	0.00000
Rheinheimera sp. LHK132	2498451	S	35	0	35	0.00002
Rheinheimera sp. F8	1763998	S	12	0	12	0.00001
Rheinheimera sp. D18	2545632	S	5	0	5	0.00000
Candidatus Thiodictyon syntrophicum	1166950	S	49	1	50	0.00003
Nitrosococcus halophilus	133539	S	7	0	7	0.00000
Nitrosococcus watsonii	473531	S	4	0	4	0.00000
Nitrosococcus oceani	1229	S	3	0	3	0.00000
Nitrosococcus wardiae	1814290	S	3	0	3	0.00000
Thiocystis violascens	73141	S	16	0	16	0.00001
Thermochromatium tepidum	1050	S	13	1	14	0.00001
Candidatus Nitrosacidococcus tergens	553981	S	9	0	9	0.00001
Allochromatium vinosum	1049	S	8	1	9	0.00001
Marichromatium purpuratum	37487	S	6	0	6	0.00000
Thioflavicoccus mobilis	80679	S	6	0	6	0.00000
Candidatus Nitrosoglobus terrae	1630141	S	4	0	4	0.00000
Caldichromatium japonicum	2699430	S	2	0	2	0.00000
Thioalkalivibrio sulfidiphilus	1033854	S	31	7	38	0.00002
Thioalkalivibrio nitratireducens	186931	S	7	4	11	0.00001
Thioalkalivibrio versutus	106634	S	6	0	6	0.00000
Thioalkalivibrio paradoxus	108010	S	4	2	6	0.00000
Thioalkalivibrio sp. K90mix	396595	S	4	0	4	0.00000
Acidihalobacter ferrooxydans	1765967	S	13	0	13	0.00001
Acidihalobacter yilgarnenesis	2819280	S	6	0	6	0.00000
Acidihalobacter aeolianus	2792603	S	2	0	2	0.00000
Halorhodospira halophila	1053	S	13	1	14	0.00001
Ectothiorhodospira sp. BSL-9	1442136	S	2	5	7	0.00000
Aquisalimonas sp. 2447	2740807	S	4	0	4	0.00000
Spiribacter curvatus	1335757	S	3	0	3	0.00000
Spiribacter sp. 2438	2666185	S	1	0	1	0.00000
Alkalilimnicola ehrlichii	351052	S	2	0	2	0.00000
Wenzhouxiangella marina	1579979	S	12	0	12	0.00001
Wenzhouxiangella sp. AB-CW3	2771012	S	10	0	10	0.00001
Halothiobacillus sp. LS2	1860122	S	8	0	8	0.00000
Halothiobacillus neapolitanus	927	S	3	0	3	0.00000
Thiohalobacter sp. COW1	2795687	S	3	3	6	0.00000
Thiohalobacter thiocyanaticus	585455	S	2	2	4	0.00000
Granulosicoccus antarcticus	437505	S	5	0	5	0.00000
Sulfuriflexus mobilis	1811807	S	4	0	4	0.00000
Guyparkeria halophila	47960	S	9	0	9	0.00001
Sulfurivermis fontis	1972068	S	7	0	7	0.00000
Woeseia oceani	1548547	S	2	0	2	0.00000
Vibrio anguillarum	55601	S	101	17	118	0.00007
Vibrio parahaemolyticus	670	S	10	1	11	0.00001
Vibrio diabolicus	50719	S	5	3	8	0.00000
Vibrio campbellii	680	S	5	0	5	0.00000
Vibrio harveyi	669	S	4	0	4	0.00000
Vibrio azureus	512649	S	3	0	3	0.00000
Vibrio alginolyticus	663	S	1	1	2	0.00000
Vibrio rotiferianus	190895	S	1	0	1	0.00000
Vibrio vulnificus	672	S	25	1	26	0.00002
Vibrio sp. SM1977	2662262	S	7	0	7	0.00000
Vibrio sp. HDW18	2714948	S	6	0	6	0.00000
Vibrio sp. ZWAL4003	2711221	S	3	0	3	0.00000
Vibrio sp. THAF190c	2587865	S	2	0	2	0.00000
Vibrio sp. Sal10	2777577	S	1	0	1	0.00000
Vibrio sp. Scap24	2589990	S	1	0	1	0.00000
Vibrio splendidus	29497	S	6	0	6	0.00000
Vibrio taketomensis	2572923	S	5	0	5	0.00000
Vibrio fluvialis	676	S	5	0	5	0.00000
Vibrio furnissii	29494	S	4	0	4	0.00000
Vibrio crassostreae	246167	S	4	0	4	0.00000
Vibrio rumoiensis	76258	S	4	1	5	0.00000
Vibrio mimicus	674	S	3	0	3	0.00000
Vibrio tapetis	52443	S	3	0	3	0.00000
Vibrio tritonius	1435069	S	2	0	2	0.00000
Vibrio alfacsensis	1074311	S	2	0	2	0.00000
Vibrio atlanticus	693153	S	2	0	2	0.00000
Vibrio breoganii	553239	S	2	0	2	0.00000
Vibrio metoecus	1481663	S	2	0	2	0.00000
Vibrio chagasii	170679	S	2	0	2	0.00000
Vibrio kanaloae	170673	S	2	0	2	0.00000
Vibrio europaeus	300876	S	1	1	2	0.00000
Vibrio zhugei	2479546	S	2	0	2	0.00000
Vibrio metschnikovii	28172	S	2	0	2	0.00000
Vibrio aphrogenes	1891186	S	1	0	1	0.00000
Vibrio spartinae	1918945	S	1	0	1	0.00000
Vibrio qinghaiensis	2025808	S	1	0	1	0.00000
Vibrio aquimaris	2587862	S	1	0	1	0.00000
Vibrio cholerae	666	S	1	0	1	0.00000
Vibrio casei	673372	S	1	0	1	0.00000
Vibrio panuliri	1381081	S	1	0	1	0.00000
Vibrio coralliilyticus	190893	S	1	0	1	0.00000
Vibrio scophthalmi	45658	S	1	0	1	0.00000
Vibrio navarrensis	29495	S	1	0	1	0.00000
Vibrio nigripulchritudo	28173	S	1	0	1	0.00000
Photobacterium damselae	38293	S	7	1	8	0.00000
Photobacterium gaetbulicola	1295392	S	3	0	3	0.00000
Photobacterium ganghwense	320778	S	2	0	2	0.00000
Photobacterium profundum	74109	S	1	0	1	0.00000
Aliivibrio fischeri	668	S	9	0	9	0.00001
Aliivibrio salmonicida	40269	S	2	0	2	0.00000
Salinivibrio kushneri	1908198	S	4	0	4	0.00000
Salinivibrio costicola	51367	S	1	1	2	0.00000
Grimontia hollisae	673	S	2	0	2	0.00000
Paraphotobacterium marinum	1755811	S	2	0	2	0.00000
Legionella pneumophila	446	S	27	8	35	0.00002
Legionella sp. TUM19329	2708020	S	8	0	8	0.00000
Legionella sp. MW5194	2662448	S	7	1	8	0.00000
Legionella sp. PC997	2755562	S	5	0	5	0.00000
Legionella sp. PC1000	2746060	S	1	0	1	0.00000
Legionella oakridgensis	29423	S	20	1	21	0.00001
Legionella longbeachae	450	S	13	1	14	0.00001
Legionella hackeliae	449	S	13	3	16	0.00001
Legionella cherrii	28084	S	9	0	9	0.00001
Legionella clemsonensis	1867846	S	9	1	10	0.00001
Legionella fallonii	96230	S	8	0	8	0.00000
Legionella jordanis	456	S	5	0	5	0.00000
Legionella anisa	28082	S	5	0	5	0.00000
Legionella adelaidensis	45056	S	5	0	5	0.00000
Legionella waltersii	66969	S	5	0	5	0.00000
Legionella geestiana	45065	S	4	0	4	0.00000
Legionella endosymbiont of Polyplax serrata	2005262	S	4	0	4	0.00000
Legionella spiritensis	452	S	2	0	2	0.00000
Legionella israelensis	454	S	2	0	2	0.00000
Legionella sainthelensi	28087	S	1	0	1	0.00000
Legionella lansingensis	45067	S	1	0	1	0.00000
Tatlockia micdadei	451	S	3	0	3	0.00000
Fluoribacter dumoffii	463	S	2	1	3	0.00000
Candidatus Rickettsiella viridis	676208	S	44	0	44	0.00003
Coxiella burnetii	777	S	13	1	14	0.00001
Candidatus Coxiella mudrowiae	2054173	S	1	0	1	0.00000
Aquicella siphonis	254247	S	6	1	7	0.00000
Aquicella lusitana	254246	S	5	1	6	0.00000
Cellvibrio sp. KY-YJ-3	454662	S	27	5	32	0.00002
Cellvibrio sp. KY-GH-1	2303332	S	21	2	23	0.00001
Cellvibrio sp. PSBB023	1945512	S	12	1	13	0.00001
Cellvibrio sp. PSBB006	1987723	S	8	0	8	0.00000
Cellvibrio japonicus	155077	S	6	0	6	0.00000
Teredinibacter purpureus	2731756	S	7	0	7	0.00000
Teredinibacter turnerae	2426	S	2	0	2	0.00000
Teredinibacter haidensis	2731755	S	2	0	2	0.00000
Agarilytica rhodophyticola	1737490	S	7	0	7	0.00000
Saccharophagus degradans	86304	S	6	0	6	0.00000
Simiduia agarivorans	447471	S	4	0	4	0.00000
Microbulbifer sp. A4B17	359370	S	3	0	3	0.00000
Microbulbifer sp. YPW1	2745199	S	3	0	3	0.00000
Microbulbifer sp. ALW1	1516059	S	2	0	2	0.00000
Microbulbifer sp. THAF38	2587856	S	2	0	2	0.00000
Microbulbifer sp. SH-1	2681547	S	2	0	2	0.00000
Microbulbifer sp. GL-2	2591606	S	1	0	1	0.00000
Microbulbifer hydrolyticus	48074	S	10	0	10	0.00001
Microbulbifer aggregans	1769779	S	7	0	7	0.00000
Microbulbifer agarilyticus	260552	S	6	0	6	0.00000
Microbulbifer thermotolerans	252514	S	4	0	4	0.00000
Halioglobus pacificus	930806	S	13	0	13	0.00001
Halioglobus maricola	2601894	S	6	0	6	0.00000
Halioglobus japonicus	930805	S	2	0	2	0.00000
Congregibacter litoralis	393662	S	7	1	8	0.00000
Kineobactrum salinum	2708301	S	6	0	6	0.00000
Spongiibacter sp. IMCC21906	1620392	S	6	0	6	0.00000
Spongiibacter sp. CSC3.9	2794344	S	3	0	3	0.00000
Zhongshania aliphaticivorans	1470434	S	6	0	6	0.00000
Haemophilus parainfluenzae	729	S	17	1	18	0.00001
Haemophilus influenzae	727	S	10	3	13	0.00001
Haemophilus haemolyticus	726	S	3	0	3	0.00000
Haemophilus parahaemolyticus	735	S	3	0	3	0.00000
[Haemophilus] ducreyi	730	S	2	0	2	0.00000
Haemophilus pittmaniae	249188	S	1	0	1	0.00000
Pasteurella multocida	747	S	25	16	41	0.00003
Pasteurella skyensis	97481	S	1	0	1	0.00000
Mannheimia granulomatis	85402	S	5	0	5	0.00000
Mannheimia varigena	85404	S	3	0	3	0.00000
Mannheimia bovis	2770636	S	3	0	3	0.00000
Mannheimia pernigra	111844	S	2	1	3	0.00000
Mannheimia haemolytica	75985	S	1	0	1	0.00000
Mannheimia sp. USDA-ARS-USMARC-1261	1432056	S	1	0	1	0.00000
Mannheimia ovis	2679994	S	1	0	1	0.00000
Actinobacillus delphinicola	51161	S	4	0	4	0.00000
Actinobacillus porcitonsillarum	189834	S	4	0	4	0.00000
Actinobacillus sp. GY-402	2774188	S	3	0	3	0.00000
Actinobacillus pleuropneumoniae	715	S	2	0	2	0.00000
Actinobacillus indolicus	51049	S	1	0	1	0.00000
Aggregatibacter aphrophilus	732	S	2	0	2	0.00000
Aggregatibacter segnis	739	S	2	0	2	0.00000
Aggregatibacter actinomycetemcomitans	714	S	1	0	1	0.00000
Aggregatibacter sp. 2125159857	2820817	S	1	0	1	0.00000
Glaesserella parasuis	738	S	3	0	3	0.00000
Glaesserella sp. 15-184	2030797	S	3	0	3	0.00000
Gallibacterium anatis	750	S	5	0	5	0.00000
Bibersteinia trehalosi	47735	S	4	118	122	0.00007
Otariodibacter oris	1032623	S	3	0	3	0.00000
Histophilus somni	731	S	2	0	2	0.00000
Bisgaardia hudsonensis	109472	S	2	0	2	0.00000
Rodentibacter heylii	1906744	S	2	0	2	0.00000
Avibacterium volantium	762	S	1	0	1	0.00000
Vespertiliibacter pulmonis	1443036	S	1	0	1	0.00000
Frederiksenia canicola	123824	S	1	0	1	0.00000
Methylomonas sp. LW13	107637	S	7	0	7	0.00000
Methylomonas sp. DH-1	1727196	S	4	1	5	0.00000
Methylomonas sp. LL1	2785785	S	3	0	3	0.00000
Methylomonas sp. EFPC1	2812647	S	2	0	2	0.00000
Methylomonas denitrificans	1538553	S	10	0	10	0.00001
Methylomonas rhizoryzae	2608981	S	7	0	7	0.00000
Methylomonas methanica	421	S	6	0	6	0.00000
Methylomonas koyamae	702114	S	3	0	3	0.00000
Methylococcus sp. IM1	2681310	S	14	0	14	0.00001
Methylococcus sp. EFPC2	2812648	S	8	0	8	0.00000
Methylococcus capsulatus	414	S	5	0	5	0.00000
Methylovulum psychrotolerans	1704499	S	26	0	26	0.00002
Methylocaldum marinum	1432792	S	9	0	9	0.00001
Candidatus Methylospira mobilis	1808979	S	9	0	9	0.00001
Methylomicrobium album	39775	S	6	0	6	0.00000
Methylomicrobium sp. wino1	2049332	S	2	2	4	0.00000
Methylotuvimicrobium buryatense	95641	S	3	4	7	0.00000
Methylotuvimicrobium alcaliphilum	271065	S	1	1	2	0.00000
Piscirickettsia salmonis	1238	S	18	0	18	0.00001
Hydrogenovibrio crunogenus	39765	S	5	0	5	0.00000
Hydrogenovibrio marinus	28885	S	1	0	1	0.00000
Hydrogenovibrio thermophilus	265883	S	1	0	1	0.00000
Thiomicrorhabdus aquaedulcis	2211106	S	4	0	4	0.00000
Thiomicrorhabdus xiamenensis	2739063	S	2	0	2	0.00000
Thiomicrorhabdus sediminis	2580412	S	1	0	1	0.00000
Cycloclasticus zancles	1329899	S	2	4	6	0.00000
Thiomicrospira aerophila	92245	S	2	0	2	0.00000
Thiomicrospira cyclica	147268	S	2	0	2	0.00000
Thiomicrospira sp. S5	1803865	S	1	0	1	0.00000
Methylophaga nitratireducenticrescens	754476	S	2	0	2	0.00000
Thiosulfatimonas sediminis	2675054	S	2	0	2	0.00000
Thiosulfativibrio zosterae	2675053	S	1	0	1	0.00000
Thiothrix sp. Ku-5	2735563	S	15	2	17	0.00001
Thiothrix sp.	1032	S	10	1	11	0.00001
Thiothrix unzii	111769	S	10	3	13	0.00001
Beggiatoa leptomitoformis	288004	S	7	0	7	0.00000
Francisella sp. FSC1006	1547445	S	6	0	6	0.00000
Francisella sp. Scap27	2589986	S	2	1	3	0.00000
Francisella sp. LA112445	1395624	S	1	0	1	0.00000
Francisella tularensis	263	S	4	2	6	0.00000
Francisella halioticida	549298	S	4	0	4	0.00000
Francisella orientalis	299583	S	2	1	3	0.00000
Francisella persica	954	S	1	0	1	0.00000
Francisella philomiragia	28110	S	1	0	1	0.00000
Francisella salina	573569	S	1	2	3	0.00000
Francisella uliginis	573570	S	1	0	1	0.00000
Francisella hispaniensis	622488	S	1	0	1	0.00000
Francisella frigiditurris	1542390	S	1	0	1	0.00000
Allofrancisella frigidaquae	1085644	S	2	0	2	0.00000
Allofrancisella guangzhouensis	594679	S	1	0	1	0.00000
Allofrancisella inopinata	1085647	S	1	0	1	0.00000
Bathymodiolus septemdierum thioautotrophic gill symbiont	113267	S	10	0	10	0.00001
Candidatus Vesicomyosocius sp. SY067_SCS001	2732590	S	3	0	3	0.00000
Candidatus Vesicomyosocius okutanii	412965	S	1	0	1	0.00000
Candidatus Ruthia endofausta	2738852	S	1	0	1	0.00000
Candidatus Thioglobus singularis	1427364	S	5	0	5	0.00000
Candidatus Thioglobus sp. NP1	2508687	S	4	0	4	0.00000
Gallaecimonas mangrovi	2291597	S	6	0	6	0.00000
Pseudohongiella spirulinae	1249552	S	6	0	6	0.00000
Sedimenticola thiotaurini	1543721	S	4	0	4	0.00000
Thiolapillus brandeum	1076588	S	4	0	4	0.00000
Candidatus Nardonella dryophthoridicola	1971485	S	1	0	1	0.00000
endosymbiont of Pachyrhynchus infernalis	1971488	S	1	0	1	0.00000
Candidatus Azoamicus ciliaticola	2652803	S	3	0	3	0.00000
Candidatus Reidiella endopervernicosa	2738883	S	2	0	2	0.00000
Solimonas sp. K1W22B-7	2303331	S	19	0	19	0.00001
Sinimarinibacterium sp. NLF-5-8	2698684	S	11	1	12	0.00001
Steroidobacter denitrificans	465721	S	8	0	8	0.00000
Sulfuricaulis limicola	1620215	S	9	0	9	0.00001
Sulfurifustis variabilis	1675686	S	5	0	5	0.00000
Acidiferrobacter sp. SPIII_3	1281578	S	3	0	3	0.00000
Gilliamella apicola	1196095	S	12	0	12	0.00001
Orbus sp. IPMB12	1635327	S	1	0	1	0.00000
Immundisolibacter cernigliae	1810504	S	12	0	12	0.00001
endosymbiont of unidentified scaly snail isolate Monju	1248727	S	9	0	9	0.00001
endosymbiont of Euscepes postfasciatus	650377	S	1	0	1	0.00000
Cardiobacterium hominis	2718	S	3	0	3	0.00000
Dichelobacter nodosus	870	S	2	0	2	0.00000
Salinisphaera sp. LB1	2183911	S	5	0	5	0.00000
Methylobacterium sp. WL1	2603276	S	111	9	120	0.00007
Methylobacterium sp. C1	1479019	S	98	287	385	0.00024
Methylobacterium sp. 17Sr1-43	2202828	S	59	6	65	0.00004
Methylobacterium sp. XJLW	739141	S	54	441	495	0.00030
Methylobacterium sp. 4-46	426117	S	32	2	34	0.00002
Methylobacterium sp. 17Sr1-1	2202826	S	16	3	19	0.00001
Methylobacterium sp. AMS5	925818	S	11	4	15	0.00001
Methylobacterium sp. DM1	2067957	S	9	10	19	0.00001
Methylobacterium mesophilicum	39956	S	238	19	257	0.00016
Methylobacterium radiotolerans	31998	S	179	333	512	0.00031
Methylobacterium brachiatum	269660	S	101	24	125	0.00008
Methylobacterium aquaticum	270351	S	91	18	109	0.00007
Methylobacterium phyllosphaerae	418223	S	46	90	136	0.00008
Methylobacterium indicum	1775910	S	40	9	49	0.00003
Methylobacterium nodulans	114616	S	38	1	39	0.00002
Methylobacterium durans	2202825	S	31	2	33	0.00002
Methylobacterium oryzae	334852	S	12	106	118	0.00007
Methylobacterium terrae	2202827	S	12	2	14	0.00001
Methylobacterium currus	2051553	S	9	2	11	0.00001
Methylorubrum extorquens	408	S	49	47	96	0.00006
Methylorubrum populi	223967	S	27	8	35	0.00002
Microvirga sp. 17 mud 1-3	2082949	S	14	2	16	0.00001
Microvirga sp. VF16	2807101	S	8	0	8	0.00000
Microvirga ossetica	1882682	S	14	2	16	0.00001
Microvirga thermotolerans	2651334	S	7	1	8	0.00000
Bradyrhizobium sp. BTAi1	288000	S	168	20	188	0.00012
Bradyrhizobium sp. CCBAU 051011	858422	S	31	3	34	0.00002
Bradyrhizobium sp. ORS 285	115808	S	28	4	32	0.00002
Bradyrhizobium sp. CCBAU 51753	1325100	S	26	4	30	0.00002
Bradyrhizobium sp. PSBB068	2715960	S	25	5	30	0.00002
Bradyrhizobium sp. CCBAU 51765	1325102	S	25	6	31	0.00002
Bradyrhizobium sp. ORS 278	114615	S	22	3	25	0.00002
Bradyrhizobium sp.	376	S	18	33	51	0.00003
Bradyrhizobium sp. CCBAU 53421	1325120	S	15	3	18	0.00001
Bradyrhizobium sp. 6(2017)	1197460	S	13	2	15	0.00001
Bradyrhizobium sp. CCBAU 53340	1325112	S	12	7	19	0.00001
Bradyrhizobium sp. CCGE-LA001	1223566	S	11	2	13	0.00001
Bradyrhizobium sp. CCBAU 53351	1325114	S	10	7	17	0.00001
Bradyrhizobium sp. CCBAU 53338	1325111	S	9	5	14	0.00001
Bradyrhizobium sp. 1(2017)	1404888	S	7	1	8	0.00000
Bradyrhizobium sp. SK17	2057741	S	7	2	9	0.00001
Bradyrhizobium sp. LCT2	2493093	S	5	15	20	0.00001
Bradyrhizobium sp. TM102	2599819	S	4	33	37	0.00002
Bradyrhizobium sp. WSM471	319017	S	3	8	11	0.00001
Bradyrhizobium sp. 323S2	1404649	S	2	2	4	0.00000
Bradyrhizobium erythrophlei	1437360	S	77	4	81	0.00005
Bradyrhizobium diazoefficiens	1355477	S	52	68	120	0.00007
Bradyrhizobium paxllaeri	190148	S	38	5	43	0.00003
Bradyrhizobium lablabi	722472	S	29	46	75	0.00005
Bradyrhizobium guangdongense	1325090	S	22	17	39	0.00002
Bradyrhizobium canariense	255045	S	20	1	21	0.00001
Bradyrhizobium cosmicum	1404864	S	19	4	23	0.00001
Bradyrhizobium icense	1274631	S	17	1	18	0.00001
Bradyrhizobium japonicum	375	S	16	11	27	0.00002
Bradyrhizobium genosp. L	83637	S	16	2	18	0.00001
Bradyrhizobium genosp. B	83627	S	14	2	16	0.00001
Bradyrhizobium betae	244734	S	13	7	20	0.00001
Bradyrhizobium guangzhouense	1325095	S	13	8	21	0.00001
Bradyrhizobium vignae	1549949	S	13	1	14	0.00001
Bradyrhizobium symbiodeficiens	1404367	S	11	2	13	0.00001
Bradyrhizobium guangxiense	1325115	S	10	6	16	0.00001
Bradyrhizobium oligotrophicum	44255	S	10	1	11	0.00001
Bradyrhizobium amphicarpaeae	1404768	S	9	2	11	0.00001
Bradyrhizobium zhanjiangense	1325107	S	7	1	8	0.00000
Bradyrhizobium arachidis	858423	S	3	0	3	0.00000
Bradyrhizobium ottawaense	931866	S	2	14	16	0.00001
Bradyrhizobium elkanii	29448	S	2	63	65	0.00004
Bosea sp. RAC05	1842539	S	60	11	71	0.00004
Bosea sp. Tri-49	1867715	S	30	3	33	0.00002
Bosea sp. F3-2	2599640	S	26	5	31	0.00002
Bosea sp. ANAM02	2020412	S	24	5	29	0.00002
Bosea sp. PAMC 26642	1792307	S	21	2	23	0.00001
Bosea sp. AS-1	2015316	S	15	3	18	0.00001
Bosea vaviloviae	1526658	S	25	4	29	0.00002
Rhodopseudomonas palustris	1076	S	111	22	133	0.00008
Afipia carboxidovorans	40137	S	21	35	56	0.00003
Afipia sp. GAS231	1882747	S	16	13	29	0.00002
Tardiphaga robiniae	943830	S	21	1	22	0.00001
Nitrobacter hamburgensis	912	S	16	3	19	0.00001
Nitrobacter winogradskyi	913	S	9	2	11	0.00001
Variibacter gotjawalensis	1333996	S	22	0	22	0.00001
Rhizobium sp. WL3	2603277	S	12	1	13	0.00001
Rhizobium sp. NXC24	2048897	S	9	0	9	0.00001
Rhizobium sp. Khangiran2	1435607	S	8	9	17	0.00001
Rhizobium sp. NLR16a	2731112	S	7	4	11	0.00001
Rhizobium sp. BG4	2613770	S	6	0	6	0.00000
Rhizobium sp. CIAT894	2020312	S	5	2	7	0.00000
Rhizobium sp. 11515TR	2028343	S	4	0	4	0.00000
Rhizobium sp. NXC14	1981173	S	3	1	4	0.00000
Rhizobium sp. NZLR1	2731096	S	3	0	3	0.00000
Rhizobium sp. S41	1869170	S	3	34	37	0.00002
Rhizobium sp. ADMK78	1813451	S	3	0	3	0.00000
Rhizobium sp. ACO-34A	1571470	S	2	0	2	0.00000
Rhizobium sp. IE4771	1301032	S	1	4	5	0.00000
Rhizobium sp. ZX09	2291939	S	1	4	5	0.00000
Rhizobium leguminosarum	384	S	50	24	74	0.00005
Rhizobium lusitanum	293958	S	15	1	16	0.00001
Rhizobium pseudoryzae	379684	S	13	1	14	0.00001
Rhizobium rosettiformans	1368430	S	12	6	18	0.00001
Rhizobium phaseoli	396	S	9	14	23	0.00001
Rhizobium flavum	1335061	S	9	5	14	0.00001
Rhizobium favelukesii	348824	S	9	3	12	0.00001
Rhizobium etli	29449	S	9	10	19	0.00001
Rhizobium bangladeshense	1138189	S	8	1	9	0.00001
Rhizobium jaguaris	1312183	S	8	0	8	0.00000
Rhizobium indicum	2583231	S	7	4	11	0.00001
Rhizobium hidalgonense	1538159	S	7	13	20	0.00001
Rhizobium pusense	648995	S	6	21	27	0.00002
Rhizobium gallicum	56730	S	5	1	6	0.00000
Rhizobium tropici	398	S	3	1	4	0.00000
Rhizobium daejeonense	240521	S	3	2	5	0.00000
Rhizobium binae	1138190	S	2	0	2	0.00000
Rhizobium lentis	1138194	S	1	0	1	0.00000
Rhizobium acidisoli	1538158	S	1	0	1	0.00000
Rhizobium rhizoryzae	451876	S	1	0	1	0.00000
Rhizobium oryzihabitans	2267833	S	1	1	2	0.00000
Rhizobium selenitireducens	448181	S	1	12	13	0.00001
Agrobacterium tumefaciens	358	S	36	25	61	0.00004
Agrobacterium fabrum	1176649	S	12	14	26	0.00002
Agrobacterium fabacearum	1183401	S	4	13	17	0.00001
Agrobacterium vitis	373	S	20	2	22	0.00001
Agrobacterium larrymoorei	160699	S	13	1	14	0.00001
Agrobacterium rubi	28099	S	12	2	14	0.00001
Agrobacterium sp. RAC06	1842536	S	2	1	3	0.00000
Agrobacterium sp. T29	2580515	S	1	0	1	0.00000
Agrobacterium sp. MA01	2664893	S	1	0	1	0.00000
Agrobacterium rhizogenes	359	S	3	3	6	0.00000
Neorhizobium sp. SOG26	2060726	S	19	2	21	0.00001
Neorhizobium sp. NCHU2750	1825976	S	4	0	4	0.00000
Neorhizobium galegae	399	S	20	1	21	0.00001
Pseudorhizobium banfieldiae	1125847	S	1	1	2	0.00000
Sinorhizobium fredii	380	S	18	10	28	0.00002
Sinorhizobium meliloti	382	S	17	4	21	0.00001
Sinorhizobium sp. RAC02	1842534	S	10	1	11	0.00001
Sinorhizobium sp. BG8	2613773	S	5	0	5	0.00000
Sinorhizobium sp. CCBAU 05631	794846	S	2	3	5	0.00000
Sinorhizobium americanum	194963	S	8	1	9	0.00001
Sinorhizobium medicae	110321	S	3	0	3	0.00000
Ensifer adhaerens	106592	S	15	5	20	0.00001
Ensifer mexicanus	375549	S	15	1	16	0.00001
Ensifer alkalisoli	1752398	S	3	0	3	0.00000
Ensifer sp. PDNC004	2811423	S	2	0	2	0.00000
Shinella sp. HZN7	879274	S	13	9	22	0.00001
Shinella sp. PSBB067	2715959	S	10	9	19	0.00001
Kaistia sp. 32K	2795690	S	16	2	18	0.00001
Georhizobium profundi	2341112	S	9	2	11	0.00001
Candidatus Liberibacter asiaticus	34021	S	2	0	2	0.00000
Liberibacter crescens	1273132	S	2	0	2	0.00000
Candidatus Liberibacter africanus	34020	S	1	0	1	0.00000
Candidatus Liberibacter solanacearum	556287	S	1	0	1	0.00000
Ciceribacter thiooxidans	1969821	S	7	1	8	0.00000
Mesorhizobium sp. N3	675281	S	18	2	20	0.00001
Mesorhizobium sp. 8	2584466	S	13	1	14	0.00001
Mesorhizobium sp. M3A.F.Ca.ET.080.04.2.1	2493676	S	13	2	15	0.00001
Mesorhizobium sp. NBSH29	2654249	S	12	0	12	0.00001
Mesorhizobium sp. M2A.F.Ca.ET.046.03.2.1	2493674	S	12	21	33	0.00002
Mesorhizobium sp. M1E.F.Ca.ET.045.02.1.1	2493672	S	11	3	14	0.00001
Mesorhizobium sp. DCY119	2108445	S	10	1	11	0.00001
Mesorhizobium sp. INR15	2654248	S	9	0	9	0.00001
Mesorhizobium sp. M1B.F.Ca.ET.045.04.1.1	2493673	S	9	2	11	0.00001
Mesorhizobium sp. J8	2777475	S	6	1	7	0.00000
Mesorhizobium sp. 113-3-9	2744517	S	6	3	9	0.00001
Mesorhizobium sp. M8A.F.Ca.ET.057.01.1.1	2493679	S	6	1	7	0.00000
Mesorhizobium sp. M7D.F.Ca.US.005.01.1.1	2493678	S	6	1	7	0.00000
Mesorhizobium sp. M4B.F.Ca.ET.058.02.1.1	2493675	S	5	1	6	0.00000
Mesorhizobium sp. M1D.F.Ca.ET.043.01.1.1	2493669	S	5	2	7	0.00000
Mesorhizobium sp. M1A.F.Ca.IN.022.06.1.1	2493680	S	5	1	6	0.00000
Mesorhizobium sp. Pch-S	2082387	S	5	0	5	0.00000
Mesorhizobium sp. 113-3-3	2744516	S	5	2	7	0.00000
Mesorhizobium sp. L-2-11	2744521	S	4	1	5	0.00000
Mesorhizobium sp. 113-1-2	2744515	S	4	9	13	0.00001
Mesorhizobium sp. M6A.T.Cr.TU.016.01.1.1	2493677	S	3	0	3	0.00000
Mesorhizobium sp. NZP2077	2483404	S	3	0	3	0.00000
Mesorhizobium sp. 131-3-5	2744520	S	3	9	12	0.00001
Mesorhizobium sp. WSM1497	278153	S	2	4	6	0.00000
Mesorhizobium sp. M2A.F.Ca.ET.043.05.1.1	2493671	S	2	1	3	0.00000
Mesorhizobium sp. L-8-10	2744523	S	2	4	6	0.00000
Mesorhizobium sp. L-8-3	2744522	S	2	4	6	0.00000
Mesorhizobium sp. 131-2-1	2744518	S	2	0	2	0.00000
Mesorhizobium sp. M7A.F.Ce.TU.012.03.2.1	2493681	S	2	0	2	0.00000
Mesorhizobium sp. M2A.F.Ca.ET.043.02.1.1	2493670	S	2	3	5	0.00000
Mesorhizobium sp. AA22	1854057	S	1	0	1	0.00000
Mesorhizobium sp. NZP2298	2483403	S	1	0	1	0.00000
Mesorhizobium sp. M9A.F.Ca.ET.002.03.1.2	2493668	S	1	0	1	0.00000
Mesorhizobium loti	381	S	20	47	67	0.00004
Mesorhizobium erdmanii	1777866	S	12	2	14	0.00001
Mesorhizobium australicum	536018	S	11	2	13	0.00001
Mesorhizobium huakuii	28104	S	7	2	9	0.00001
Mesorhizobium oceanicum	1670800	S	7	1	8	0.00000
Mesorhizobium japonicum	2066070	S	6	3	9	0.00001
Mesorhizobium amorphae	71433	S	5	0	5	0.00000
Mesorhizobium opportunistum	593909	S	5	1	6	0.00000
Mesorhizobium ciceri	39645	S	3	2	5	0.00000
Aminobacter sp. MSH1	374606	S	16	7	23	0.00001
Aminobacter sp. SR38	2774562	S	4	16	20	0.00001
Aminobacter sp. MDW-2	2666139	S	1	7	8	0.00000
Aminobacter aminovorans	83263	S	2	7	9	0.00001
Phyllobacterium sp. 628	2718938	S	14	1	15	0.00001
Phyllobacterium zundukense	1867719	S	9	0	9	0.00001
Nitratireductor sp. SY7	2599600	S	14	1	15	0.00001
Nitratireductor sp. OM-1	1756988	S	9	0	9	0.00001
Roseitalea porphyridii	1852022	S	18	2	20	0.00001
Hoeflea phototrophica	244596	S	8	0	8	0.00000
Hoeflea sp. IMCC20628	1620421	S	7	0	7	0.00000
Oricola thermophila	2742145	S	13	1	14	0.00001
Chelativorans sp. BNC1	266779	S	10	1	11	0.00001
Salaquimonas pukyongi	2712698	S	9	0	9	0.00001
Lentilitoribacter sp. Alg239-R112	2305987	S	2	0	2	0.00000
Devosia sp. A16	1736675	S	34	2	36	0.00002
Devosia sp. I507	2083786	S	20	3	23	0.00001
Devosia sp. S02	2657486	S	15	2	17	0.00001
Devosia sp. LEGU1	2774137	S	13	1	14	0.00001
Devosia sp. G19	2801335	S	11	1	12	0.00001
Devosia sp. MC521	2759954	S	8	2	10	0.00001
Devosia sp. 1566	2499144	S	5	0	5	0.00000
Devosia sp. D6-9	2664417	S	5	11	16	0.00001
Devosia ginsengisoli	400770	S	27	3	30	0.00002
Rhodoplanes sp. Z2-YC6860	674703	S	52	3	55	0.00003
Hyphomicrobium denitrificans	53399	S	19	1	20	0.00001
Hyphomicrobium nitrativorans	1427356	S	16	0	16	0.00001
Hyphomicrobium sp. MC1	717785	S	14	0	14	0.00001
Blastochloris tepida	2233851	S	14	3	17	0.00001
Blastochloris viridis	1079	S	11	1	12	0.00001
Aquabacter sp. L1I39	2820278	S	19	1	20	0.00001
Caenibius tardaugens	169176	S	16	21	37	0.00002
Rhodomicrobium vannielii	1069	S	11	0	11	0.00001
Pelagibacterium halotolerans	531813	S	11	0	11	0.00001
Methyloceanibacter sp. wino2	2170729	S	6	0	6	0.00000
Methyloceanibacter caenitepidi	1384459	S	3	0	3	0.00000
Youhaiella tibetensis	1447062	S	7	0	7	0.00000
Candidatus Filomicrobium marinum	1608628	S	6	0	6	0.00000
Methyloligella sp. GL2	2742204	S	5	0	5	0.00000
Paradevosia shaoguanensis	1335043	S	4	9	13	0.00001
Maritalea myrionectae	454601	S	2	0	2	0.00000
Pseudolabrys taiwanensis	331696	S	25	2	27	0.00002
Pseudolabrys sp. FHR47	2562284	S	24	2	26	0.00002
Starkeya sp. ORNL1	2709380	S	20	2	22	0.00001
Starkeya novella	921	S	15	3	18	0.00001
Xanthobacter sp. YN2	2528964	S	22	4	26	0.00002
Ancylobacter sp. TS-1	1850374	S	12	3	15	0.00001
Ancylobacter pratisalsi	1745854	S	9	1	10	0.00001
Labrys sp. KNU-23	2789216	S	19	1	20	0.00001
Azorhizobium caulinodans	7	S	12	1	13	0.00001
Pyruvatibacter mobilis	1712261	S	85	7	92	0.00006
Parvibaculum lavamentivorans	256618	S	22	9	31	0.00002
Candidatus Phaeomarinobacter ectocarpi	1458461	S	7	0	7	0.00000
Aureimonas sp. OT7	2816454	S	37	35	72	0.00004
Aureimonas sp. AU20	1349819	S	14	1	15	0.00001
Aureimonas sp. LMG 31693	2758041	S	10	1	11	0.00001
Aureimonas populi	1701758	S	17	2	19	0.00001
Martelella endophytica	1486262	S	11	1	12	0.00001
Martelella sp. AD-3	686597	S	2	11	13	0.00001
Martelella mediterranea	293089	S	2	1	3	0.00000
Martelella lutilitoris	2583532	S	1	1	2	0.00000
Methylocystis rosea	173366	S	17	3	20	0.00001
Methylocystis parvus	134	S	13	0	13	0.00001
Methylocystis heyeri	391905	S	11	0	11	0.00001
Methylocystis bryophila	655015	S	9	0	9	0.00001
Methylocystis sp. SC2	187303	S	9	3	12	0.00001
Methylosinus sp. C49	2699395	S	20	2	22	0.00001
Methylosinus trichosporium	426	S	7	0	7	0.00000
Labrenzia sp. VG12	2021862	S	9	0	9	0.00001
Labrenzia sp. PHM005	2590016	S	7	0	7	0.00000
Labrenzia sp. CP4	1674922	S	1	2	3	0.00000
Labrenzia sp. THAF35	2587854	S	1	2	3	0.00000
Labrenzia sp. THAF82	2587861	S	1	0	1	0.00000
Labrenzia alexandrii	388408	S	2	0	2	0.00000
Labrenzia aggregata	187304	S	1	1	2	0.00000
Stappia indica	538381	S	13	1	14	0.00001
Stappia sp. ES.058	1881061	S	7	0	7	0.00000
Pannonibacter phragmitetus	121719	S	19	17	36	0.00002
Pseudovibrio sp. FO-BEG1	911045	S	3	0	3	0.00000
Pseudorhodoplanes sinuspersici	1235591	S	23	0	23	0.00001
Nordella sp. HKS 07	2712222	S	19	0	19	0.00001
Hartmannibacter diazotrophicus	1482074	S	11	1	12	0.00001
Candidatus Hodgkinia cicadicola	573658	S	6	0	6	0.00000
Brucella anthropi	529	S	6	17	23	0.00001
Brucella sp. 09RB8910	1844051	S	3	1	4	0.00000
Brucella sp. 09RB8471	1149952	S	2	1	3	0.00000
Brucella sp. 10RB9215	1149953	S	1	0	1	0.00000
Brucella pituitosa	571256	S	5	1	6	0.00000
[Ochrobactrum] quorumnocens	271865	S	4	0	4	0.00000
Brucella melitensis	29459	S	3	12	15	0.00001
Ochrobactrum sp. MT180101	2726427	S	3	8	11	0.00001
Methylocella tundrae	227605	S	8	0	8	0.00000
Methylocella silvestris	199596	S	7	0	7	0.00000
Methylovirgula ligni	569860	S	11	0	11	0.00001
Beijerinckia indica	533	S	5	0	5	0.00000
Bartonella sp. WD16.2	1933904	S	1	2	3	0.00000
Bartonella sp. HY038	2759660	S	1	0	1	0.00000
Bartonella elizabethae	807	S	2	5	7	0.00000
Bartonella ancashensis	1318743	S	2	0	2	0.00000
Bartonella tribocorum	85701	S	2	3	5	0.00000
Bartonella birtlesii	111504	S	1	0	1	0.00000
Bartonella bovis	155194	S	1	0	1	0.00000
Bartonella clarridgeiae	56426	S	1	0	1	0.00000
Bartonella alsatica	52764	S	1	0	1	0.00000
Bartonella vinsonii	33047	S	1	0	1	0.00000
Bartonella quintana	803	S	1	0	1	0.00000
Breoghania sp. L-A4	2304600	S	19	1	20	0.00001
Cohaesibacter sp. ES.047	1798205	S	5	0	5	0.00000
Chelatococcus sp. CO-6	1702325	S	9	2	11	0.00001
Chelatococcus daeguensis	444444	S	7	1	8	0.00000
Lichenihabitans psoromatis	2528642	S	15	0	15	0.00001
Sphingomonas sp. PAMC26645	2565555	S	174	28	202	0.00012
Sphingomonas sp. HMP9	1517554	S	92	21	113	0.00007
Sphingomonas sp. AAP5	1523415	S	51	8	59	0.00004
Sphingomonas sp. FARSPH	2219696	S	39	21	60	0.00004
Sphingomonas sp. CL5.1	2653203	S	38	7	45	0.00003
Sphingomonas sp. C33	2698679	S	32	2	34	0.00002
Sphingomonas sp. MM-1	745310	S	31	36	67	0.00004
Sphingomonas sp. NBWT7	2596913	S	29	5	34	0.00002
Sphingomonas sp. AP4-R1	2735134	S	26	1	27	0.00002
Sphingomonas sp. LMO-1	2681549	S	25	1	26	0.00002
Sphingomonas sp. HMP6	1517551	S	25	2	27	0.00002
Sphingomonas sp. DH-S5	2759526	S	24	1	25	0.00002
Sphingomonas sp. Cra20	1327635	S	23	1	24	0.00001
Sphingomonas sp. MK52	2711156	S	19	0	19	0.00001
Sphingomonas sp. NIC1	1961362	S	19	22	41	0.00003
Sphingomonas sp. LK11	1390395	S	19	3	22	0.00001
Sphingomonas sp. XS-10	2599297	S	18	0	18	0.00001
Sphingomonas sp. KC8	1030157	S	18	6	24	0.00001
Sphingomonas sp. C8-2	2492837	S	14	11	25	0.00002
Sphingomonas sp. LM7	1938607	S	13	1	14	0.00001
Sphingomonas sp. HDW15A	2714942	S	12	0	12	0.00001
Sphingomonas sp. HDW15B	2714943	S	12	0	12	0.00001
Sphingomonas sp. YZ-8	2319844	S	9	0	9	0.00001
Sphingomonas sp. sand1-3	2764186	S	8	0	8	0.00000
Sphingomonas sp. HDW15C	2714944	S	6	0	6	0.00000
Sphingomonas sp. IC081	304378	S	5	16	21	0.00001
Sphingomonas sp. ERG5	1381597	S	4	3	7	0.00000
Sphingomonas sp.	28214	S	2	0	2	0.00000
Sphingomonas koreensis	93064	S	71	43	114	0.00007
Sphingomonas melonis	152682	S	71	118	189	0.00012
Sphingomonas sanxanigenens	397260	S	48	20	68	0.00004
Sphingomonas taxi	1549858	S	44	3	47	0.00003
Sphingomonas alpina	653931	S	39	0	39	0.00002
Sphingomonas paucimobilis	13689	S	38	11	49	0.00003
Sphingomonas panacis	1560345	S	38	1	39	0.00002
Sphingomonas hengshuiensis	1609977	S	30	0	30	0.00002
Sphingomonas panacisoli	1813879	S	21	0	21	0.00001
Sphingomonas wittichii	160791	S	20	10	30	0.00002
Sphingomonas sediminicola	386874	S	12	0	12	0.00001
Sphingomonas ginsengisoli An et al. 2013	363835	S	12	0	12	0.00001
Sphingomonas insulae	424800	S	12	0	12	0.00001
Sphingomonas xanthus	2594473	S	11	0	11	0.00001
Sphingomonas lutea	1045317	S	7	0	7	0.00000
Sphingomonas lacunae	2698828	S	6	0	6	0.00000
Sphingomonas rhizophila	2071607	S	5	0	5	0.00000
Sphingomonas daechungensis	1176646	S	4	0	4	0.00000
Sphingobium sp. YG1	2082188	S	76	27	103	0.00006
Sphingobium sp. KCTC 72723	2733867	S	49	2	51	0.00003
Sphingobium sp. TKS	1315974	S	20	25	45	0.00003
Sphingobium sp. SYK-6	627192	S	19	5	24	0.00001
Sphingobium sp. RAC03	1843368	S	17	2	19	0.00001
Sphingobium sp. CAP-1	2676077	S	15	11	26	0.00002
Sphingobium sp. Cam5-1	2789327	S	14	4	18	0.00001
Sphingobium sp. MI1205	407020	S	12	18	30	0.00002
Sphingobium sp. SCG-1	2072936	S	11	0	11	0.00001
Sphingobium sp. EP60837	1855519	S	9	1	10	0.00001
Sphingobium sp. PAMC28499	2565554	S	8	9	17	0.00001
Sphingobium sp. RSMS	520734	S	5	23	28	0.00002
Sphingobium sp. YBL2	484429	S	3	14	17	0.00001
Sphingobium yanoikuyae	13690	S	42	52	94	0.00006
Sphingobium hydrophobicum	1673076	S	38	33	71	0.00004
Sphingobium cloacae	120107	S	14	24	38	0.00002
Sphingobium japonicum	332056	S	14	6	20	0.00001
Sphingobium baderi	1332080	S	14	20	34	0.00002
Sphingobium chlorophenolicum	46429	S	11	5	16	0.00001
Sphingobium herbicidovorans	76947	S	9	5	14	0.00001
Sphingobium amiense	135719	S	7	11	18	0.00001
Sphingobium barthaii	1054037	S	4	8	12	0.00001
Sphingobium fuliginis	336203	S	1	2	3	0.00000
Sphingopyxis sp. PAMC25046	2565556	S	35	9	44	0.00003
Sphingopyxis sp. EG6	1874061	S	33	9	42	0.00003
Sphingopyxis sp. FD7	1914525	S	29	7	36	0.00002
Sphingopyxis sp. OPL5	2486273	S	26	2	28	0.00002
Sphingopyxis sp. 113P3	292913	S	23	8	31	0.00002
Sphingopyxis sp. QXT-31	1357916	S	16	2	18	0.00001
Sphingopyxis sp. MG	1866325	S	7	31	38	0.00002
Sphingopyxis sp. LPB0140	1913578	S	4	0	4	0.00000
Sphingopyxis terrae	33052	S	105	26	131	0.00008
Sphingopyxis macrogoltabida	33050	S	40	13	53	0.00003
Sphingopyxis fribergensis	1515612	S	28	6	34	0.00002
Sphingopyxis lindanitolerans	2054227	S	23	5	28	0.00002
Sphingopyxis alaskensis	117207	S	22	2	24	0.00001
Sphingopyxis granuli	267128	S	9	31	40	0.00002
Novosphingobium sp. P6W	1609758	S	79	4	83	0.00005
Novosphingobium sp. ABRDHK2	2571749	S	39	15	54	0.00003
Novosphingobium sp. ES2-1	2780074	S	39	22	61	0.00004
Novosphingobium sp. THN1	1016987	S	26	10	36	0.00002
Novosphingobium sp. Gsoil 351	2675225	S	23	0	23	0.00001
Novosphingobium sp. PP1Y	702113	S	19	10	29	0.00002
Novosphingobium sp. KA1	164608	S	10	28	38	0.00002
Novosphingobium aromaticivorans	48935	S	39	12	51	0.00003
Novosphingobium ginsenosidimutans	1176536	S	33	1	34	0.00002
Novosphingobium resinovorum	158500	S	27	13	40	0.00002
Novosphingobium pentaromativorans	205844	S	16	20	36	0.00002
Sphingorhabdus lacus	392610	S	187	3	190	0.00012
Sphingorhabdus sp. SMR4y	2584094	S	15	0	15	0.00001
Sphingorhabdus sp. YGSMI21	2077182	S	14	0	14	0.00001
Sphingorhabdus sp. M41	1806885	S	5	0	5	0.00000
Sphingorhabdus sp. JK6	2725558	S	5	0	5	0.00000
Blastomonas sp. RAC04	1842535	S	21	11	32	0.00002
Blastomonas fulva	1550728	S	11	11	22	0.00001
Sphingosinithalassobacter sp. CS137	2762748	S	24	2	26	0.00002
Sphingosinithalassobacter sp. zrk23	2711215	S	15	3	18	0.00001
Rhizorhabdus dicambivorans	1850238	S	38	40	78	0.00005
Citromicrobium sp. JL477	1634516	S	10	3	13	0.00001
Parasphingopyxis sp. CP4	2724527	S	6	0	6	0.00000
Parasphingopyxis algicola	2026624	S	4	0	4	0.00000
Novosphingopyxis sp. PB63	2762729	S	10	3	13	0.00001
Allosphingosinicella indica	941907	S	9	0	9	0.00001
Zymomonas mobilis	542	S	8	1	9	0.00001
Parasphingorhabdus sp. JHSY0214	2806553	S	8	0	8	0.00000
Tardibacter chloracetimidivorans	1921510	S	7	6	13	0.00001
Porphyrobacter sp. LM 6	1896196	S	40	12	52	0.00003
Porphyrobacter sp. YT40	2547601	S	35	31	66	0.00004
Porphyrobacter sp. HT-58-2	2023229	S	33	6	39	0.00002
Porphyrobacter sp. CACIAM 03H1	2003315	S	27	5	32	0.00002
Erythrobacter sp. A30-3	2785907	S	12	11	23	0.00001
Erythrobacter sp. 6D36	2782568	S	11	1	12	0.00001
Erythrobacter sp. HL-111	1798193	S	7	0	7	0.00000
Erythrobacter sp. KY5	2011159	S	6	0	6	0.00000
Erythrobacter sp. THAF29	2587851	S	6	1	7	0.00000
Erythrobacter sp. HKB08	2502843	S	3	0	3	0.00000
Erythrobacter neustonensis	1112	S	34	5	39	0.00002
Erythrobacter litoralis	39960	S	18	7	25	0.00002
Erythrobacter mangrovi	2739433	S	13	5	18	0.00001
Erythrobacter aureus	2182384	S	5	0	5	0.00000
Altererythrobacter sp. BO-6	2604537	S	18	1	19	0.00001
Altererythrobacter sp. B11	2060312	S	16	4	20	0.00001
Altererythrobacter sp. TH136	2067415	S	16	1	17	0.00001
Altererythrobacter sp. ZODW24	2185142	S	7	0	7	0.00000
Altererythrobacter atlanticus	1267766	S	16	7	23	0.00001
Altererythrobacter ishigakiensis	476157	S	11	0	11	0.00001
Altererythrobacter epoxidivorans	361183	S	2	0	2	0.00000
Tsuneonella amylolytica	2338327	S	31	4	35	0.00002
Tsuneonella dongtanensis	692370	S	20	1	21	0.00001
Tsuneonella flava	2055955	S	9	3	12	0.00001
Tsuneonella mangrovi	1982042	S	8	0	8	0.00000
Croceicoccus marinus	450378	S	23	14	37	0.00002
Croceicoccus sp. YJ47	2798724	S	13	3	16	0.00001
Croceicoccus naphthovorans	1348774	S	9	14	23	0.00001
Qipengyuania flava	192812	S	23	15	38	0.00002
Qipengyuania sediminis	1532023	S	9	0	9	0.00001
Qipengyuania seohaensis	266951	S	3	0	3	0.00000
Aurantiacibacter atlanticus	1648404	S	12	9	21	0.00001
Aurantiacibacter gangjinensis	502682	S	4	0	4	0.00000
Pelagerythrobacter marensis	543877	S	16	0	16	0.00001
Paraurantiacibacter namhicola	645517	S	15	0	15	0.00001
Sphingosinicella sp. UDD2	2771430	S	7	0	7	0.00000
Sphingosinicella sp. BN140058	1892855	S	6	0	6	0.00000
Sphingosinicella microcystinivorans	335406	S	11	0	11	0.00001
Sandaracinobacter sp. M6	2759707	S	5	0	5	0.00000
Paracoccus yeei	147645	S	95	94	189	0.00012
Paracoccus sp. Arc7-R13	2500532	S	28	3	31	0.00002
Paracoccus sp. AK26	2589076	S	16	1	17	0.00001
Paracoccus sp. BM15	1529068	S	13	0	13	0.00001
Paracoccus sp. MC1862	2760307	S	13	0	13	0.00001
Paracoccus sp. H4-D09	2812658	S	8	1	9	0.00001
Paracoccus sanguinis	1545044	S	72	9	81	0.00005
Paracoccus contaminans	1945662	S	24	2	26	0.00002
Paracoccus aminovorans	34004	S	18	2	20	0.00001
Paracoccus kondratievae	135740	S	15	2	17	0.00001
Paracoccus zhejiangensis	1077935	S	14	2	16	0.00001
Paracoccus liaowanqingii	2560053	S	13	0	13	0.00001
Paracoccus pantotrophus	82367	S	11	2	13	0.00001
Paracoccus jeotgali	2065379	S	9	0	9	0.00001
Paracoccus suum	2259340	S	8	1	9	0.00001
Paracoccus denitrificans	266	S	5	1	6	0.00000
Paracoccus aminophilus	34003	S	4	0	4	0.00000
Paracoccus marcusii	59779	S	1	0	1	0.00000
Rhodobacter sp. CZR27	2033869	S	23	3	26	0.00002
Rhodobacter sp. LPB0142	1850250	S	10	5	15	0.00001
Rhodobacter blasticus	1075	S	25	2	27	0.00002
Rhodobacter capsulatus	1061	S	24	3	27	0.00002
Tabrizicola piscis	2494374	S	80	4	84	0.00005
Sulfitobacter sp. D7	1968541	S	10	4	14	0.00001
Sulfitobacter sp. THAF37	2587855	S	10	6	16	0.00001
Sulfitobacter sp. SK012	1389005	S	9	0	9	0.00001
Sulfitobacter sp. AM1-D1	1917485	S	9	8	17	0.00001
Sulfitobacter sp. JL08	2070369	S	7	0	7	0.00000
Sulfitobacter sp. B30-2	2785912	S	3	7	10	0.00001
Sulfitobacter sp. SK011	1389004	S	1	0	1	0.00000
Sulfitobacter sp. SK025	1389011	S	1	2	3	0.00000
Sulfitobacter pseudonitzschiae	1402135	S	9	3	12	0.00001
Sulfitobacter mediterraneus	83219	S	5	0	5	0.00000
Gemmobacter sp. HYN0069	2169400	S	54	5	59	0.00004
Roseovarius indicus	540747	S	20	10	30	0.00002
Roseovarius sp. THAF9	2587847	S	6	2	8	0.00000
Roseovarius sp. THAF8	2587846	S	2	2	4	0.00000
Roseovarius sp. TM1035	391613	S	1	0	1	0.00000
Roseovarius sp. THAF27	2587850	S	1	1	2	0.00000
Roseovarius faecimaris	2494550	S	11	0	11	0.00001
Roseovarius mucosus	215743	S	4	2	6	0.00000
Phaeobacter gallaeciensis	60890	S	17	10	27	0.00002
Phaeobacter inhibens	221822	S	16	7	23	0.00001
Phaeobacter porticola	1844006	S	3	0	3	0.00000
Phaeobacter piscinae	1580596	S	2	1	3	0.00000
Haematobacter massiliensis	195105	S	37	21	58	0.00004
Celeribacter manganoxidans	1411902	S	9	2	11	0.00001
Celeribacter indicus	1208324	S	8	5	13	0.00001
Celeribacter marinus	1397108	S	5	0	5	0.00000
Celeribacter ethanolicus	1758178	S	5	2	7	0.00000
Celeribacter baekdonensis	875171	S	4	1	5	0.00000
Defluviimonas alba	1335048	S	26	8	34	0.00002
Cereibacter sphaeroides	1063	S	23	1	24	0.00001
Yangia sp. CCB-MM3	1792508	S	10	0	10	0.00001
Salipiger profundus	1229727	S	7	3	10	0.00001
Salipiger pacificus	311180	S	6	0	6	0.00000
Rhodovulum sulfidophilum	35806	S	10	1	11	0.00001
Rhodovulum sp. MB263	308754	S	6	0	6	0.00000
Rhodovulum sp. P5	1564506	S	4	0	4	0.00000
Roseivivax sp. THAF30	2587852	S	10	11	21	0.00001
Ruegeria pomeroyi	89184	S	10	3	13	0.00001
Ruegeria sp. TM1040	292414	S	2	0	2	0.00000
Ruegeria sp. AD91A	2293862	S	2	1	3	0.00000
Ruegeria sp. THAF33	2587853	S	1	0	1	0.00000
Leisingera methylohalidivorans	133924	S	9	1	10	0.00001
Leisingera sp. NJS201	2508306	S	3	4	7	0.00000
Leisingera aquaemixtae	1396826	S	4	0	4	0.00000
Thioclava electrotropha	1549850	S	8	2	10	0.00001
Thioclava nitratireducens	1915078	S	4	1	5	0.00000
Rhodobaca barguzinensis	441209	S	15	0	15	0.00001
Sagittula sp. P11	2009329	S	15	11	26	0.00002
Pontivivens sp. MT2928	2789856	S	14	0	14	0.00001
Octadecabacter sp. SW4	2602067	S	7	1	8	0.00000
Octadecabacter arcticus	53946	S	4	0	4	0.00000
Octadecabacter temperatus	1458307	S	3	0	3	0.00000
Yoonia vestfoldensis	245188	S	13	4	17	0.00001
Pelagibaca abyssi	1250539	S	13	6	19	0.00001
Profundibacter amoris	2171755	S	12	0	12	0.00001
Pseudopuniceibacterium antarcticum	2613965	S	12	0	12	0.00001
Roseobacter denitrificans	2434	S	5	0	5	0.00000
Roseobacter ponti	1891787	S	4	0	4	0.00000
Roseobacter litoralis	42443	S	3	0	3	0.00000
Pseudorhodobacter turbinis	2500533	S	11	0	11	0.00001
Brevirhabdus pacifica	1267768	S	10	6	16	0.00001
Confluentimicrobium sp. EMB200-NS6	1609966	S	9	7	16	0.00001
Maribius sp. THAF1	2587842	S	9	0	9	0.00001
Planktomarina temperata	1284658	S	8	0	8	0.00000
Dinoroseobacter shibae	215813	S	8	5	13	0.00001
Epibacterium mobile	379347	S	8	2	10	0.00001
Roseibacterium elongatum	159346	S	8	0	8	0.00000
Oceanicola sp. D3	2587163	S	8	0	8	0.00000
Ketogulonicigenium vulgare	92945	S	4	1	5	0.00000
Ketogulonicigenium robustum	92947	S	1	0	1	0.00000
Thalassococcus sp. S3	2017482	S	6	0	6	0.00000
Marinovum algicola	42444	S	6	2	8	0.00000
Roseicitreum antarcticum	564137	S	6	0	6	0.00000
Qingshengfaniella alkalisoli	2599296	S	6	0	6	0.00000
Pelagovum pacificum	2588711	S	6	0	6	0.00000
Parasedimentitalea marina	2483033	S	6	0	6	0.00000
Pseudooceanicola algae	1537215	S	6	0	6	0.00000
Cognatishimia activa	1715691	S	6	0	6	0.00000
Monaibacterium sp. ALG8	2715211	S	6	1	7	0.00000
Polymorphum gilvum	991904	S	5	0	5	0.00000
Halocynthiibacter arcticus	1579316	S	5	0	5	0.00000
Thalassobius gelatinovorus	53501	S	5	0	5	0.00000
Paraoceanicella profunda	2579971	S	4	0	4	0.00000
Mameliella alba	561184	S	4	0	4	0.00000
Jannaschia sp. CCS1	290400	S	3	0	3	0.00000
Pseudohalocynthiibacter aestuariivivens	1591409	S	3	0	3	0.00000
Silicimonas algicola	1826607	S	2	0	2	0.00000
Marivivens sp. JLT3646	1920883	S	2	0	2	0.00000
Boseongicola sp. CCM32	2552942	S	2	0	2	0.00000
Antarctobacter heliothermus	74033	S	2	0	2	0.00000
Tateyamaria omphalii	299262	S	1	0	1	0.00000
Brevundimonas sp. CS1	2813778	S	51	31	82	0.00005
Brevundimonas sp. GW460-12-10-14-LB2	1827469	S	46	48	94	0.00006
Brevundimonas sp. SGAir0440	2579977	S	45	19	64	0.00004
Brevundimonas sp. M20	2591463	S	43	3	46	0.00003
Brevundimonas sp. LVF2	2774190	S	38	2	40	0.00002
Brevundimonas sp. AJA228-03	2752515	S	35	2	37	0.00002
Brevundimonas sp. GRTSA-9	2800818	S	35	2	37	0.00002
Brevundimonas sp. LM2	1938605	S	29	2	31	0.00002
Brevundimonas sp. 'scallop'	2562582	S	27	33	60	0.00004
Brevundimonas sp. MF30-B	2561924	S	24	1	25	0.00002
Brevundimonas sp. LVF1	2774189	S	24	5	29	0.00002
Brevundimonas sp. Bb-A	2560058	S	18	35	53	0.00003
Brevundimonas sp. DS20	1532555	S	14	28	42	0.00003
Brevundimonas mediterranea	74329	S	62	14	76	0.00005
Brevundimonas naejangsanensis	588932	S	40	7	47	0.00003
Brevundimonas vesicularis	41276	S	22	42	64	0.00004
Brevundimonas subvibrioides	74313	S	21	1	22	0.00001
Brevundimonas diminuta	293	S	15	28	43	0.00003
Brevundimonas vancanneytii	1325724	S	12	39	51	0.00003
Caulobacter vibrioides	155892	S	68	23	91	0.00006
Caulobacter sp. K31	366602	S	48	11	59	0.00004
Caulobacter sp. FWC26	69665	S	17	8	25	0.00002
Caulobacter soli	2708539	S	50	15	65	0.00004
Caulobacter segnis	88688	S	48	14	62	0.00004
Caulobacter rhizosphaerae	2010972	S	42	11	53	0.00003
Caulobacter henricii	69395	S	36	5	41	0.00003
Caulobacter flavus	1679497	S	36	7	43	0.00003
Caulobacter mirabilis	69666	S	28	3	31	0.00002
Phenylobacterium zucineum	284016	S	47	7	54	0.00003
Phenylobacterium parvum	2201350	S	16	1	17	0.00001
Asticcacaulis excentricus	78587	S	20	0	20	0.00001
Terricaulis silvestris	2686094	S	15	0	15	0.00001
Azospirillum brasilense	192	S	33	32	65	0.00004
Azospirillum sp. TSA2s	709810	S	5	4	9	0.00001
Azospirillum sp. TSH100	652764	S	4	1	5	0.00000
Azospirillum sp. TSH58	664962	S	4	5	9	0.00001
Azospirillum lipoferum	193	S	7	4	11	0.00001
Azospirillum thiophilum	528244	S	7	2	9	0.00001
Azospirillum thermophilum	2202148	S	7	1	8	0.00000
Azospirillum ramasamyi	682998	S	5	3	8	0.00000
Azospirillum humicireducens	1226968	S	5	2	7	0.00000
Azospirillum oryzae	286727	S	4	4	8	0.00000
Azospirillum baldaniorum	1064539	S	4	8	12	0.00001
Magnetospirillum sp. ME-1	1639348	S	16	5	21	0.00001
Magnetospirillum sp. XM-1	1663591	S	12	4	16	0.00001
Magnetospirillum magneticum	84159	S	16	3	19	0.00001
Magnetospirillum gryphiswaldense	55518	S	15	1	16	0.00001
Hypericibacter terrae	2602015	S	25	3	28	0.00002
Hypericibacter adhaerens	2602016	S	15	3	18	0.00001
Skermanella sp. TT6	2775420	S	13	13	26	0.00002
Skermanella pratensis	2233999	S	12	5	17	0.00001
Rhodospirillum rubrum	1085	S	16	-16	0	0.00000
Rhodospirillum centenum	34018	S	4	1	5	0.00000
Thalassospira marina	2048283	S	6	0	6	0.00000
Thalassospira xiamenensis	220697	S	4	2	6	0.00000
Thalassospira sp. A40-3	2785908	S	2	0	2	0.00000
Thalassospira sp. B30-1	2785911	S	1	0	1	0.00000
Thalassospira indica	1891279	S	1	0	1	0.00000
Tistrella mobilis	171437	S	15	3	18	0.00001
Pararhodospirillum photometricum	1084	S	15	2	17	0.00001
Nitrospirillum amazonense	28077	S	14	2	16	0.00001
Magnetospira sp. QH-2	1288970	S	12	0	12	0.00001
Indioceanicola profundi	2220096	S	11	2	13	0.00001
Defluviicoccus vanus	111831	S	10	1	11	0.00001
Ferrovibrio terrae	2594003	S	10	0	10	0.00001
Niveispirillum cyanobacteriorum	1612173	S	7	1	8	0.00000
Haematospirillum jordaniae	1549855	S	5	0	5	0.00000
Candidatus Endolissoclinum faulkneri	1263979	S	1	0	1	0.00000
Roseomonas sp. 546	2768162	S	13	0	13	0.00001
Roseomonas sp. 1318	2768161	S	10	0	10	0.00001
Roseomonas sp. FDAARGOS_362	2018065	S	7	17	24	0.00001
Roseomonas gilardii	257708	S	28	4	32	0.00002
Roseomonas mucosa	207340	S	22	72	94	0.00006
Stella humosa	94	S	51	3	54	0.00003
Komagataeibacter xylinus	28448	S	18	18	36	0.00002
Komagataeibacter hansenii	436	S	9	1	10	0.00001
Komagataeibacter oboediens	65958	S	7	0	7	0.00000
Komagataeibacter medellinensis	1177712	S	2	1	3	0.00000
Komagataeibacter europaeus	33995	S	1	0	1	0.00000
Komagataeibacter saccharivorans	265959	S	1	0	1	0.00000
Acetobacter persici	1076596	S	7	0	7	0.00000
Acetobacter aceti	435	S	5	1	6	0.00000
Acetobacter sp. KACC 21233	2592655	S	5	0	5	0.00000
Acetobacter ascendens	481146	S	3	2	5	0.00000
Acetobacter ghanensis	431306	S	2	0	2	0.00000
Acetobacter senegalensis	446692	S	2	1	3	0.00000
Acetobacter orientalis	146474	S	1	0	1	0.00000
Acetobacter oryzoeni	2500548	S	1	1	2	0.00000
Roseococcus sp. NIBR12	2771361	S	27	0	27	0.00002
Acidibrevibacterium fodinaquatile	1969806	S	20	1	21	0.00001
Lichenicola cladoniae	1484109	S	15	0	15	0.00001
Granulibacter bethesdensis	364410	S	14	0	14	0.00001
Acidiphilium cryptum	524	S	1	13	14	0.00001
Gluconobacter oxydans	442	S	6	2	8	0.00000
Gluconobacter sphaericus	574987	S	1	0	1	0.00000
Gluconacetobacter diazotrophicus	33996	S	8	0	8	0.00000
Kozakia baliensis	153496	S	7	1	8	0.00000
Oecophyllibacter saccharovorans	2558360	S	4	0	4	0.00000
Entomobacter blattae	2762277	S	4	0	4	0.00000
Neoasaia chiangmaiensis	320497	S	1	0	1	0.00000
Commensalibacter sp. AMU001	2478912	S	1	0	1	0.00000
Neokomagataea tanensis	661191	S	1	0	1	0.00000
Swingsia sp. F3b2	2558361	S	1	0	1	0.00000
Terasakiella sp. SH-1	2560057	S	4	0	4	0.00000
Wolbachia endosymbiont of Cimex lectularius	246273	S	2	0	2	0.00000
Wolbachia endosymbiont of Folsomia candida	169402	S	2	0	2	0.00000
Wolbachia endosymbiont of Ctenocephalides felis wCfeJ	2732594	S	1	0	1	0.00000
Wolbachia endosymbiont of Ctenocephalides felis wCfeT	2732593	S	1	0	1	0.00000
Wolbachia endosymbiont of Litomosoides sigmodontis	80850	S	1	0	1	0.00000
Wolbachia endosymbiont of Onchocerca ochengi	100901	S	1	0	1	0.00000
Wolbachia endosymbiont of Drosophila mauritiana	109663	S	1	9	10	0.00001
Wolbachia endosymbiont of Bemisia tabaci	215173	S	1	0	1	0.00000
Wolbachia pipientis	955	S	1	2	3	0.00000
Ehrlichia ruminantium	779	S	10	3	13	0.00001
Ehrlichia canis	944	S	3	1	4	0.00000
Ehrlichia chaffeensis	945	S	2	-2	0	0.00000
Ehrlichia sp. HF	391036	S	1	0	1	0.00000
Anaplasma marginale	770	S	3	0	3	0.00000
Anaplasma platys	949	S	3	0	3	0.00000
Anaplasma phagocytophilum	948	S	2	-2	0	0.00000
Neorickettsia risticii	950	S	1	0	1	0.00000
Neorickettsia findlayensis	2686014	S	1	0	1	0.00000
Rickettsia raoultii	369822	S	5	6	11	0.00001
Rickettsia rhipicephali	33992	S	2	4	6	0.00000
Rickettsia parkeri	35792	S	1	4	5	0.00000
Rickettsia endosymbiont of Ixodes scapularis	444612	S	1	0	1	0.00000
Rickettsia asiatica	238800	S	1	1	2	0.00000
Rickettsia amblyommatis	33989	S	1	0	1	0.00000
Rickettsia typhi	785	S	2	0	2	0.00000
Rickettsia bellii	33990	S	2	1	3	0.00000
Rickettsia endosymbiont of Bemisia tabaci	337479	S	1	0	1	0.00000
Orientia tsutsugamushi	784	S	5	0	5	0.00000
Candidatus Sneabacter namystus	2601646	S	1	0	1	0.00000
Candidatus Fokinia solitaria	1802984	S	4	0	4	0.00000
Candidatus Midichloria mitochondrii	234827	S	3	0	3	0.00000
Rickettsiales endosymbiont of Stachyamoeba lipophora	2486578	S	7	1	8	0.00000
Candidatus Deianiraea vastatrix	2163644	S	4	0	4	0.00000
Phreatobacter cathodiphilus	1868589	S	20	3	23	0.00001
Phreatobacter stygius	1940610	S	15	1	16	0.00001
Phreatobacter sp. NMCR1094	2570229	S	15	2	17	0.00001
Micavibrio aeruginosavorus	349221	S	22	1	23	0.00001
Candidatus Puniceispirillum marinum	767892	S	1	0	1	0.00000
Hyphomonas sp. CACIAM 19H1	1873716	S	13	0	13	0.00001
Hyphomonas sp. Mor2	1906738	S	11	0	11	0.00001
Hyphomonas sp. KY3	2016196	S	3	0	3	0.00000
Hirschia baltica	2724	S	6	0	6	0.00000
Candidatus Pelagibacter sp. RS40	1977865	S	5	0	5	0.00000
Candidatus Pelagibacter sp. HIMB1321	1388755	S	4	0	4	0.00000
Candidatus Pelagibacter sp. RS39	1977864	S	4	0	4	0.00000
Candidatus Pelagibacter sp. FZCC0015	2268451	S	3	0	3	0.00000
Candidatus Pelagibacter sp. IMCC9063	1002672	S	2	0	2	0.00000
Candidatus Pelagibacter ubique	198252	S	2	1	3	0.00000
Candidatus Pelagibacter giovannonii	2563896	S	1	0	1	0.00000
Candidatus Fonsibacter ubiquis	1925548	S	5	0	5	0.00000
Marinicauda algicola	2029849	S	9	3	12	0.00001
Glycocaulis alkaliphilus	1434191	S	5	1	6	0.00000
Hyphobacterium sp. CCMP332	2749086	S	3	0	3	0.00000
Maricaulis maris	74318	S	2	0	2	0.00000
Candidatus Cytomitobacter primus	2066024	S	3	2	5	0.00000
endosymbiont of Acanthamoeba sp. UWC8	86106	S	2	0	2	0.00000
Candidatus Nesciobacter abundans	2601668	S	1	0	1	0.00000
Candidatus Nucleicultrix amoebiphila	1509244	S	8	0	8	0.00000
Candidatus Paracaedibacter acanthamoebae	91604	S	2	0	2	0.00000
Luteithermobacter gelatinilyticus	2582913	S	4	0	4	0.00000
Paremcibacter congregatus	2043170	S	3	0	3	0.00000
Parvularcula bermudensis	208216	S	6	0	6	0.00000
Magnetococcus marinus	1124597	S	6	0	6	0.00000
Kordiimonas pumila	2161677	S	3	0	3	0.00000
Aliarcobacter cryaerophilus	28198	S	1039	159	1198	0.00073
Aliarcobacter skirrowii	28200	S	60	16	76	0.00005
Aliarcobacter cibarius	255507	S	29	4	33	0.00002
Aliarcobacter butzleri	28197	S	15	2	17	0.00001
Aliarcobacter faecis	1564138	S	15	1	16	0.00001
[Arcobacter] porcinus	1935204	S	15	4	19	0.00001
Aliarcobacter lanthieri	1355374	S	14	0	14	0.00001
Aliarcobacter trophiarum	708186	S	8	0	8	0.00000
Aliarcobacter thereius	544718	S	3	0	3	0.00000
Arcobacter suis	1278212	S	90	13	103	0.00006
Arcobacter venerupis	1054033	S	49	6	55	0.00003
Arcobacter ellisii	913109	S	22	5	27	0.00002
Arcobacter cloacae	1054034	S	17	5	22	0.00001
Arcobacter defluvii	873191	S	15	2	17	0.00001
Arcobacter aquimarinus	1315211	S	9	2	11	0.00001
Arcobacter nitrofigilis	28199	S	4	0	4	0.00000
Arcobacter anaerophilus	877500	S	4	0	4	0.00000
Arcobacter sp. FWKO B	2593672	S	1	0	1	0.00000
Malaciobacter pacificus	1080223	S	8	0	8	0.00000
Malaciobacter molluscorum	1032072	S	7	0	7	0.00000
Malaciobacter halophilus	197482	S	6	0	6	0.00000
Malaciobacter marinus	505249	S	4	0	4	0.00000
Malaciobacter mytili	603050	S	2	1	3	0.00000
Pseudoarcobacter acticola	1849015	S	23	2	25	0.00002
Halarcobacter bivalviorum	663364	S	5	0	5	0.00000
Halarcobacter ebronensis	1462615	S	1	0	1	0.00000
Poseidonibacter lekithochrous	1904463	S	6	0	6	0.00000
Campylobacter fetus	196	S	5	0	5	0.00000
Campylobacter sp. RM16704	1500960	S	2	0	2	0.00000
Campylobacter sp. CCUG 57310	2517362	S	2	1	3	0.00000
Campylobacter jejuni	197	S	5	33	38	0.00002
Campylobacter concisus	199	S	4	0	4	0.00000
Campylobacter mucosalis	202	S	4	0	4	0.00000
Campylobacter iguaniorum	1244531	S	4	0	4	0.00000
Campylobacter peloridis	488546	S	3	1	4	0.00000
Campylobacter lari	201	S	3	2	5	0.00000
Campylobacter showae	204	S	3	0	3	0.00000
Campylobacter sputorum	206	S	3	0	3	0.00000
Campylobacter ureolyticus	827	S	3	0	3	0.00000
Campylobacter lanienae	75658	S	3	0	3	0.00000
Campylobacter gracilis	824	S	2	0	2	0.00000
Campylobacter canadensis	449520	S	2	0	2	0.00000
Campylobacter insulaenigrae	260714	S	2	0	2	0.00000
Campylobacter blaseri	2042961	S	2	0	2	0.00000
Campylobacter hyointestinalis	198	S	2	0	2	0.00000
Campylobacter pinnipediorum	1965231	S	1	0	1	0.00000
Campylobacter avium	522485	S	1	0	1	0.00000
Campylobacter coli	195	S	1	1	2	0.00000
Campylobacter subantarcticus	497724	S	1	-1	0	0.00000
Campylobacter helveticus	28898	S	1	0	1	0.00000
Sulfurospirillum sp. UCH001	1581011	S	6	0	6	0.00000
Sulfurospirillum sp. JPD-1	220622	S	1	9	10	0.00001
Sulfurospirillum deleyianum	65553	S	4	0	4	0.00000
Sulfurospirillum multivorans	66821	S	2	0	2	0.00000
Sulfurospirillum halorespirans	194424	S	2	0	2	0.00000
Sulfurospirillum cavolei	366522	S	2	0	2	0.00000
Sulfurimonas sp. B2	2590551	S	8	0	8	0.00000
Sulfurimonas sp. GYSZ_1	2590022	S	3	0	3	0.00000
Sulfurimonas sp. S2-6	2590020	S	2	0	2	0.00000
Sulfurimonas sp. 1-1N	2590021	S	2	5	7	0.00000
Sulfurimonas sp. H1576	2672570	S	1	0	1	0.00000
Candidatus Sulfurimonas marisnigri	2740405	S	5	1	6	0.00000
Sulfurimonas gotlandica	1176482	S	4	0	4	0.00000
Candidatus Sulfurimonas baltica	2740404	S	4	0	4	0.00000
Sulfurimonas autotrophica	202747	S	2	0	2	0.00000
Sulfurimonas denitrificans	39766	S	1	0	1	0.00000
Sulfurimonas paralvinellae	317658	S	1	0	1	0.00000
Sulfuricurvum kujiense	148813	S	4	0	4	0.00000
Helicobacter pylori	210	S	18	5	23	0.00001
Helicobacter bilis	37372	S	3	0	3	0.00000
Helicobacter cholecystus	45498	S	2	0	2	0.00000
Helicobacter cinaedi	213	S	1	0	1	0.00000
Helicobacter winghamensis	157268	S	1	0	1	0.00000
Helicobacter cetorum	138563	S	1	0	1	0.00000
Helicobacter canadensis	123841	S	1	0	1	0.00000
Helicobacter pullorum	35818	S	1	0	1	0.00000
Helicobacter suis	104628	S	1	0	1	0.00000
Wolinella succinogenes	844	S	2	0	2	0.00000
Nitratifractor salsuginis	269261	S	2	0	2	0.00000
Hydrogenimonas urashimensis	2740515	S	2	0	2	0.00000
Nitratiruptor sp. SB155-2	387092	S	1	7	8	0.00000
Nitratiruptor labii	2706014	S	3	0	3	0.00000
Nitrosophilus alvini	2714855	S	3	0	3	0.00000
Nautilia profundicola	244787	S	4	0	4	0.00000
Caminibacter mediatlanticus	291048	S	2	0	2	0.00000
Cetia pacifica	1424653	S	2	0	2	0.00000
Sorangium cellulosum	56	S	109	21	130	0.00008
Chondromyces crocatus	52	S	16	1	17	0.00001
Pajaroellobacter abortibovis	1882918	S	1	0	1	0.00000
Minicystis rosea	888845	S	36	6	42	0.00003
Sandaracinus amylolyticus	927083	S	34	1	35	0.00002
Labilithrix luteola	1391654	S	32	2	34	0.00002
Archangium violaceum	83451	S	32	10	42	0.00003
Archangium gephyra	48	S	7	2	9	0.00001
Stigmatella aurantiaca	41	S	11	2	13	0.00001
Cystobacter fuscus	43	S	8	4	12	0.00001
Melittangium boletus	83453	S	5	2	7	0.00000
Myxococcus xanthus	34	S	9	2	11	0.00001
Myxococcus hansupus	1297742	S	7	1	8	0.00000
Myxococcus sp. SCHIC003	2813577	S	7	0	7	0.00000
Myxococcus stipitatus	83455	S	5	0	5	0.00000
Corallococcus coralloides	184914	S	12	2	14	0.00001
Corallococcus macrosporus	35	S	8	3	11	0.00001
Pyxidicoccus sp. SCPEA002	2813578	S	11	1	12	0.00001
Anaeromyxobacter sp. Fw109-5	404589	S	18	1	19	0.00001
Anaeromyxobacter sp. K	447217	S	2	6	8	0.00000
Anaeromyxobacter dehalogenans	161493	S	13	14	27	0.00002
Vulgatibacter incomptus	1391653	S	3	0	3	0.00000
Haliangium ochraceum	80816	S	49	1	50	0.00003
Desulfovibrio desulfuricans	876	S	7	0	7	0.00000
Desulfovibrio vulgaris	881	S	7	0	7	0.00000
Desulfovibrio sp. 86	2666132	S	5	0	5	0.00000
Desulfovibrio sp. G11	631220	S	1	8	9	0.00001
Desulfovibrio piger	901	S	5	0	5	0.00000
Desulfovibrio sulfodismutans	63561	S	5	1	6	0.00000
Desulfovibrio carbinolicus	296842	S	5	1	6	0.00000
Desulfovibrio marinus	370038	S	4	0	4	0.00000
Desulfovibrio fairfieldensis	44742	S	3	0	3	0.00000
Desulfovibrio carbinoliphilus	345370	S	3	0	3	0.00000
Desulfovibrio gigas	879	S	2	0	2	0.00000
Desulfovibrio magneticus	184917	S	2	0	2	0.00000
Desulfovibrio ferrophilus	241368	S	1	0	1	0.00000
Pseudodesulfovibrio mercurii	641491	S	9	0	9	0.00001
Pseudodesulfovibrio profundus	57320	S	3	2	5	0.00000
Pseudodesulfovibrio aespoeensis	182210	S	3	2	5	0.00000
Pseudodesulfovibrio indicus	1716143	S	3	0	3	0.00000
Pseudodesulfovibrio sp. zrk46	2725288	S	2	0	2	0.00000
Pseudodesulfovibrio cashew	2678688	S	2	0	2	0.00000
Pseudodesulfovibrio piezophilus	879567	S	1	0	1	0.00000
Desulfocurvibacter africanus	873	S	3	0	3	0.00000
Desulfolutivibrio sulfoxidireducens	2773299	S	3	0	3	0.00000
Maridesulfovibrio hydrothermalis	191026	S	2	0	2	0.00000
Maridesulfovibrio salexigens	880	S	1	0	1	0.00000
Desulfomicrobium baculatum	899	S	8	1	9	0.00001
Desulfomicrobium orale	132132	S	3	1	4	0.00000
Desulfohalobium retbaense	45663	S	3	0	3	0.00000
Geobacter sp. M18	443143	S	14	8	22	0.00001
Geobacter sp. SVR	2495594	S	10	1	11	0.00001
Geobacter sp. FeAm09	2597769	S	10	0	10	0.00001
Geobacter sp. Jerry-YX	2815309	S	2	0	2	0.00000
Geobacter sp. DSM 9736	1277350	S	1	0	1	0.00000
Geobacter lovleyi	313985	S	11	1	12	0.00001
Geobacter bremensis	60035	S	7	5	12	0.00001
Geobacter metallireducens	28232	S	5	0	5	0.00000
Geobacter sulfurreducens	35554	S	4	2	6	0.00000
Geobacter daltonii	1203471	S	3	0	3	0.00000
Geobacter bemidjiensis	225194	S	1	1	2	0.00000
Geoalkalibacter subterraneus	483547	S	3	2	5	0.00000
Desulfuromonas sp. DDH964	1823759	S	4	1	5	0.00000
Desulfuromonas soudanensis	1603606	S	3	0	3	0.00000
Pelobacter propionicus	29543	S	5	1	6	0.00000
Syntrophotalea carbinolica	19	S	6	0	6	0.00000
Syntrophotalea acetylenivorans	1842532	S	3	0	3	0.00000
Desulfonema limicola	45656	S	16	0	16	0.00001
Desulfonema magnum	45655	S	5	0	5	0.00000
Desulfosarcina ovata	83564	S	4	0	4	0.00000
Desulfosarcina alkanivorans	571177	S	4	1	5	0.00000
Desulfosarcina widdelii	947919	S	3	0	3	0.00000
Desulfatibacillum aliphaticivorans	218208	S	8	0	8	0.00000
Desulfococcus oleovorans	181663	S	5	0	5	0.00000
Desulfococcus multivorans	897	S	2	0	2	0.00000
Desulfobacter postgatei	2293	S	4	0	4	0.00000
Desulfobacter hydrogenophilus	2291	S	3	0	3	0.00000
Desulfobacterium autotrophicum	2296	S	7	0	7	0.00000
Desulfobacula toluolica	28223	S	2	0	2	0.00000
Desulfobulbus propionicus	894	S	8	0	8	0.00000
Desulfobulbus oligotrophicus	1909699	S	4	4	8	0.00000
Desulfobulbus oralis	1986146	S	2	0	2	0.00000
Desulfopila sp. IMCC35005	2569541	S	5	0	5	0.00000
Desulfopila sp. IMCC35004	2569540	S	4	0	4	0.00000
Desulfocapsa sulfexigens	65555	S	3	0	3	0.00000
Desulfurivibrio alkaliphilus	427923	S	2	0	2	0.00000
Persicimonas caeni	2292766	S	14	0	14	0.00001
Bradymonas sediminis	1548548	S	7	1	8	0.00000
Desulfobacca acetoxidans	60893	S	7	0	7	0.00000
Syntrophus aciditrophicus	316277	S	2	0	2	0.00000
Desulfomonile tiedjei	2358	S	1	0	1	0.00000
Desulfoglaeba alkanexedens	361111	S	5	0	5	0.00000
Syntrophobacter fumaroxidans	119484	S	2	0	2	0.00000
Desulfarculus baarsii	453230	S	6	5	11	0.00001
Hippea maritima	84405	S	3	0	3	0.00000
Candidatus Desulfofervidus auxilii	1621989	S	3	0	3	0.00000
Bacteriovorax stolpii	960	S	53	0	53	0.00003
Halobacteriovorax marinus	97084	S	12	0	12	0.00001
Halobacteriovorax sp. BALOs_7	2109558	S	2	0	2	0.00000
Bdellovibrio sp. NC01	2220073	S	13	4	17	0.00001
Bdellovibrio sp. ZAP7	2231053	S	1	3	4	0.00000
Bdellovibrio sp. KM01	2748865	S	1	3	4	0.00000
Bdellovibrio bacteriovorus	959	S	21	3	24	0.00001
Bdellovibrio exovorus	453816	S	10	0	10	0.00001
Silvanigrella aquatica	1915309	S	13	0	13	0.00001
Acidithiobacillus ferrivorans	160808	S	14	0	14	0.00001
Acidithiobacillus thiooxidans	930	S	3	0	3	0.00000
Acidithiobacillus caldus	33059	S	3	0	3	0.00000
Acidithiobacillus ferrooxidans	920	S	1	0	1	0.00000
Hydrogenophilus thermoluteolus	297	S	10	0	10	0.00001
Mariprofundus ferrinatatus	1921087	S	1	3	4	0.00000
Cutibacterium acnes	1747	S	9606	519	10125	0.00620
Cutibacterium granulosum	33011	S	116	9	125	0.00008
Cutibacterium avidum	33010	S	102	9	111	0.00007
Propionibacterium sp. oral taxon 193	671223	S	160	25	185	0.00011
Propionibacterium freudenreichii	1744	S	18	4	22	0.00001
Propionibacterium acidifaciens	556499	S	6	0	6	0.00000
Propionibacterium australiense	119981	S	1	0	1	0.00000
Tessaracoccus flavescens	399497	S	15	10	25	0.00002
Tessaracoccus defluvii	1285901	S	11	6	17	0.00001
Tessaracoccus aquimaris	1332264	S	8	2	10	0.00001
Tessaracoccus flavus	1610493	S	6	3	9	0.00001
Tessaracoccus timonensis	2161816	S	6	1	7	0.00000
Tessaracoccus sp. MC1865	2760310	S	3	0	3	0.00000
Microlunatus sagamiharensis	546874	S	12	1	13	0.00001
Microlunatus phosphovorus	29405	S	11	0	11	0.00001
Microlunatus soli	630515	S	10	1	11	0.00001
Microlunatus sp. Gsoil 973	2672569	S	7	0	7	0.00000
Microlunatus sp. KUDC0627	2596828	S	3	0	3	0.00000
Acidipropionibacterium jensenii	1749	S	9	4	13	0.00001
Acidipropionibacterium acidipropionici	1748	S	7	3	10	0.00001
Acidipropionibacterium virtanenii	2057246	S	5	1	6	0.00000
Brevilactibacter sp. MC1595	2819349	S	18	2	20	0.00001
Auraticoccus monumenti	675864	S	9	0	9	0.00001
Raineyella sp. CBA3103	2662261	S	9	0	9	0.00001
Propioniciclava sp. HDW11	2714937	S	7	1	8	0.00000
Propionimicrobium sp. Marseille-P3275	1871034	S	3	0	3	0.00000
Pseudopropionibacterium propionicum	1750	S	3	0	3	0.00000
Nocardioides sp. JS614	196162	S	18	3	21	0.00001
Nocardioides sp. S5	2017486	S	17	8	25	0.00002
Nocardioides sp. S-1144	2582905	S	17	4	21	0.00001
Nocardioides sp. MC1495	2736757	S	15	4	19	0.00001
Nocardioides sp. zg-1228	2763008	S	12	3	15	0.00001
Nocardioides sp. HDW12B	2714939	S	11	2	13	0.00001
Nocardioides sp. S-713	2760089	S	10	3	13	0.00001
Nocardioides sp. 603	2483798	S	8	2	10	0.00001
Nocardioides sp. zg-579	2663857	S	7	2	9	0.00001
Nocardioides sp. HDW12A	2714938	S	6	3	9	0.00001
Nocardioides sp. dk884	2662361	S	5	5	10	0.00001
Nocardioides sp. WS12	2486272	S	4	0	4	0.00000
Nocardioides sp. dk3136	2575373	S	3	1	4	0.00000
Nocardioides sp. JQ2195	2592334	S	3	0	3	0.00000
Nocardioides sp. CF8	110319	S	3	1	4	0.00000
Nocardioides sp. HY056	2500546	S	2	0	2	0.00000
Nocardioides sp. ZJ1313	2685869	S	2	2	4	0.00000
Nocardioides anomalus	2712223	S	17	4	21	0.00001
Nocardioides euryhalodurans	2518370	S	16	3	19	0.00001
Nocardioides aromaticivorans	200618	S	15	5	20	0.00001
Nocardioides houyundeii	2045452	S	14	3	17	0.00001
Nocardioides mesophilus	433659	S	11	1	12	0.00001
Nocardioides cynanchi	2558918	S	10	1	11	0.00001
Nocardioides ungokensis	1643322	S	9	2	11	0.00001
Nocardioides seonyuensis	2518371	S	9	2	11	0.00001
Nocardioides marinisabuli	419476	S	8	5	13	0.00001
Nocardioides humi	449461	S	8	2	10	0.00001
Nocardioides sambongensis	2589074	S	8	1	9	0.00001
Nocardioides daphniae	402297	S	6	2	8	0.00000
Nocardioides dokdonensis	450734	S	5	3	8	0.00000
Nocardioides baekrokdamisoli	1804624	S	5	0	5	0.00000
Aeromicrobium marinum	219314	S	14	1	15	0.00001
Aeromicrobium chenweiae	2079793	S	12	3	15	0.00001
Aeromicrobium erythreum	2041	S	9	1	10	0.00001
Aeromicrobium choanae	1736691	S	7	1	8	0.00000
Aeromicrobium sp. A1-2	2107713	S	4	0	4	0.00000
Aeromicrobium sp. zg-629	2663859	S	3	0	3	0.00000
Aeromicrobium yanjiei	2662028	S	6	1	7	0.00000
Micropruina glycogenica	75385	S	29	2	31	0.00002
Friedmanniella luteola	546871	S	12	0	12	0.00001
Pimelobacter simplex	2045	S	11	3	14	0.00001
Marmoricola scoriae	642780	S	10	2	12	0.00001
Mumia sp. ZJ1417	2708082	S	8	0	8	0.00000
Kribbella flavida	182640	S	16	1	17	0.00001
Kribbella qitaiheensis	1544730	S	7	0	7	0.00000
Actinopolymorpha singaporensis	117157	S	11	0	11	0.00001
Dermacoccus nishinomiyaensis	1274	S	3241	395	3636	0.00223
Dermacoccus sp. PAMC28757	2762331	S	36	3	39	0.00002
Luteipulveratus mongoliensis	571913	S	8	0	8	0.00000
Yimella sp. cx-51	2770551	S	3	0	3	0.00000
Microbacterium sp. PM5	2014534	S	58	5	63	0.00004
Microbacterium sp. Y-01	2048898	S	26	6	32	0.00002
Microbacterium sp. BH-3-3-3	1906742	S	20	2	22	0.00001
Microbacterium sp. LKL04	912630	S	17	2	19	0.00001
Microbacterium sp. WY121	2782168	S	16	1	17	0.00001
Microbacterium sp. NY27	2782169	S	15	1	16	0.00001
Microbacterium sp. A18JL200	2782167	S	15	4	19	0.00001
Microbacterium sp. 4R-513	2567934	S	15	1	16	0.00001
Microbacterium sp. RG1	2489212	S	15	1	16	0.00001
Microbacterium sp. TPU 3598	1938334	S	15	2	17	0.00001
Microbacterium sp. ABRD_28	2268461	S	14	0	14	0.00001
Microbacterium sp. No. 7	1714373	S	13	2	15	0.00001
Microbacterium sp. XT11	367477	S	12	1	13	0.00001
Microbacterium sp. PAMC 28756	1795053	S	12	14	26	0.00002
Microbacterium sp. Se63.02b	2709304	S	11	2	13	0.00001
Microbacterium sp. 10M-3C3	2483401	S	10	1	11	0.00001
Microbacterium sp. YJN-G	2763257	S	10	1	11	0.00001
Microbacterium sp. HY60	2769067	S	8	0	8	0.00000
Microbacterium sp. 1S1	2606451	S	7	2	9	0.00001
Microbacterium sp. A18JL241	2782166	S	7	0	7	0.00000
Microbacterium sp. CBA3102	2603598	S	7	1	8	0.00000
Microbacterium sp. 1.5R	1916917	S	5	15	20	0.00001
Microbacterium sp. HY82	2708079	S	4	0	4	0.00000
Microbacterium sp. str. 'China'	2103230	S	4	34	38	0.00002
Microbacterium sp. JZ31	1906274	S	3	0	3	0.00000
Microbacterium sp. SGAir0570	2070348	S	3	18	21	0.00001
Microbacterium sp. Nx66	2766784	S	2	1	3	0.00000
Microbacterium hominis	162426	S	43	7	50	0.00003
Microbacterium foliorum	104336	S	41	6	47	0.00003
Microbacterium oxydans	82380	S	36	9	45	0.00003
Microbacterium aurum	36805	S	28	5	33	0.00002
Microbacterium pygmaeum	370764	S	17	0	17	0.00001
Microbacterium schleiferi	69362	S	16	5	21	0.00001
Microbacterium esteraromaticum	57043	S	15	1	16	0.00001
Microbacterium chocolatum	84292	S	11	1	12	0.00001
Microbacterium testaceum	2033	S	11	0	11	0.00001
Microbacterium hydrocarbonoxydans	273678	S	10	1	11	0.00001
Microbacterium caowuchunii	2614638	S	10	0	10	0.00001
Microbacterium lemovicicum	1072463	S	10	0	10	0.00001
Microbacterium protaetiae	2509458	S	9	0	9	0.00001
Microbacterium oleivorans	273677	S	8	0	8	0.00000
Microbacterium sediminis	904291	S	7	2	9	0.00001
Microbacterium oryzae	743009	S	6	0	6	0.00000
Microbacterium amylolyticum	936337	S	5	0	5	0.00000
Microbacterium lushaniae	2614639	S	4	0	4	0.00000
Microbacterium wangchenii	2541726	S	4	0	4	0.00000
Microbacterium paraoxydans	199592	S	2	14	16	0.00001
Microbacterium endophyticum	1526412	S	1	0	1	0.00000
Curtobacterium flaccumfaciens	2035	S	584	60	644	0.00039
Curtobacterium sp. SGAir0471	2070337	S	16	2	18	0.00001
Curtobacterium sp. 24E2	2804758	S	12	1	13	0.00001
Curtobacterium sp. YC1	2795488	S	7	0	7	0.00000
Curtobacterium sp. MR_MD2014	1561023	S	4	0	4	0.00000
Curtobacterium sp. BH-2-1-1	1905847	S	3	0	3	0.00000
Curtobacterium sp. Csp2	2495430	S	3	0	3	0.00000
Curtobacterium sp. Csp1	2495429	S	2	11	13	0.00001
Curtobacterium pusillum	69373	S	2	0	2	0.00000
Rhodoluna lacicola	529884	S	109	11	120	0.00007
Rhodoluna limnophila	232537	S	46	4	50	0.00003
Candidatus Rhodoluna planktonica	535712	S	12	0	12	0.00001
Candidatus Aquiluna sp. 15G-AUS-rot	2499157	S	10	0	10	0.00001
Candidatus Aquiluna sp. UB-MaderosW2red	1855377	S	5	0	5	0.00000
Rathayibacter sp. VKM Ac-2759	2609252	S	34	6	40	0.00002
Rathayibacter sp. VKM Ac-2760	2609253	S	34	11	45	0.00003
Rathayibacter sp. VKM Ac-2804	2609257	S	12	6	18	0.00001
Rathayibacter sp. VKM Ac-2762	2609254	S	7	17	24	0.00001
Rathayibacter sp. VKM Ac-2801	2609255	S	2	1	3	0.00000
Rathayibacter sp. VKM Ac-2805	2609258	S	1	2	3	0.00000
Rathayibacter festucae	110937	S	21	15	36	0.00002
Rathayibacter toxicus	145458	S	7	0	7	0.00000
Rathayibacter iranicus	59737	S	6	0	6	0.00000
Rathayibacter tritici	33888	S	4	0	4	0.00000
Rathayibacter tanaceti	1671680	S	4	0	4	0.00000
Rathayibacter rathayi	33887	S	1	0	1	0.00000
Plantibacter sp. PA-3-X8	2480625	S	49	50	99	0.00006
Plantibacter sp. M259	2583822	S	29	29	58	0.00004
Plantibacter flavus	150123	S	11	8	19	0.00001
Aurantimicrobium sp. MWH-Mo1	1987356	S	57	3	60	0.00004
Aurantimicrobium sp. MWH-Uga1	2079575	S	12	5	17	0.00001
Aurantimicrobium minutum	708131	S	6	2	8	0.00000
Agromyces sp. LHK192	2498704	S	9	1	10	0.00001
Agromyces sp. G127AT	2781962	S	9	1	10	0.00001
Agromyces sp. KACC 19306	2592652	S	7	0	7	0.00000
Agromyces sp. HY052	2585717	S	6	0	6	0.00000
Agromyces badenianii	2080742	S	10	2	12	0.00001
Agromyces protaetiae	2509455	S	8	1	9	0.00001
Agromyces aureus	453304	S	6	1	7	0.00000
Agromyces flavus	589382	S	5	0	5	0.00000
Leifsonia sp. PS1209	2724914	S	10	2	12	0.00001
Leifsonia sp. 21MFCrub1.1	1798223	S	8	9	17	0.00001
Leifsonia shinshuensis	150026	S	13	4	17	0.00001
Leifsonia xyli	1575	S	11	3	14	0.00001
Clavibacter michiganensis	28447	S	36	7	43	0.00003
Clavibacter sp. DM1	2768071	S	10	6	16	0.00001
Leucobacter sp. CX169	2813744	S	9	1	10	0.00001
Leucobacter triazinivorans	1784719	S	7	1	8	0.00000
Leucobacter muris	1935379	S	7	1	8	0.00000
Leucobacter viscericola	2714935	S	5	0	5	0.00000
Leucobacter denitrificans	683042	S	4	0	4	0.00000
Leucobacter coleopterorum	2714933	S	4	0	4	0.00000
Leucobacter insecticola	2714934	S	3	0	3	0.00000
Agreia sp. COWG	2773266	S	40	2	42	0.00003
Cryobacterium arcticum	670052	S	15	7	22	0.00001
Cryobacterium sp.	1926290	S	6	0	6	0.00000
Cryobacterium sp. LW097	1978566	S	5	0	5	0.00000
Cryobacterium soli	2220095	S	5	2	7	0.00000
Salinibacterium sp. ZJ70	2708084	S	11	1	12	0.00001
Salinibacterium sp. dk2585	2603292	S	9	1	10	0.00001
Salinibacterium sp. ZJ450	2708338	S	8	0	8	0.00000
Salinibacterium sp. UTAS2018	2508880	S	7	0	7	0.00000
Salinibacterium hongtaonis	2079791	S	2	0	2	0.00000
Agrococcus carbonis	684552	S	11	1	12	0.00001
Agrococcus jejuensis	399736	S	7	1	8	0.00000
Agrococcus sp. SGAir0287	2070347	S	7	1	8	0.00000
Mycetocola zhujimingii	2079792	S	14	0	14	0.00001
Mycetocola sp. JXN-3	2116510	S	7	0	7	0.00000
Humibacter sp. WJ7-1	2599293	S	11	1	12	0.00001
Humibacter sp. BT305	2282656	S	9	54	63	0.00004
Herbiconiux sp. SALV-R1	2735133	S	20	1	21	0.00001
Frigoribacterium sp. NBH87	2596916	S	16	2	18	0.00001
Protaetiibacter intestinalis	2419774	S	10	4	14	0.00001
Protaetiibacter sp. SSC-01	2759943	S	3	1	4	0.00000
Gryllotalpicola protaetiae	2419771	S	15	1	16	0.00001
Glaciihabitans sp. INWT7	2596912	S	15	0	15	0.00001
Chryseoglobus sp. 28M-23	2772253	S	2	12	14	0.00001
Marisediminicola antarctica	674079	S	13	0	13	0.00001
Frondihabitans sp. PAMC 28766	1795630	S	8	0	8	0.00000
Frondihabitans sp. 762G35	1446794	S	3	0	3	0.00000
Lysinimonas sp. KACC 19322	2592654	S	11	2	13	0.00001
Diaminobutyricimonas sp. LJ205	2683590	S	9	0	9	0.00001
Microterricola viridarii	412690	S	6	0	6	0.00000
Pontimonas salivibrio	1159327	S	3	0	3	0.00000
Microcella alkaliphila	279828	S	2	0	2	0.00000
Cnuibacter physcomitrellae	1619308	S	1	5	6	0.00000
Kocuria rhizophila	72000	S	768	188	956	0.00059
Kocuria palustris	71999	S	122	15	137	0.00008
Kocuria varians	1272	S	21	5	26	0.00002
Kocuria sp. BT304	1702043	S	5	4	9	0.00001
Kocuria sp. KD4	2719588	S	5	1	6	0.00000
Kocuria sp. TGY1127_2	2711328	S	4	3	7	0.00000
Kocuria rosea	1275	S	10	0	10	0.00001
Kocuria turfanensis	388357	S	7	0	7	0.00000
Kocuria indica	1049583	S	5	1	6	0.00000
Kocuria flava	446860	S	4	0	4	0.00000
Micrococcus luteus	1270	S	122	110	232	0.00014
Micrococcus sp. A7	376418	S	2	4	6	0.00000
Micrococcus sp. KBS0714	1179670	S	1	7	8	0.00000
Arthrobacter sp. NEB 688	904039	S	10	1	11	0.00001
Arthrobacter sp. FB24	290399	S	9	0	9	0.00001
Arthrobacter sp. PAMC25564	2565366	S	9	0	9	0.00001
Arthrobacter sp. ERGS1:01	1704044	S	8	0	8	0.00000
Arthrobacter sp. U41	1849032	S	7	0	7	0.00000
Arthrobacter sp. PGP41	2079227	S	5	0	5	0.00000
Arthrobacter sp. 24S4-2	2575374	S	4	0	4	0.00000
Arthrobacter sp. PM3	2017685	S	4	0	4	0.00000
Arthrobacter sp. TES	2774874	S	3	32	35	0.00002
Arthrobacter sp. QXT-31	1357915	S	2	0	2	0.00000
Arthrobacter sp. YC-RL1	1652545	S	2	0	2	0.00000
Arthrobacter sp. UKPF54-2	2600159	S	2	0	2	0.00000
Arthrobacter sp. KBS0702	2578107	S	2	0	2	0.00000
Arthrobacter sp. Rue61a	1118963	S	1	1	2	0.00000
Arthrobacter sp. D5-1	1477518	S	1	0	1	0.00000
Arthrobacter sp. PAMC 25486	1494608	S	1	0	1	0.00000
Arthrobacter sp. ZXY-2	1806905	S	1	5	6	0.00000
Arthrobacter alpinus	656366	S	19	2	21	0.00001
Arthrobacter agilis	37921	S	10	0	10	0.00001
Arthrobacter woluwensis	156980	S	7	0	7	0.00000
Arthrobacter crystallopoietes	37928	S	5	0	5	0.00000
Arthrobacter citreus	1670	S	3	0	3	0.00000
Arthrobacter dokdonellae	2211210	S	2	0	2	0.00000
Rothia terrae	396015	S	15	6	21	0.00001
Rothia mucilaginosa	43675	S	13	0	13	0.00001
Rothia kristinae	37923	S	7	1	8	0.00000
Rothia nasimurium	85336	S	4	0	4	0.00000
Rothia dentocariosa	2047	S	3	0	3	0.00000
Rothia aeria	172042	S	3	0	3	0.00000
Rothia sp. ZJ932	2810516	S	3	0	3	0.00000
Rothia amarae	169480	S	2	0	2	0.00000
Pseudarthrobacter sp. NIBRBAC000502772	2590775	S	6	1	7	0.00000
Pseudarthrobacter sp. BIM B-2242	2772401	S	5	0	5	0.00000
Pseudarthrobacter sp. NBSH8	2596911	S	2	0	2	0.00000
Pseudarthrobacter sp. NIBRBAC000502771	2590774	S	1	1	2	0.00000
Pseudarthrobacter sp. NIBRBAC000502770	2590785	S	1	1	2	0.00000
Pseudarthrobacter sp. YJ56	2697569	S	1	0	1	0.00000
Pseudarthrobacter chlorophenolicus	85085	S	10	0	10	0.00001
Pseudarthrobacter equi	728066	S	10	1	11	0.00001
Pseudarthrobacter phenanthrenivorans	361575	S	3	0	3	0.00000
Paenarthrobacter sp. YJN-D	2735317	S	31	4	35	0.00002
Paenarthrobacter ureafaciens	37931	S	1	4	5	0.00000
Glutamicibacter arilaitensis	256701	S	7	1	8	0.00000
Glutamicibacter halophytocola	1933880	S	5	0	5	0.00000
Glutamicibacter mishrai	1775880	S	4	0	4	0.00000
Glutamicibacter protophormiae	37930	S	2	0	2	0.00000
Glutamicibacter nicotianae	37929	S	1	7	8	0.00000
Glutamicibacter creatinolyticus	162496	S	1	0	1	0.00000
Sinomonas sp. R1AF57	2020377	S	5	0	5	0.00000
Sinomonas atrocyanea	37927	S	3	0	3	0.00000
Psychromicrobium lacuslunae	1618207	S	6	0	6	0.00000
Nesterenkonia sp. NBAIMH1	2600320	S	5	0	5	0.00000
Zhihengliuella sp. ISTPL4	2058657	S	5	2	7	0.00000
Citricoccus sp. SGAir0253	2567881	S	4	0	4	0.00000
Auritidibacter sp. NML130574	2170745	S	2	0	2	0.00000
Renibacterium salmoninarum	1646	S	1	0	1	0.00000
Janibacter indicus	857417	S	59	42	101	0.00006
Janibacter sp. YB324	2761047	S	22	22	44	0.00003
Janibacter melonis	262209	S	18	1	19	0.00001
Janibacter limosus	53458	S	10	0	10	0.00001
Pedococcus dokdonensis	443156	S	19	1	20	0.00001
Intrasporangium calvum	53358	S	12	0	12	0.00001
Phycicoccus sp. HDW14	2714941	S	6	0	6	0.00000
Phycicoccus endophyticus	1690220	S	2	0	2	0.00000
Tetrasphaera sp. HKS02	1813880	S	4	0	4	0.00000
Arsenicicoccus sp. oral taxon 190	1658671	S	4	0	4	0.00000
Brevibacterium sp. CS2	2575923	S	69	8	77	0.00005
Brevibacterium sp. 'Marine'	2725563	S	6	1	7	0.00000
Brevibacterium sp. WO024	2697563	S	3	0	3	0.00000
Brevibacterium sp. o2	2697565	S	3	0	3	0.00000
Brevibacterium sp. YB235	1496080	S	2	0	2	0.00000
Brevibacterium sp. PAMC23299	2762330	S	1	2	3	0.00000
Brevibacterium linens	1703	S	32	7	39	0.00002
Brevibacterium aurantiacum	273384	S	14	4	18	0.00001
Brevibacterium casei	33889	S	12	1	13	0.00001
Brevibacterium luteolum	199591	S	6	1	7	0.00000
Brevibacterium sandarakinum	629680	S	5	0	5	0.00000
Brevibacterium siliguriense	1136497	S	1	0	1	0.00000
Cellulomonas sp. Y8	2591145	S	15	2	17	0.00001
Cellulomonas sp. PSBB021	2003551	S	7	1	8	0.00000
Cellulomonas sp. JZ18	2654191	S	6	1	7	0.00000
Cellulomonas sp. H30R-01	2704467	S	6	1	7	0.00000
Cellulomonas fimi	1708	S	10	2	12	0.00001
Cellulomonas flavigena	1711	S	8	1	9	0.00001
Cellulomonas gilvus	11	S	7	1	8	0.00000
Cellulomonas taurus	2729175	S	6	0	6	0.00000
Cellulomonas shaoxiangyii	2566013	S	4	0	4	0.00000
Paraoerskovia marina	545619	S	13	0	13	0.00001
Pseudactinotalea sp. HY158	2654547	S	7	0	7	0.00000
Oerskovia sp. KBS0722	1179673	S	4	0	4	0.00000
Actinotalea sp. JY-7876	2758442	S	3	0	3	0.00000
Brachybacterium sp. SGAir0954	2571029	S	16	1	17	0.00001
Brachybacterium sp. P6-10-X1	1903186	S	7	0	7	0.00000
Brachybacterium ginsengisoli	1331682	S	18	2	20	0.00001
Brachybacterium faecium	43669	S	16	1	17	0.00001
Brachybacterium saurashtrense	556288	S	9	0	9	0.00001
Brachybacterium vulturis	2017484	S	9	1	10	0.00001
Brachybacterium avium	2017485	S	7	1	8	0.00000
Dermabacter vaginalis	1630135	S	3	3	6	0.00000
Dermabacter jinjuensis	1667168	S	3	3	6	0.00000
Devriesea agamarum	472569	S	1	0	1	0.00000
Ornithinimicrobium sp. H23M54	2594265	S	7	0	7	0.00000
Ornithinimicrobium sp. HY006	2508882	S	6	0	6	0.00000
Ornithinimicrobium sp. AMA3305	2283195	S	4	0	4	0.00000
Ornithinimicrobium pratense	2593973	S	13	0	13	0.00001
Ornithinimicrobium flavum	1288636	S	8	1	9	0.00001
Serinicoccus chungangensis	767452	S	7	1	8	0.00000
Serinicoccus profundi	1078471	S	7	1	8	0.00000
Serinicoccus marinus	247333	S	5	1	6	0.00000
Serinicoccus hydrothermalis	1758689	S	3	1	4	0.00000
Cellulosimicrobium sp. 72-3	2731680	S	4	4	8	0.00000
Cellulosimicrobium sp. BI34T	2587808	S	3	0	3	0.00000
Cellulosimicrobium cellulans	1710	S	2	0	2	0.00000
Isoptericola dokdonensis	372663	S	5	0	5	0.00000
Isoptericola variabilis	139208	S	3	0	3	0.00000
Xylanimicrobium sp. FW10M-9	2509457	S	8	0	8	0.00000
Xylanimonas allomyrinae	2509459	S	4	0	4	0.00000
Xylanimonas cellulosilytica	186189	S	3	0	3	0.00000
Kytococcus sedentarius	1276	S	25	2	27	0.00002
Georgenia sp. Z294	2585135	S	9	0	9	0.00001
Georgenia sp. Z443	2589797	S	7	0	7	0.00000
Georgenia faecalis	2483799	S	8	0	8	0.00000
Sanguibacter sp. HDW7	2714931	S	9	0	9	0.00001
Sanguibacter keddieii	60920	S	8	0	8	0.00000
Miniimonas sp. S16	2171623	S	8	1	9	0.00001
Beutenbergia cavernae	84757	S	7	0	7	0.00000
Haloactinobacterium sp. RN3S43	2779775	S	6	0	6	0.00000
Haloactinobacterium sp. HY164	2675754	S	5	0	5	0.00000
Ruania sp. HY168	2603206	S	3	0	3	0.00000
Austwickia chelonae	100225	S	4	0	4	0.00000
Mobilicoccus sp. NJES-13	2716227	S	2	0	2	0.00000
Luteimicrobium xylanilyticum	1133546	S	5	0	5	0.00000
Jonesia denitrificans	43674	S	3	0	3	0.00000
Corynebacterium kefirresidentii	1979527	S	112	33	145	0.00009
Corynebacterium sp. LMM-1652	2487892	S	25	1	26	0.00002
Corynebacterium sp. zg-320	2768834	S	21	0	21	0.00001
Corynebacterium sp. zg-917	2763010	S	7	0	7	0.00000
Corynebacterium sp. ZJ-599	2709394	S	7	0	7	0.00000
Corynebacterium sp. 2039	2675219	S	5	0	5	0.00000
Corynebacterium sp. 1959	2675216	S	3	0	3	0.00000
Corynebacterium sp. NML98-0116	702967	S	2	0	2	0.00000
Corynebacterium sp. sy039	2599641	S	2	0	2	0.00000
Corynebacterium sp. 2019	2675218	S	2	0	2	0.00000
Corynebacterium sp. Marseille-Q3630	2754725	S	2	0	2	0.00000
Corynebacterium sp. 1864	2820399	S	1	11	12	0.00001
Corynebacterium sp. FDAARGOS 1242	2778078	S	1	0	1	0.00000
Corynebacterium sp. MC1420	2709392	S	1	0	1	0.00000
Corynebacterium tuberculostearicum	38304	S	58	13	71	0.00004
Corynebacterium xerosis	1725	S	58	11	69	0.00004
Corynebacterium glutamicum	1718	S	32	145	177	0.00011
Corynebacterium jeikeium	38289	S	30	25	55	0.00003
Corynebacterium urealyticum	43771	S	21	6	27	0.00002
Corynebacterium anserum	2684406	S	15	0	15	0.00001
Corynebacterium propinquum	43769	S	15	1	16	0.00001
Corynebacterium lactis	1231000	S	15	0	15	0.00001
Corynebacterium glucuronolyticum	39791	S	14	0	14	0.00001
Corynebacterium ammoniagenes	1697	S	13	0	13	0.00001
Corynebacterium ureicelerivorans	401472	S	13	1	14	0.00001
Corynebacterium riegelii	156976	S	12	0	12	0.00001
Corynebacterium kroppenstedtii	161879	S	11	0	11	0.00001
Corynebacterium nuruki	1032851	S	11	0	11	0.00001
Corynebacterium resistens	258224	S	11	3	14	0.00001
Corynebacterium efficiens	152794	S	10	0	10	0.00001
Corynebacterium mycetoides	38302	S	9	1	10	0.00001
Corynebacterium sanguinis	2594913	S	9	2	11	0.00001
Corynebacterium maris	575200	S	9	0	9	0.00001
Corynebacterium endometrii	2488819	S	8	0	8	0.00000
Corynebacterium choanis	1862358	S	8	0	8	0.00000
Corynebacterium aurimucosum	169292	S	7	0	7	0.00000
Corynebacterium striatum	43770	S	7	2	9	0.00001
Corynebacterium deserti	1408191	S	6	0	6	0.00000
Corynebacterium kutscheri	35755	S	6	0	6	0.00000
Corynebacterium terpenotabidum	89154	S	6	0	6	0.00000
Corynebacterium sphenisci	191493	S	6	0	6	0.00000
Corynebacterium flavescens	28028	S	6	0	6	0.00000
Corynebacterium imitans	156978	S	6	0	6	0.00000
Corynebacterium glaucum	187491	S	5	0	5	0.00000
Corynebacterium minutissimum	38301	S	5	1	6	0.00000
Corynebacterium suranareeae	2506452	S	5	0	5	0.00000
Corynebacterium variabile	1727	S	5	1	6	0.00000
Corynebacterium epidermidicanis	1050174	S	5	0	5	0.00000
Corynebacterium uterequi	1072256	S	5	0	5	0.00000
Corynebacterium testudinoris	136857	S	5	0	5	0.00000
Corynebacterium humireducens	1223514	S	5	0	5	0.00000
Corynebacterium argentoratense	42817	S	5	0	5	0.00000
Corynebacterium liangguodongii	2079535	S	5	0	5	0.00000
Corynebacterium geronticis	2079234	S	5	0	5	0.00000
Corynebacterium pseudopelargi	2080757	S	4	0	4	0.00000
Corynebacterium timonense	441500	S	4	0	4	0.00000
Corynebacterium crudilactis	1652495	S	4	1	5	0.00000
Corynebacterium stationis	1705	S	4	0	4	0.00000
Corynebacterium aquilae	203263	S	4	0	4	0.00000
Corynebacterium bovis	36808	S	4	0	4	0.00000
Corynebacterium genitalium	38288	S	4	0	4	0.00000
Corynebacterium matruchotii	43768	S	4	0	4	0.00000
Corynebacterium segmentosum	43990	S	4	0	4	0.00000
Corynebacterium phocae	161895	S	4	0	4	0.00000
Corynebacterium camporealensis	161896	S	3	0	3	0.00000
Corynebacterium halotolerans	225326	S	3	0	3	0.00000
Corynebacterium marinum	349751	S	3	0	3	0.00000
Corynebacterium cystitidis	35757	S	3	0	3	0.00000
Corynebacterium vitaeruminis	38305	S	3	0	3	0.00000
Corynebacterium renale	1724	S	3	0	3	0.00000
Corynebacterium provencense	1737425	S	3	0	3	0.00000
Corynebacterium pelargi	1471400	S	3	0	3	0.00000
Corynebacterium ulcerans	65058	S	3	0	3	0.00000
Corynebacterium pseudotuberculosis	1719	S	3	0	3	0.00000
Corynebacterium doosanense	1121358	S	3	0	3	0.00000
Corynebacterium simulans	146827	S	3	0	3	0.00000
Corynebacterium casei	160386	S	3	2	5	0.00000
Corynebacterium callunae	1721	S	2	0	2	0.00000
Corynebacterium singulare	161899	S	2	0	2	0.00000
Corynebacterium atypicum	191610	S	2	0	2	0.00000
Corynebacterium diphtheriae	1717	S	2	0	2	0.00000
Corynebacterium yudongzhengii	2080740	S	2	0	2	0.00000
Corynebacterium rouxii	2719119	S	1	0	1	0.00000
Corynebacterium amycolatum	43765	S	1	2	3	0.00000
Corynebacterium glyciniphilum	1404244	S	1	0	1	0.00000
Mycolicibacterium aurum	1791	S	19	2	21	0.00001
Mycolicibacterium sediminis	1286180	S	18	2	20	0.00001
Mycolicibacterium helvum	1534349	S	16	1	17	0.00001
Mycolicibacterium phlei	1771	S	14	3	17	0.00001
Mycolicibacterium moriokaense	39691	S	14	0	14	0.00001
Mycolicibacterium mageritense	53462	S	14	1	15	0.00001
Mycolicibacterium arabiense	1286181	S	12	0	12	0.00001
Mycolicibacterium litorale	758802	S	11	2	13	0.00001
Mycolicibacterium madagascariense	212765	S	11	0	11	0.00001
Mycolicibacterium rutilum	370526	S	10	2	12	0.00001
Mycolicibacterium chubuense	1800	S	10	1	11	0.00001
Mycolicibacterium confluentis	28047	S	10	0	10	0.00001
Mycolicibacterium sarraceniae	1534348	S	9	0	9	0.00001
Mycolicibacterium fluoranthenivorans	258505	S	9	0	9	0.00001
Mycolicibacterium psychrotolerans	216929	S	9	0	9	0.00001
Mycolicibacterium goodii	134601	S	9	1	10	0.00001
Mycolicibacterium fortuitum	1766	S	8	1	9	0.00001
Mycolicibacterium tokaiense	39695	S	8	0	8	0.00000
Mycolicibacterium sp. Z-34	2736649	S	5	0	5	0.00000
Mycolicibacterium sp. LJ126	2761578	S	3	0	3	0.00000
Mycolicibacterium chitae	1792	S	8	1	9	0.00001
Mycolicibacterium thermoresistibile	1797	S	7	1	8	0.00000
Mycolicibacterium aichiense	1799	S	7	1	8	0.00000
Mycolicibacterium aubagnense	319707	S	7	1	8	0.00000
Mycolicibacterium boenickei	146017	S	7	22	29	0.00002
Mycolicibacterium phocaicum	319706	S	6	1	7	0.00000
Mycolicibacterium anyangense	1431246	S	6	0	6	0.00000
Mycolicibacterium frederiksbergense	117567	S	6	2	8	0.00000
Mycolicibacterium rhodesiae	36814	S	6	1	7	0.00000
Mycolicibacterium doricum	126673	S	5	1	6	0.00000
Mycolicibacterium gadium	1794	S	5	1	6	0.00000
Mycolicibacterium alvei	67081	S	5	1	6	0.00000
Mycolicibacterium fallax	1793	S	4	0	4	0.00000
Mycolicibacterium pulveris	36813	S	4	0	4	0.00000
Mycolicibacterium duvalii	39688	S	4	0	4	0.00000
Mycolicibacterium parafortuitum	39692	S	4	0	4	0.00000
Mycolicibacterium vaccae	1810	S	3	0	3	0.00000
Mycolicibacterium mucogenicum	56689	S	3	0	3	0.00000
Mycolicibacterium hassiacum	46351	S	3	0	3	0.00000
Mycolicibacterium insubricum	444597	S	3	0	3	0.00000
Mycolicibacterium smegmatis	1772	S	2	0	2	0.00000
Mycolicibacterium celeriflavum	1249101	S	2	0	2	0.00000
Mycolicibacterium gilvum	1804	S	2	-2	0	0.00000
Mycolicibacterium vanbaalenii	110539	S	1	9	10	0.00001
Mycolicibacterium monacense	85693	S	1	5	6	0.00000
Mycobacterium sp. JS623	212767	S	9	0	9	0.00001
Mycobacterium sp. EPa45	1545728	S	9	0	9	0.00001
Mycobacterium sp. MS1601	1936029	S	9	0	9	0.00001
Mycobacterium sp. DL592	2675524	S	9	0	9	0.00001
Mycobacterium sp. YC-RL4	1682113	S	7	2	9	0.00001
Mycobacterium sp. ELW1	1547487	S	6	1	7	0.00000
Mycobacterium sp. THAF192	2587868	S	3	7	10	0.00001
Mycobacterium sp. WY10	1920667	S	2	9	11	0.00001
Mycobacterium sp. DL440	2675523	S	2	0	2	0.00000
Mycobacterium heidelbergense	53376	S	17	2	19	0.00001
Mycobacterium parmense	185642	S	7	1	8	0.00000
Mycobacterium shigaense	722731	S	7	0	7	0.00000
Mycobacterium saskatchewanense	220927	S	6	0	6	0.00000
Mycobacterium florentinum	292462	S	5	0	5	0.00000
Mycobacterium kubicae	120959	S	4	0	4	0.00000
Mycobacterium stomatepiae	470076	S	2	0	2	0.00000
Mycobacterium simiae	1784	S	1	0	1	0.00000
Mycobacterium mantenii	560555	S	15	0	15	0.00001
Mycobacterium avium	1764	S	13	3	16	0.00001
Mycobacterium colombiense	339268	S	5	0	5	0.00000
Mycobacterium intracellulare	1767	S	2	7	9	0.00001
Mycobacterium marseillense	701042	S	1	0	1	0.00000
Mycobacterium gordonae	1778	S	13	0	13	0.00001
Mycobacterium paragordonae	1389713	S	10	0	10	0.00001
Mycobacterium kansasii	1768	S	10	0	10	0.00001
Mycobacterium gallinarum	39689	S	9	1	10	0.00001
Mycobacterium cookii	1775	S	9	0	9	0.00001
Mycobacterium noviomagense	459858	S	7	0	7	0.00000
Mycobacterium grossiae	1552759	S	7	1	8	0.00000
Mycobacterium branderi	43348	S	6	0	6	0.00000
Mycobacterium heckeshornense	110505	S	5	0	5	0.00000
Mycobacterium dioxanotrophicus	482462	S	5	0	5	0.00000
Mycobacterium riyadhense	486698	S	4	0	4	0.00000
Mycobacterium conspicuum	44010	S	4	0	4	0.00000
Mycobacterium haemophilum	29311	S	3	0	3	0.00000
Mycobacterium canettii	78331	S	1	2	3	0.00000
Mycobacterium shinjukuense	398694	S	3	0	3	0.00000
Mycobacterium xenopi	1789	S	2	0	2	0.00000
Mycobacterium basiliense	2094119	S	2	0	2	0.00000
Mycobacterium liflandii	261524	S	2	28	30	0.00002
Mycobacterium lacus	169765	S	2	0	2	0.00000
Mycobacterium marinum	1781	S	1	5	6	0.00000
Mycobacteroides salmoniphilum	404941	S	32	1	33	0.00002
Mycobacteroides abscessus	36809	S	11	6	17	0.00001
Mycobacteroides immunogenum	83262	S	8	1	9	0.00001
Mycobacteroides chelonae	1774	S	7	8	15	0.00001
[Mycobacterium] stephanolepidis	1520670	S	5	1	6	0.00000
Mycobacteroides saopaulense	1578165	S	4	0	4	0.00000
Mycolicibacter minnesotensis	1118379	S	7	0	7	0.00000
Mycolicibacter terrae	1788	S	5	0	5	0.00000
Mycolicibacter sinensis	875328	S	2	18	20	0.00001
Hoyosella subflava	639313	S	5	0	5	0.00000
Mycolicibacillus koreensis	1069220	S	3	0	3	0.00000
Rhodococcus sp. PBTS 1	1653478	S	19	2	21	0.00001
Rhodococcus sp. AQ5-07	2054902	S	8	20	28	0.00002
Rhodococcus sp. 008	1723645	S	8	32	40	0.00002
Rhodococcus sp. PBTS 2	1653479	S	8	4	12	0.00001
Rhodococcus sp. X156	2499145	S	7	0	7	0.00000
Rhodococcus sp. P-2	2795031	S	5	0	5	0.00000
Rhodococcus sp. B7740	1564114	S	5	0	5	0.00000
Rhodococcus sp. YL-1	1045808	S	4	12	16	0.00001
Rhodococcus sp. p52	935199	S	4	13	17	0.00001
Rhodococcus sp. P1Y	1302308	S	3	0	3	0.00000
Rhodococcus sp. R79	2811421	S	3	0	3	0.00000
Rhodococcus sp. WMMA185	679318	S	3	0	3	0.00000
Rhodococcus sp. ABRD24	2507582	S	3	0	3	0.00000
Rhodococcus sp. H-CA8f	1727214	S	2	6	8	0.00000
Rhodococcus sp. MTM3W5.2	1805827	S	2	0	2	0.00000
Rhodococcus sp. ZPP	2749906	S	2	4	6	0.00000
Rhodococcus sp. S2-17	1990687	S	2	3	5	0.00000
Rhodococcus sp. NJ-530	2490853	S	2	7	9	0.00001
Rhodococcus sp. SGAir0479	2567884	S	1	0	1	0.00000
Rhodococcus sp. W8901	2742603	S	1	0	1	0.00000
Rhodococcus sp. WAY2	2663121	S	1	0	1	0.00000
Rhodococcus sp. 21391	2683591	S	1	3	4	0.00000
Rhodococcus sp. BH4	1807790	S	1	3	4	0.00000
Rhodococcus sp. 2G	1570939	S	1	2	3	0.00000
Rhodococcus erythropolis	1833	S	50	136	186	0.00011
Rhodococcus qingshengii	334542	S	30	117	147	0.00009
Rhodococcus fascians	1828	S	13	1	14	0.00001
Rhodococcus rhodochrous	1829	S	9	2	11	0.00001
Rhodococcus opacus	37919	S	9	3	12	0.00001
Rhodococcus ruber	1830	S	7	1	8	0.00000
Rhodococcus jostii	132919	S	5	1	6	0.00000
Rhodococcus koreensis	99653	S	4	0	4	0.00000
Rhodococcus hoagii	43767	S	3	1	4	0.00000
Rhodococcus imtechensis	262776	S	2	5	7	0.00000
Rhodococcus aetherivorans	191292	S	1	9	10	0.00001
Rhodococcus triatomae	300028	S	1	0	1	0.00000
Nocardia brasiliensis	37326	S	16	2	18	0.00001
Nocardia terpenica	455432	S	12	1	13	0.00001
Nocardia seriolae	37332	S	9	2	11	0.00001
Nocardia yunnanensis	2382165	S	9	2	11	0.00001
Nocardia nova	37330	S	7	0	7	0.00000
Nocardia arthritidis	228602	S	7	0	7	0.00000
Nocardia farcinica	37329	S	6	2	8	0.00000
Nocardia cyriacigeorgica	135487	S	5	1	6	0.00000
Nocardia sp. CS682	1047172	S	4	0	4	0.00000
Nocardia sp. WCH-YHL-001	2755382	S	1	0	1	0.00000
Nocardia asteroides	1824	S	4	1	5	0.00000
Nocardia wallacei	480035	S	4	0	4	0.00000
Nocardia otitidiscaviarum	1823	S	3	0	3	0.00000
Nocardia mangyaensis	2213200	S	3	0	3	0.00000
Gordonia bronchialis	2054	S	223	33	256	0.00016
Gordonia polyisoprenivorans	84595	S	34	2	36	0.00002
Gordonia sp. PDNC005	2811424	S	6	0	6	0.00000
Gordonia sp. YC-JH1	2059875	S	5	4	9	0.00001
Gordonia sp. HY186	2597659	S	4	0	4	0.00000
Gordonia sp. 135	2676309	S	4	7	11	0.00001
Gordonia sp. KTR9	337191	S	3	0	3	0.00000
Gordonia sp. 1D	1737359	S	1	2	3	0.00000
Gordonia sp. JH63	2698900	S	1	1	2	0.00000
Gordonia insulae	2420509	S	13	1	14	0.00001
Gordonia rubripertincta	36822	S	11	5	16	0.00001
Gordonia terrae	2055	S	9	4	13	0.00001
Gordonia iterans	1004901	S	5	1	6	0.00000
Gordonia phthalatica	1136941	S	4	1	5	0.00000
Gordonia alkanivorans	84096	S	2	4	6	0.00000
Lawsonella clevelandensis	1528099	S	80	5	85	0.00005
Dietzia sp. oral taxon 368	712270	S	21	6	27	0.00002
Dietzia timorensis	499555	S	14	10	24	0.00001
Dietzia lutea	546160	S	9	1	10	0.00001
Dietzia psychralcaliphila	139021	S	5	0	5	0.00000
Tsukamurella paurometabola	2061	S	26	3	29	0.00002
Tsukamurella tyrosinosolvens	57704	S	16	5	21	0.00001
Tomitella sp. HY188	2597660	S	7	0	7	0.00000
Segniliparus rotundus	286802	S	2	0	2	0.00000
Candidatus Planktophila sulfonica	1884904	S	745	60	805	0.00049
Candidatus Planktophila dulcis	1884914	S	157	15	172	0.00011
Candidatus Planktophila lacus	1884913	S	147	4	151	0.00009
Candidatus Planktophila versatilis	1884905	S	69	3	72	0.00004
Candidatus Planktophila vernalis	1884907	S	65	1	66	0.00004
Candidatus Planktophila limnetica	573600	S	38	0	38	0.00002
Candidatus Nanopelagicus limnes	1884634	S	40	5	45	0.00003
Candidatus Nanopelagicus hibericus	1884915	S	13	0	13	0.00001
Candidatus Nanopelagicus abundans	1884916	S	11	0	11	0.00001
Streptomyces sp. So13.3	2136173	S	15	0	15	0.00001
Streptomyces sp. TLI_053	1855352	S	10	0	10	0.00001
Streptomyces sp. SUK 48	2582831	S	10	2	12	0.00001
Streptomyces sp. WAC 01438	2203204	S	9	0	9	0.00001
Streptomyces sp. 2323.1	1938841	S	9	0	9	0.00001
Streptomyces sp. SAT1	1849967	S	9	0	9	0.00001
Streptomyces sp. NHF165	2175864	S	8	0	8	0.00000
Streptomyces sp. QMT-12	2717324	S	7	0	7	0.00000
Streptomyces sp. RPA4-2	2721244	S	6	0	6	0.00000
Streptomyces sp. P3	2135430	S	6	0	6	0.00000
Streptomyces sp. GS7	2692234	S	6	0	6	0.00000
Streptomyces sp. SCSIO 3032	1264596	S	6	0	6	0.00000
Streptomyces sp. NA04227	2742136	S	6	0	6	0.00000
Streptomyces sp. CB00271	2750025	S	6	2	8	0.00000
Streptomyces sp. NEAU-sy36	2751189	S	6	0	6	0.00000
Streptomyces sp. M2	646637	S	6	0	6	0.00000
Streptomyces sp. CRXT-G-22	2768066	S	6	0	6	0.00000
Streptomyces sp. TN58	234612	S	6	0	6	0.00000
Streptomyces sp. MBT27	1488356	S	5	0	5	0.00000
Streptomyces sp. Z423-1	2730915	S	5	0	5	0.00000
Streptomyces sp. S063	2005885	S	5	1	6	0.00000
Streptomyces sp. SCUT-3	2684469	S	5	0	5	0.00000
Streptomyces sp. QHH-9511	2684468	S	5	0	5	0.00000
Streptomyces sp. 3214.6	1882757	S	5	0	5	0.00000
Streptomyces sp. NA02950	2742137	S	5	0	5	0.00000
Streptomyces sp. SM18	1736046	S	5	0	5	0.00000
Streptomyces sp. CdTB01	1725411	S	4	0	4	0.00000
Streptomyces sp. WAC 06738	2203210	S	4	1	5	0.00000
Streptomyces sp. S1A1-7	2594459	S	4	17	21	0.00001
Streptomyces sp. RLB1-33	2721243	S	4	0	4	0.00000
Streptomyces sp. CRPJ-33	2768068	S	4	0	4	0.00000
Streptomyces sp. CMB-StM0423	2059884	S	4	0	4	0.00000
Streptomyces sp. S8	1837283	S	4	1	5	0.00000
Streptomyces sp. CB01881	2078691	S	4	0	4	0.00000
Streptomyces sp. ID38640	1265399	S	4	1	5	0.00000
Streptomyces sp. ZYC-3	2797636	S	4	0	4	0.00000
Streptomyces sp. LBUM 1482	2609809	S	4	61	65	0.00004
Streptomyces sp. SirexAA-E	862751	S	4	0	4	0.00000
Streptomyces sp. SYP-A7193	2662065	S	4	0	4	0.00000
Streptomyces sp. Go-475	2072505	S	3	0	3	0.00000
Streptomyces sp. JB150	2714844	S	3	0	3	0.00000
Streptomyces sp. S4.7	2705439	S	3	0	3	0.00000
Streptomyces sp. NEAU-S7GS2	2202000	S	3	0	3	0.00000
Streptomyces sp. DSM 40868	2721173	S	3	0	3	0.00000
Streptomyces sp. SN-593	659352	S	3	0	3	0.00000
Streptomyces sp. INR7	2607753	S	3	0	3	0.00000
Streptomyces sp. CNQ-509	444103	S	3	1	4	0.00000
Streptomyces sp. jing01	2726118	S	3	0	3	0.00000
Streptomyces sp. CFMR 7	1649184	S	3	2	5	0.00000
Streptomyces sp. C8S0	2585716	S	3	0	3	0.00000
Streptomyces sp. CRXT-Y-14	2768069	S	2	0	2	0.00000
Streptomyces sp. FR-008	206662	S	2	4	6	0.00000
Streptomyces sp. RPA4-5	2721245	S	2	0	2	0.00000
Streptomyces sp. F2	317660	S	2	1	3	0.00000
Streptomyces sp. CB09001	2083284	S	2	0	2	0.00000
Streptomyces sp. Z022	1442032	S	2	0	2	0.00000
Streptomyces sp. 769	1262452	S	2	0	2	0.00000
Streptomyces sp. CCM_MD2014	1561022	S	2	0	2	0.00000
Streptomyces sp. Sge12	1972846	S	2	1	3	0.00000
Streptomyces sp. W1SF4	2305220	S	2	0	2	0.00000
Streptomyces sp. AgN23	1188315	S	2	0	2	0.00000
Streptomyces sp. HSG2	2797167	S	2	0	2	0.00000
Streptomyces sp. HM190	2695266	S	2	0	2	0.00000
Streptomyces sp. LBUM 1480	2609808	S	2	10	12	0.00001
Streptomyces sp. Tue 6075	1661694	S	2	0	2	0.00000
Streptomyces sp. fd1-xmd	1812480	S	2	0	2	0.00000
Streptomyces sp. Tu 2975	2676871	S	1	0	1	0.00000
Streptomyces sp. WAC 01529	2203205	S	1	0	1	0.00000
Streptomyces sp. RTd22	1841249	S	1	0	1	0.00000
Streptomyces sp. KPB2	2305221	S	1	2	3	0.00000
Streptomyces sp. S1D4-14	2594461	S	1	20	21	0.00001
Streptomyces sp. YIM 121038	2136401	S	1	0	1	0.00000
Streptomyces sp. CA-256286	2801033	S	1	3	4	0.00000
Streptomyces sp. XC 2026	2782004	S	1	0	1	0.00000
Streptomyces sp. Mg1	465541	S	1	0	1	0.00000
Streptomyces sp. 604F	1476754	S	1	2	3	0.00000
Streptomyces sp. ADI95-16	1522758	S	1	0	1	0.00000
Streptomyces sp. PBH53	1577075	S	1	0	1	0.00000
Streptomyces sp. MOE7	1961713	S	1	0	1	0.00000
Streptomyces sp. 3211	1964449	S	1	0	1	0.00000
Streptomyces sp. CLI2509	1984801	S	1	1	2	0.00000
Streptomyces sp. WAC00288	2094021	S	1	1	2	0.00000
Streptomyces sp. endophyte_N2	2153485	S	1	1	2	0.00000
Streptomyces lividans	1916	S	17	222	239	0.00015
Streptomyces spectabilis	68270	S	16	1	17	0.00001
Streptomyces venezuelae	54571	S	14	1	15	0.00001
Streptomyces lincolnensis	1915	S	13	0	13	0.00001
Streptomyces buecherae	2763006	S	11	0	11	0.00001
Streptomyces ambofaciens	1889	S	11	1	12	0.00001
Streptomyces ferrugineus	1413221	S	11	1	12	0.00001
Streptomyces tsukubensis	83656	S	9	0	9	0.00001
Streptomyces lydicus	47763	S	9	1	10	0.00001
Streptomyces harbinensis	1176198	S	9	0	9	0.00001
Streptomyces albus	1888	S	8	0	8	0.00000
Streptomyces griseochromogenes	68214	S	8	0	8	0.00000
Streptomyces asterosporus	285570	S	8	0	8	0.00000
Streptomyces xinghaiensis	1038928	S	8	0	8	0.00000
Streptomyces griseocarneus	51201	S	8	0	8	0.00000
Streptomyces bathyalis	2710756	S	8	0	8	0.00000
Streptomyces cattleya	29303	S	8	0	8	0.00000
Streptomyces exfoliatus	1905	S	8	0	8	0.00000
Streptomyces antibioticus	1890	S	7	0	7	0.00000
Streptomyces albireticuli	1940	S	7	0	7	0.00000
Streptomyces lunaelactis	1535768	S	7	0	7	0.00000
Streptomyces chartreusis	1969	S	7	0	7	0.00000
Streptomyces fagopyri	2662397	S	7	0	7	0.00000
Streptomyces pluripotens	1355015	S	7	0	7	0.00000
Streptomyces bingchenggensis	379067	S	7	0	7	0.00000
Streptomyces nodosus	40318	S	7	0	7	0.00000
Streptomyces luteoverticillatus	66425	S	7	0	7	0.00000
Streptomyces armeniacus	83291	S	7	0	7	0.00000
Streptomyces vietnamensis	362257	S	6	0	6	0.00000
Streptomyces glomeroaurantiacus	68210	S	6	0	6	0.00000
Streptomyces hygroscopicus	1912	S	6	0	6	0.00000
Streptomyces koyangensis	188770	S	6	2	8	0.00000
Streptomyces rutgersensis	53451	S	6	0	6	0.00000
Streptomyces davaonensis	348043	S	6	0	6	0.00000
Streptomyces paludis	2282738	S	6	0	6	0.00000
Streptomyces griseus	1911	S	3	0	3	0.00000
Streptomyces globisporus	1908	S	2	0	2	0.00000
Streptomyces anulatus	1892	S	1	0	1	0.00000
Streptomyces fodineus	1904616	S	5	0	5	0.00000
Streptomyces rapamycinicus	1226757	S	5	0	5	0.00000
Streptomyces alboflavus	67267	S	5	0	5	0.00000
Streptomyces griseorubiginosus	67304	S	5	0	5	0.00000
Streptomyces globosus	68209	S	5	0	5	0.00000
Streptomyces nigra	1827580	S	5	0	5	0.00000
Streptomyces capitiformicae	2014920	S	5	0	5	0.00000
Streptomyces pristinaespiralis	38300	S	5	0	5	0.00000
Streptomyces aquilus	2548456	S	5	0	5	0.00000
Streptomyces galilaeus	33899	S	5	0	5	0.00000
Streptomyces atratus	1893	S	5	0	5	0.00000
Streptomyces qinzhouensis	2599401	S	5	0	5	0.00000
Streptomyces vinaceus	1960	S	5	0	5	0.00000
Streptomyces peucetius	1950	S	5	0	5	0.00000
Streptomyces seoulensis	73044	S	5	0	5	0.00000
Streptomyces actuosus	1885	S	4	0	4	0.00000
Streptomyces cyaneogriseus	68192	S	4	1	5	0.00000
Streptomyces parvulus	146923	S	4	0	4	0.00000
Streptomyces pactum	68249	S	4	0	4	0.00000
Streptomyces gardneri	66892	S	4	0	4	0.00000
Streptomyces cacaoi	1898	S	4	0	4	0.00000
Streptomyces nojiriensis	66374	S	4	0	4	0.00000
Streptomyces leeuwenhoekii	1437453	S	4	0	4	0.00000
Streptomyces mobaraensis	35621	S	4	0	4	0.00000
Streptomyces rimosus	1927	S	4	0	4	0.00000
Streptomyces griseoviridis	45398	S	4	0	4	0.00000
Streptomyces cadmiisoli	2184053	S	4	0	4	0.00000
Streptomyces violaceusniger	68280	S	3	0	3	0.00000
Streptomyces incarnatus	665007	S	3	0	3	0.00000
Streptomyces albulus	68570	S	3	0	3	0.00000
Streptomyces broussonetiae	2686304	S	3	0	3	0.00000
Streptomyces alboniger	132473	S	3	0	3	0.00000
Streptomyces qaidamensis	1783515	S	3	0	3	0.00000
Streptomyces formicae	1616117	S	3	0	3	0.00000
Streptomyces niveus	193462	S	3	0	3	0.00000
Streptomyces albidoflavus	1886	S	3	4	7	0.00000
Streptomyces pratensis	1169025	S	3	0	3	0.00000
Streptomyces platensis	58346	S	3	0	3	0.00000
Streptomyces lavendulae	1914	S	3	0	3	0.00000
Streptomyces olivoreticuli	68246	S	3	0	3	0.00000
Streptomyces avermitilis	33903	S	3	0	3	0.00000
Streptomyces collinus	42684	S	3	0	3	0.00000
Streptomyces tuirus	68278	S	3	0	3	0.00000
Streptomyces tirandamycinicus	2174846	S	2	0	2	0.00000
Streptomyces clavuligerus	1901	S	2	0	2	0.00000
Streptomyces aureoverticillatus	66871	S	2	0	2	0.00000
Streptomyces viridifaciens	48665	S	2	10	12	0.00001
Streptomyces chromofuscus	42881	S	2	0	2	0.00000
Streptomyces roseochromogenus	285450	S	2	0	2	0.00000
Streptomyces xiamenensis	408015	S	2	0	2	0.00000
Streptomyces subrutilus	36818	S	2	0	2	0.00000
Streptomyces hundungensis	1077946	S	2	0	2	0.00000
Streptomyces nitrosporeus	28894	S	2	0	2	0.00000
Streptomyces phaeolivaceus	2653200	S	2	0	2	0.00000
Streptomyces cyanogenus	80860	S	2	0	2	0.00000
Streptomyces kanamyceticus	1967	S	2	0	2	0.00000
Streptomyces glaucescens	1907	S	2	0	2	0.00000
Streptomyces hawaiiensis	67305	S	2	0	2	0.00000
Streptomyces ficellus	1977088	S	1	0	1	0.00000
Streptomyces finlayi	67296	S	1	0	1	0.00000
Streptomyces dengpaensis	2049881	S	1	0	1	0.00000
Streptomyces cyaneochromogenes	2496836	S	1	0	1	0.00000
Streptomyces tendae	1932	S	1	0	1	0.00000
Streptomyces fungicidicus	68203	S	1	1	2	0.00000
Streptomyces gilvosporeus	553510	S	1	0	1	0.00000
Streptomyces prasinus	67345	S	1	0	1	0.00000
Streptomyces rectiverticillatus	173860	S	1	0	1	0.00000
Streptomyces katrae	68223	S	1	0	1	0.00000
Kitasatospora albolonga	68173	S	19	8	27	0.00002
Kitasatospora sp. NA04385	2742135	S	10	1	11	0.00001
Kitasatospora sp. MMS16-BH015	2018025	S	9	0	9	0.00001
Kitasatospora setae	2066	S	5	0	5	0.00000
Kitasatospora aureofaciens	1894	S	1	6	7	0.00000
Streptacidiphilus sp. P02-A3a	2704468	S	9	1	10	0.00001
Streptacidiphilus sp. PB12-B1b	2705012	S	6	1	7	0.00000
Streptacidiphilus bronchialis	2126346	S	3	0	3	0.00000
Micromonospora sp. HM134	2583243	S	10	3	13	0.00001
Micromonospora sp. B006	2201999	S	8	6	14	0.00001
Micromonospora sp. WMMC415	2675222	S	6	1	7	0.00000
Micromonospora sp. 28ISP2-46	2749844	S	5	2	7	0.00000
Micromonospora sp. WMMA2032	2039870	S	2	1	3	0.00000
Micromonospora zamorensis	709883	S	12	2	14	0.00001
Micromonospora purpureochromogenes	47872	S	11	4	15	0.00001
Micromonospora inositola	47865	S	11	4	15	0.00001
Micromonospora echinaurantiaca	47857	S	10	3	13	0.00001
Micromonospora rifamycinica	291594	S	7	2	9	0.00001
Micromonospora chokoriensis	356851	S	7	1	8	0.00000
Micromonospora echinospora	1877	S	5	1	6	0.00000
Micromonospora narathiwatensis	299146	S	5	1	6	0.00000
Micromonospora carbonacea	47853	S	5	1	6	0.00000
Micromonospora sagamiensis	47875	S	4	1	5	0.00000
Micromonospora siamensis	299152	S	4	1	5	0.00000
Micromonospora tulbaghiae	479978	S	4	4	8	0.00000
Micromonospora terminaliae	1914461	S	4	1	5	0.00000
Micromonospora viridifaciens	1881	S	3	0	3	0.00000
Micromonospora auratinigra	261654	S	3	1	4	0.00000
Micromonospora coriariae	285665	S	3	0	3	0.00000
Micromonospora echinofusca	47858	S	3	0	3	0.00000
Micromonospora coxensis	356852	S	2	0	2	0.00000
Micromonospora aurantiaca	47850	S	2	16	18	0.00001
Micromonospora krabiensis	307121	S	1	0	1	0.00000
Actinoplanes derwentensis	113562	S	60	6	66	0.00004
Actinoplanes sp. N902-109	649831	S	16	9	25	0.00002
Actinoplanes sp. OR16	946334	S	15	17	32	0.00002
Actinoplanes teichomyceticus	1867	S	17	5	22	0.00001
Actinoplanes missouriensis	1866	S	5	1	6	0.00000
Actinoplanes friuliensis	196914	S	4	0	4	0.00000
Phytohabitans flavus	1076124	S	16	1	17	0.00001
Phytohabitans suffuscus	624315	S	8	1	9	0.00001
Actinocatenispora thailandica	227318	S	15	0	15	0.00001
Plantactinospora sp. KBS50	2024580	S	5	0	5	0.00000
Plantactinospora sp. BC1	2108470	S	2	6	8	0.00000
Salinispora arenicola	168697	S	5	0	5	0.00000
Salinispora tropica	168695	S	3	0	3	0.00000
Verrucosispora sp. NA02020	2742132	S	4	2	6	0.00000
Bifidobacterium adolescentis	1680	S	123	7	130	0.00008
Bifidobacterium longum	216816	S	84	19	103	0.00006
Bifidobacterium catenulatum	1686	S	26	4	30	0.00002
Bifidobacterium pseudocatenulatum	28026	S	26	8	34	0.00002
Bifidobacterium breve	1685	S	13	15	28	0.00002
Bifidobacterium bifidum	1681	S	12	0	12	0.00001
Bifidobacterium subtile	77635	S	7	0	7	0.00000
Bifidobacterium dentium	1689	S	5	0	5	0.00000
Bifidobacterium choerinum	35760	S	5	0	5	0.00000
Bifidobacterium pullorum	78448	S	4	0	4	0.00000
Bifidobacterium scardovii	158787	S	3	0	3	0.00000
Bifidobacterium angulatum	1683	S	2	0	2	0.00000
Bifidobacterium imperatoris	2020965	S	2	0	2	0.00000
Bifidobacterium saguini	762210	S	1	0	1	0.00000
Bifidobacterium lemurum	1603886	S	1	0	1	0.00000
Bifidobacterium animalis	28025	S	1	0	1	0.00000
Bifidobacterium pseudolongum	1694	S	1	0	1	0.00000
Gardnerella vaginalis	2702	S	9	0	9	0.00001
Gardnerella leopoldii	2792978	S	1	0	1	0.00000
Parascardovia denticolens	78258	S	2	0	2	0.00000
Scardovia inopinata	78259	S	1	0	1	0.00000
Amycolatopsis sp. FDAARGOS 1241	2778070	S	18	1	19	0.00001
Amycolatopsis sp. AA4	1896961	S	15	1	16	0.00001
Amycolatopsis sp. Hca4	2742131	S	13	1	14	0.00001
Amycolatopsis sp. YIM 10	2653857	S	8	1	9	0.00001
Amycolatopsis sp. BJA-103	1911175	S	1	0	1	0.00000
Amycolatopsis mediterranei	33910	S	15	0	15	0.00001
Amycolatopsis orientalis	31958	S	14	2	16	0.00001
Amycolatopsis methanolica	1814	S	11	1	12	0.00001
Amycolatopsis keratiniphila	129921	S	6	3	9	0.00001
Amycolatopsis albispora	1804986	S	5	1	6	0.00000
Amycolatopsis japonica	208439	S	3	2	5	0.00000
Pseudonocardia sp. AL041005-10	445576	S	8	2	10	0.00001
Pseudonocardia sp. CGMCC 4.1532	2761535	S	8	1	9	0.00001
Pseudonocardia sp. HH130629-09	1641402	S	6	4	10	0.00001
Pseudonocardia sp. HH130630-07	1690815	S	3	1	4	0.00000
Pseudonocardia dioxanivorans	240495	S	11	1	12	0.00001
Pseudonocardia broussonetiae	2736640	S	10	1	11	0.00001
Pseudonocardia autotrophica	2074	S	5	1	6	0.00000
Saccharopolyspora erythraea	1836	S	12	1	13	0.00001
Saccharopolyspora sp. ASAGF58	2719023	S	8	4	12	0.00001
Saccharopolyspora spinosa	60894	S	6	1	7	0.00000
Saccharopolyspora pogona	333966	S	6	3	9	0.00001
Saccharopolyspora coralli	2665642	S	3	0	3	0.00000
Saccharothrix espanaensis	103731	S	10	1	11	0.00001
Saccharothrix sp. 6-C	2781735	S	6	0	6	0.00000
Saccharothrix syringae	103733	S	4	0	4	0.00000
Kibdelosporangium phytohabitans	860235	S	17	0	17	0.00001
Saccharomonospora xinjiangensis	75294	S	5	0	5	0.00000
Saccharomonospora viridis	1852	S	4	0	4	0.00000
Saccharomonospora glauca	40990	S	4	0	4	0.00000
Saccharomonospora marina	632569	S	3	0	3	0.00000
Lentzea guizhouensis	1586287	S	14	1	15	0.00001
Actinoalloteichus hoggarensis	1470176	S	7	0	7	0.00000
Actinoalloteichus hymeniacidonis	340345	S	3	0	3	0.00000
Actinoalloteichus fjordicus	1612552	S	1	2	3	0.00000
Actinosynnema pretiosum	42197	S	4	7	11	0.00001
Allokutzneria albata	211114	S	8	0	8	0.00000
Kutzneria albida	43357	S	6	0	6	0.00000
Prauserella marina	530584	S	6	0	6	0.00000
Actinomyces sp. oral taxon 414	712122	S	6	0	6	0.00000
Actinomyces sp. Z16	2079536	S	6	0	6	0.00000
Actinomyces sp. oral taxon 169	712116	S	5	2	7	0.00000
Actinomyces sp. 432	2057798	S	4	0	4	0.00000
Actinomyces sp. ZJ34	2722820	S	3	0	3	0.00000
Actinomyces sp. oral taxon 171	706438	S	2	0	2	0.00000
Actinomyces sp. Chiba101	1851395	S	2	0	2	0.00000
Actinomyces sp. oral taxon 897	2081702	S	2	0	2	0.00000
Actinomyces sp. zg-332	2708340	S	2	0	2	0.00000
Actinomyces sp. ZJ750	2744574	S	2	0	2	0.00000
Actinomyces sp. zg-993	2763540	S	2	0	2	0.00000
Actinomyces sp. HMT897	2789424	S	1	0	1	0.00000
Actinomyces oris	544580	S	24	19	43	0.00003
Actinomyces radicidentis	111015	S	6	1	7	0.00000
Actinomyces naeslundii	1655	S	5	1	6	0.00000
Actinomyces gaoshouyii	1960083	S	5	0	5	0.00000
Actinomyces slackii	52774	S	4	0	4	0.00000
Actinomyces weissii	675090	S	4	0	4	0.00000
Actinomyces qiguomingii	2057800	S	4	0	4	0.00000
Actinomyces viscosus	1656	S	3	0	3	0.00000
Actinomyces lilanjuaniae	2321394	S	3	0	3	0.00000
Actinomyces howellii	52771	S	2	0	2	0.00000
Actinomyces wuliandei	2057743	S	2	0	2	0.00000
Actinomyces israelii	1659	S	1	0	1	0.00000
Actinomyces procaprae	2560010	S	1	0	1	0.00000
Actinomyces marmotae	2737173	S	1	0	1	0.00000
Schaalia sp. JY-X169	2758572	S	71	0	71	0.00004
Schaalia sp. ZJ405	2709403	S	5	0	5	0.00000
Schaalia odontolytica	1660	S	10	1	11	0.00001
Schaalia cardiffensis	181487	S	2	0	2	0.00000
Flaviflexus salsibiostraticola	1282737	S	7	0	7	0.00000
Flaviflexus sp. H23T48	2496867	S	2	0	2	0.00000
Flaviflexus sp. dk850	2758573	S	2	0	2	0.00000
Arcanobacterium haemolyticum	28264	S	3	0	3	0.00000
Arcanobacterium phocae	131112	S	3	0	3	0.00000
Arcanobacterium phocisimile	1302235	S	1	0	1	0.00000
Trueperella sp. 19M2397	2733571	S	2	3	5	0.00000
Trueperella pyogenes	1661	S	1	0	1	0.00000
Mobiluncus curtisii	2051	S	5	0	5	0.00000
Actinobaculum sp. 313	2495645	S	2	0	2	0.00000
Pauljensenia hongkongensis	178339	S	2	0	2	0.00000
Actinotignum schaalii	59505	S	1	0	1	0.00000
Fannyhessea vaginae	82135	S	1	0	1	0.00000
Nonomuraea sp. ATCC 55076	1909395	S	19	2	21	0.00001
Nonomuraea nitratireducens	2656914	S	18	1	19	0.00001
Streptosporangium roseum	2001	S	8	1	9	0.00001
Streptosporangium sp. 'caverna'	2202249	S	5	0	5	0.00000
Thermobispora bispora	2006	S	8	0	8	0.00000
Actinomadura sp. WMMB 499	1219491	S	8	1	9	0.00001
Actinomadura sp. NAK00032	2742128	S	6	1	7	0.00000
Actinomadura sp. WMMA1423	2591108	S	3	0	3	0.00000
Actinomadura verrucosospora	46165	S	11	3	14	0.00001
Thermomonospora curvata	2020	S	9	1	10	0.00001
Nocardiopsis gilva	280236	S	7	0	7	0.00000
Nocardiopsis dassonvillei	2014	S	5	0	5	0.00000
Nocardiopsis alba	53437	S	5	0	5	0.00000
Thermobifida fusca	2021	S	6	0	6	0.00000
Streptomonospora sp. M2	2498135	S	4	0	4	0.00000
Geodermatophilus obscurus	1861	S	16	1	17	0.00001
Blastococcus saxobsidens	138336	S	13	0	13	0.00001
Modestobacter marinus	477641	S	10	0	10	0.00001
Frankia sp. EAN1pec	298653	S	10	1	11	0.00001
Frankia sp. QA3	710111	S	2	1	3	0.00000
Frankia inefficax	298654	S	8	0	8	0.00000
Frankia alni	1859	S	6	2	8	0.00000
Frankia casuarinae	106370	S	2	0	2	0.00000
Candidatus Frankia datiscae	2716812	S	2	0	2	0.00000
Nakamurella multipartita	53461	S	12	0	12	0.00001
Nakamurella sp. PAMC28650	2762325	S	9	0	9	0.00001
Nakamurella sp. s14-144	1902245	S	1	0	1	0.00000
Nakamurella panacisegetis	1090615	S	6	0	6	0.00000
Jiangella alkaliphila	419479	S	15	0	15	0.00001
Jiangella sp. DSM 45060	1798224	S	11	0	11	0.00001
Catenulispora acidiphila	304895	S	10	0	10	0.00001
Kineococcus radiotolerans	131568	S	7	0	7	0.00000
Jatrophihabitans sp. GAS493	1907575	S	6	0	6	0.00000
Epidermidibacterium keratini	1891644	S	4	0	4	0.00000
Stackebrandtia nassauensis	283811	S	4	0	4	0.00000
Acidothermus cellulolyticus	28049	S	3	0	3	0.00000
Actinopolyspora erythraea	414996	S	2	0	2	0.00000
Collinsella aerofaciens	74426	S	135	11	146	0.00009
Coriobacterium glomerans	33871	S	3	0	3	0.00000
Olsenella sp. GAM18	2109685	S	5	0	5	0.00000
Olsenella sp. oral taxon 807	712411	S	3	0	3	0.00000
Olsenella sp. LZLJ-2	2779519	S	1	0	1	0.00000
Olsenella uli	133926	S	4	0	4	0.00000
Olsenella timonensis	1805478	S	3	0	3	0.00000
Olsenella umbonata	604330	S	2	0	2	0.00000
Parolsenella catena	2003188	S	5	1	6	0.00000
Parolsenella massiliensis	1871022	S	3	0	3	0.00000
Lancefieldella parvula	1382	S	2	0	2	0.00000
Adlercreutzia sp. 8CFCBH1	2707299	S	7	8	15	0.00001
Adlercreutzia equolifaciens	446660	S	3	0	3	0.00000
Eggerthella lenta	84112	S	11	4	15	0.00001
Eggerthella sp. HF-1101	2690837	S	2	0	2	0.00000
Arabia massiliensis	1870985	S	12	0	12	0.00001
Gordonibacter pamelaeae	471189	S	7	3	10	0.00001
Gordonibacter urolithinfaciens	1335613	S	2	0	2	0.00000
Slackia heliotrinireducens	84110	S	9	0	9	0.00001
Berryella intestinalis	1531429	S	7	3	10	0.00001
Denitrobacterium detoxificans	79604	S	6	1	7	0.00000
Cryptobacterium curtum	84163	S	1	0	1	0.00000
Phoenicibacter congonensis	1944646	S	1	0	1	0.00000
Ilumatobacter coccineus	467094	S	31	0	31	0.00002
Actinomarinicola tropica	2789776	S	18	0	18	0.00001
Acidimicrobium ferrooxidans	53635	S	1	0	1	0.00000
Rubrobacter sp. SCSIO 52909	2653851	S	6	1	7	0.00000
Rubrobacter sp. SCSIO 52915	2653852	S	5	1	6	0.00000
Rubrobacter xylanophilus	49319	S	6	0	6	0.00000
Rubrobacter indicoceani	2051957	S	3	1	4	0.00000
Rubrobacter radiotolerans	42256	S	2	1	3	0.00000
Baekduia soli	496014	S	18	0	18	0.00001
Conexibacter sp. SYSU D00693	2812560	S	14	0	14	0.00001
Conexibacter woesei	191495	S	11	0	11	0.00001
Egibacter rhizosphaerae	1670831	S	7	0	7	0.00000
Euzebya sp. DY32-46	1608957	S	3	0	3	0.00000
Egicoccus halophilus	1670830	S	3	0	3	0.00000
Blautia sp. SC05B48	2479767	S	269	76	345	0.00021
Blautia sp. LZLJ-3	2779518	S	5	0	5	0.00000
Blautia obeum	40520	S	120	32	152	0.00009
Blautia hansenii	1322	S	30	12	42	0.00003
Blautia producta	33035	S	30	29	59	0.00004
Blautia argi	1912897	S	17	2	19	0.00001
Anaerostipes hadrus	649756	S	241	35	276	0.00017
Anaerostipes caccae	105841	S	4	0	4	0.00000
Anaerostipes rhamnosivorans	1229621	S	2	0	2	0.00000
[Ruminococcus] torques	33039	S	116	34	150	0.00009
[Ruminococcus] gnavus	33038	S	106	52	158	0.00010
Coprococcus comes	410072	S	86	22	108	0.00007
Coprococcus catus	116085	S	68	12	80	0.00005
Coprococcus sp. ART55/1	751585	S	44	6	50	0.00003
Anaerobutyricum hallii	39488	S	177	48	225	0.00014
Roseburia intestinalis	166486	S	129	26	155	0.00009
Roseburia hominis	301301	S	28	6	34	0.00002
Enterocloster bolteae	208479	S	47	4	51	0.00003
Enterocloster clostridioformis	1531	S	7	14	21	0.00001
[Clostridium] scindens	29347	S	25	3	28	0.00002
Lachnoclostridium sp. YL32	1834196	S	10	15	25	0.00002
Lachnoclostridium phocaeense	1871021	S	7	1	8	0.00000
Lachnoclostridium phytofermentans	66219	S	4	0	4	0.00000
[Clostridium] hylemonae	89153	S	3	0	3	0.00000
Lachnospira eligens	39485	S	43	2	45	0.00003
Lacrimispora saccharolytica	84030	S	15	3	18	0.00001
Lacrimispora sphenoides	29370	S	2	0	2	0.00000
Anaerocolumna cellulosilytica	433286	S	9	0	9	0.00001
Anaerocolumna sedimenticola	2696063	S	7	0	7	0.00000
Anaerocolumna sp. CTTW	2736602	S	2	0	2	0.00000
Butyrivibrio fibrisolvens	831	S	8	0	8	0.00000
Butyrivibrio hungatei	185008	S	3	0	3	0.00000
Butyrivibrio proteoclasticus	43305	S	1	0	1	0.00000
Cellulosilyticum lentocellum	29360	S	5	0	5	0.00000
Cellulosilyticum sp. WCF-2	2497860	S	5	0	5	0.00000
Herbinix luporum	1679721	S	5	0	5	0.00000
Anaerotignum propionicum	28446	S	3	0	3	0.00000
Lachnoanaerobaculum umeaense	617123	S	1	0	1	0.00000
Pseudobutyrivibrio xylanivorans	185007	S	1	0	1	0.00000
Clostridium botulinum	1491	S	81	29	110	0.00007
Clostridium sp. DL-VIII	641107	S	27	1	28	0.00002
Clostridium sp. JN-1	2483110	S	6	0	6	0.00000
Clostridium sp. JN-9	2507159	S	6	0	6	0.00000
Clostridium sp. SY8519	1042156	S	5	0	5	0.00000
Clostridium sp. CT4	2320868	S	4	0	4	0.00000
Clostridium sp. BNL1100	755731	S	2	0	2	0.00000
Clostridium sp. 'deep sea'	2779445	S	2	0	2	0.00000
Clostridium saccharobutylicum	169679	S	30	1	31	0.00002
Clostridium saccharoperbutylacetonicum	36745	S	21	0	21	0.00001
Clostridium butyricum	1492	S	16	0	16	0.00001
Clostridium perfringens	1502	S	16	0	16	0.00001
Clostridium beijerinckii	1520	S	16	15	31	0.00002
Clostridium aceticum	84022	S	12	0	12	0.00001
Clostridium taeniosporum	394958	S	11	0	11	0.00001
Clostridium estertheticum	238834	S	10	0	10	0.00001
Clostridium tyrobutyricum	1519	S	9	0	9	0.00001
Clostridium baratii	1561	S	9	0	9	0.00001
Clostridium kluyveri	1534	S	9	0	9	0.00001
Clostridium pasteurianum	1501	S	9	0	9	0.00001
Clostridium intestinale	36845	S	8	0	8	0.00000
Clostridium carboxidivorans	217159	S	5	0	5	0.00000
Clostridium formicaceticum	1497	S	5	0	5	0.00000
Clostridium fermenticellae	2068654	S	5	0	5	0.00000
Clostridium cellulovorans	1493	S	4	0	4	0.00000
Clostridium bornimense	1216932	S	4	0	4	0.00000
Clostridium chauvoei	46867	S	4	0	4	0.00000
Clostridium argentinense	29341	S	4	0	4	0.00000
Clostridium scatologenes	1548	S	3	1	4	0.00000
Clostridium tetani	1513	S	3	0	3	0.00000
Clostridium sporogenes	1509	S	3	10	13	0.00001
Clostridium acetobutylicum	1488	S	3	0	3	0.00000
Clostridium gasigenes	94869	S	2	0	2	0.00000
Clostridium isatidis	182773	S	2	0	2	0.00000
Clostridium ljungdahlii	1538	S	2	7	9	0.00001
Clostridium septicum	1504	S	2	0	2	0.00000
Clostridium cochlearium	1494	S	2	0	2	0.00000
Clostridium novyi	1542	S	1	4	5	0.00000
Clostridium diolis	223919	S	1	7	8	0.00000
Crassaminicella sp. SY095	2599308	S	13	0	13	0.00001
Hungatella hathewayi	154046	S	11	0	11	0.00001
Candidatus Arthromitus sp. SFB-rat-Yit	1041504	S	1	9	10	0.00001
Caloranaerobacter azorensis	116090	S	6	0	6	0.00000
Sarcina sp. JB2	2726954	S	4	0	4	0.00000
Alkaliphilus oremlandii	461876	S	3	0	3	0.00000
Alkaliphilus metalliredigens	208226	S	1	0	1	0.00000
Caloramator sp. E03	2576307	S	2	0	2	0.00000
Geosporobacter ferrireducens	1424294	S	1	0	1	0.00000
Hathewaya histolytica	1498	S	1	0	1	0.00000
Faecalibacterium prausnitzii	853	S	249	36	285	0.00017
Ruminococcus bicirculans	1160721	S	38	0	38	0.00002
Ruminococcus sp. JE7A12	2564099	S	8	0	8	0.00000
Ruminococcus champanellensis	1161942	S	7	0	7	0.00000
Ruminococcus albus	1264	S	6	0	6	0.00000
Ruthenibacterium lactatiformans	1550024	S	18	0	18	0.00001
Oscillibacter sp. PEA192	2109687	S	7	6	13	0.00001
Oscillibacter sp. NSJ-62	2763056	S	4	0	4	0.00000
Oscillibacter valericigenes	351091	S	5	0	5	0.00000
Flavonifractor plautii	292800	S	14	0	14	0.00001
Dysosmobacter welbionis	2093857	S	13	10	23	0.00001
Acutalibacter muris	1796620	S	12	0	12	0.00001
Acetivibrio saccincola	1677857	S	4	0	4	0.00000
Acetivibrio clariflavus	288965	S	3	0	3	0.00000
Acetivibrio thermocellus	1515	S	2	-2	0	0.00000
Caproiciproducens sp. NJN-50	2507162	S	5	0	5	0.00000
Caproiciproducens sp. 7D4C2	2721621	S	2	0	2	0.00000
Ruminiclostridium cellulolyticum	1521	S	3	0	3	0.00000
Ruminiclostridium herbifermentans	2488810	S	1	0	1	0.00000
Mageeibacillus indolicus	884684	S	3	0	3	0.00000
Pseudoclostridium thermosuccinogenes	84032	S	3	0	3	0.00000
Thermoclostridium stercorarium	1510	S	1	-1	0	0.00000
Clostridioides difficile	1496	S	44	921	965	0.00059
Romboutsia ilealis	1115758	S	16	1	17	0.00001
Romboutsia sp. CE17	2724150	S	3	0	3	0.00000
Romboutsia hominis	1507512	S	2	0	2	0.00000
Acetoanaerobium sticklandii	1511	S	8	0	8	0.00000
Paraclostridium bifermentans	1490	S	7	0	7	0.00000
Paeniclostridium sordellii	1505	S	4	0	4	0.00000
Peptacetobacter hiranonis	89152	S	4	0	4	0.00000
Peptoclostridium acidaminophilum	1731	S	2	0	2	0.00000
Filifactor alocis	143361	S	1	0	1	0.00000
Desulfosporosinus youngiae	339862	S	8	0	8	0.00000
Desulfosporosinus orientis	1563	S	5	0	5	0.00000
Desulfosporosinus meridiei	79209	S	3	0	3	0.00000
Desulfosporosinus acidiphilus	885581	S	2	0	2	0.00000
Desulfitobacterium metallireducens	142877	S	6	0	6	0.00000
Desulfitobacterium dehalogenans	36854	S	2	0	2	0.00000
Desulfitobacterium hafniense	49338	S	2	0	2	0.00000
Desulfotomaculum nigrificans	1565	S	2	0	2	0.00000
Desulfotomaculum ruminis	1564	S	1	0	1	0.00000
Desulfotomaculum reducens	59610	S	1	0	1	0.00000
Desulfotomaculum ferrireducens	1833852	S	1	0	1	0.00000
Dehalobacterium formicoaceticum	51515	S	4	0	4	0.00000
Candidatus Desulforudis audaxviator	471827	S	3	0	3	0.00000
Thermoanaerosceptrum fracticalcis	1712410	S	2	0	2	0.00000
Desulfallas gibsoniae	102134	S	1	0	1	0.00000
Mogibacterium diversum	114527	S	5	1	6	0.00000
Aminipila sp. CBA3637	2697030	S	2	2	4	0.00000
Aminipila butyrica	433296	S	2	0	2	0.00000
Flintibacter sp. KGMB00164	2610895	S	9	0	9	0.00001
Massilistercora timonensis	2086584	S	9	1	10	0.00001
Thermaerobacter sp. PB12/4term	2293838	S	2	2	4	0.00000
Thermaerobacter marianensis	73919	S	1	0	1	0.00000
Monoglobus pectinilyticus	1981510	S	5	0	5	0.00000
Intestinimonas butyriciproducens	1297617	S	4	0	4	0.00000
Carboxydocella thermautotrophica	178899	S	3	0	3	0.00000
Acetobacterium sp. KB-1	2184575	S	20	4	24	0.00001
Acetobacterium woodii	33952	S	3	0	3	0.00000
Eubacterium sp. NSJ-61	2764325	S	5	1	6	0.00000
[Eubacterium] cellulosolvens	29322	S	1	0	1	0.00000
Christensenella minuta	626937	S	11	0	11	0.00001
Christensenella sp. Marseille-P3954	2086585	S	3	0	3	0.00000
Petrocella atlantisensis	2173034	S	10	0	10	0.00001
Candidatus Syntrophocurvum alkaliphilum	2293317	S	5	0	5	0.00000
Syntrophomonas wolfei	863	S	2	0	2	0.00000
Symbiobacterium thermophilum	2734	S	5	0	5	0.00000
Heliobacterium modesticaldum	35701	S	1	0	1	0.00000
Thermoanaerobacterium thermosaccharolyticum	1517	S	7	1	8	0.00000
Thermoanaerobacterium aotearoense	47490	S	2	0	2	0.00000
Thermoanaerobacterium sp. RBIITD	1550240	S	2	0	2	0.00000
Caldicellulosiruptor bescii	31899	S	1	2	3	0.00000
Caldicellulosiruptor obsidiansis	717609	S	1	0	1	0.00000
Caldicellulosiruptor changbaiensis	1222016	S	1	1	2	0.00000
Thermoanaerobacter brockii	29323	S	1	2	3	0.00000
Moorella glycerini	55779	S	2	0	2	0.00000
Moorella thermoacetica	1525	S	1	0	1	0.00000
Carboxydothermus hydrogenoformans	129958	S	2	0	2	0.00000
Caldanaerobacter subterraneus	911092	S	2	0	2	0.00000
Thermanaeromonas toyohensis	161154	S	1	0	1	0.00000
Thermodesulfobium acidiphilum	1794699	S	3	1	4	0.00000
Thermodesulfobium narugense	184064	S	2	0	2	0.00000
Mahella australiensis	252966	S	1	0	1	0.00000
Halanaerobium praevalens	2331	S	8	0	8	0.00000
Halothermothrix orenii	31909	S	3	0	3	0.00000
Halocella sp. SP3-1	2382161	S	1	0	1	0.00000
Halobacteroides halobius	42422	S	5	0	5	0.00000
Acetohalobium arabaticum	28187	S	2	0	2	0.00000
Anoxybacter fermentans	1323375	S	5	0	5	0.00000
Biomaibacter acetigenes	2316383	S	1	0	1	0.00000
Thermosediminibacter oceani	291990	S	1	0	1	0.00000
Natranaerobius thermophilus	375929	S	2	0	2	0.00000
Staphylococcus capitis	29388	S	133	19	152	0.00009
Staphylococcus epidermidis	1282	S	112	25	137	0.00008
Staphylococcus aureus	1280	S	51	112	163	0.00010
Staphylococcus hominis	1290	S	48	6	54	0.00003
Staphylococcus lugdunensis	28035	S	24	1	25	0.00002
Staphylococcus warneri	1292	S	11	4	15	0.00001
Staphylococcus pasteuri	45972	S	8	0	8	0.00000
Staphylococcus cohnii	29382	S	6	1	7	0.00000
Staphylococcus equorum	246432	S	5	3	8	0.00000
Staphylococcus sp. MI 10-1553	1912064	S	1	1	2	0.00000
Staphylococcus sp. 17KM0847	2583989	S	1	0	1	0.00000
Staphylococcus auricularis	29379	S	4	0	4	0.00000
Staphylococcus haemolyticus	1283	S	4	0	4	0.00000
Staphylococcus saprophyticus	29385	S	3	0	3	0.00000
Staphylococcus simiae	308354	S	2	0	2	0.00000
Staphylococcus xylosus	1288	S	2	0	2	0.00000
Staphylococcus pettenkoferi	170573	S	2	0	2	0.00000
Staphylococcus chromogenes	46126	S	2	0	2	0.00000
Staphylococcus succinus	61015	S	2	0	2	0.00000
Staphylococcus agnetis	985762	S	1	0	1	0.00000
Staphylococcus schweitzeri	1654388	S	1	0	1	0.00000
Staphylococcus debuckii	2044912	S	1	0	1	0.00000
Staphylococcus nepalensis	214473	S	1	0	1	0.00000
Staphylococcus lloydii	2781774	S	1	0	1	0.00000
Staphylococcus lutrae	155085	S	1	0	1	0.00000
Staphylococcus pseudintermedius	283734	S	1	0	1	0.00000
Staphylococcus felis	46127	S	1	0	1	0.00000
Staphylococcus saccharolyticus	33028	S	1	0	1	0.00000
Staphylococcus kloosii	29384	S	1	0	1	0.00000
Staphylococcus hyicus	1284	S	1	0	1	0.00000
Mammaliicoccus sciuri	1296	S	11	1	12	0.00001
Mammaliicoccus stepanovicii	643214	S	5	0	5	0.00000
Mammaliicoccus vitulinus	71237	S	2	0	2	0.00000
Mammaliicoccus fleurettii	150056	S	1	0	1	0.00000
Jeotgalicoccus saudimassiliensis	1461582	S	5	0	5	0.00000
[Micrococcus] candicans	946432	S	2	0	2	0.00000
Macrococcus canis	1855823	S	2	1	3	0.00000
Macrococcus caseolyticus	69966	S	1	1	2	0.00000
Bacillus sp. M4U3P1	2592382	S	15	0	15	0.00001
Bacillus sp. THAF10	2587848	S	11	0	11	0.00001
Bacillus sp. HD4P25	2779776	S	11	0	11	0.00001
Bacillus sp. Cs-700	2589818	S	7	1	8	0.00000
Bacillus sp. S3	486398	S	6	0	6	0.00000
Bacillus sp. KH172YL63	2709784	S	3	0	3	0.00000
Bacillus sp. ms-22	2683680	S	3	0	3	0.00000
Bacillus sp. N1-1	2682541	S	3	0	3	0.00000
Bacillus sp. Y1	352858	S	3	0	3	0.00000
Bacillus sp. FJAT-45348	2011012	S	2	0	2	0.00000
Bacillus sp. FJAT-18017	1705566	S	2	0	2	0.00000
Bacillus sp. CS13	2728853	S	2	0	2	0.00000
Bacillus sp. X1(2014)	1565991	S	1	0	1	0.00000
Bacillus sp. NSP9.1	1071078	S	1	0	1	0.00000
Bacillus cereus	1396	S	24	485	509	0.00031
Bacillus pseudomycoides	64104	S	9	0	9	0.00001
Bacillus thuringiensis	1428	S	6	2	8	0.00000
Bacillus mycoides	1405	S	4	0	4	0.00000
Bacillus cytotoxicus	580165	S	4	0	4	0.00000
Bacillus albus	2026189	S	3	0	3	0.00000
Bacillus luti	2026191	S	2	0	2	0.00000
Bacillus paranthracis	2026186	S	1	2	3	0.00000
Bacillus mobilis	2026190	S	1	0	1	0.00000
Bacillus velezensis	492670	S	4	9	13	0.00001
Bacillus amyloliquefaciens	1390	S	1	2	3	0.00000
Bacillus subtilis	1423	S	4	39	43	0.00003
Bacillus paralicheniformis	1648923	S	4	0	4	0.00000
Bacillus atrophaeus	1452	S	1	0	1	0.00000
Bacillus vallismortis	72361	S	1	0	1	0.00000
Bacillus sonorensis	119858	S	1	0	1	0.00000
Bacillus cellulosilyticus	1413	S	6	0	6	0.00000
Bacillus horikoshii	79883	S	6	0	6	0.00000
Bacillus sporothermodurans	46224	S	5	0	5	0.00000
Bacillus circulans	1397	S	5	0	5	0.00000
Bacillus dafuensis	1742359	S	4	0	4	0.00000
Bacillus marisflavi	189381	S	4	0	4	0.00000
Bacillus ciccensis	1670641	S	3	0	3	0.00000
Bacillus weihaiensis	1547283	S	3	0	3	0.00000
Bacillus infantis	324767	S	3	0	3	0.00000
Bacillus vietnamensis	218284	S	2	0	2	0.00000
Bacillus glycinifermentans	1664069	S	2	0	2	0.00000
Bacillus gobiensis	1441095	S	2	0	2	0.00000
Bacillus beveridgei	632773	S	2	0	2	0.00000
Bacillus oleronius	38875	S	2	0	2	0.00000
Bacillus pumilus	1408	S	2	0	2	0.00000
Bacillus cohnii	33932	S	1	0	1	0.00000
Bacillus vini	1476025	S	1	0	1	0.00000
Bacillus smithii	1479	S	1	0	1	0.00000
Bacillus methanolicus	1471	S	1	0	1	0.00000
Lysinibacillus sp. 2017	2169540	S	6	0	6	0.00000
Lysinibacillus sp. SGAir0095	2070463	S	4	0	4	0.00000
Lysinibacillus sp. YS11	2072025	S	3	0	3	0.00000
Lysinibacillus sp. FJAT-51161	2590012	S	1	0	1	0.00000
Lysinibacillus sphaericus	1421	S	9	4	13	0.00001
Lysinibacillus fusiformis	28031	S	5	2	7	0.00000
Lysinibacillus timonensis	2086577	S	4	0	4	0.00000
Cytobacillus kochii	859143	S	7	0	7	0.00000
Cytobacillus oceanisediminis	665099	S	6	0	6	0.00000
Metabacillus litoralis	152268	S	9	0	9	0.00001
Metabacillus sp. KUDC1714	2745198	S	2	0	2	0.00000
Metabacillus sp. cB07	2806989	S	1	0	1	0.00000
Salicibibacter kimchii	2099786	S	7	0	7	0.00000
Salicibibacter halophilus	2502791	S	2	0	2	0.00000
Salicibibacter sp. NKC5-3	2743000	S	1	1	2	0.00000
Peribacillus muralis	264697	S	7	0	7	0.00000
Peribacillus asahii	228899	S	2	0	2	0.00000
Peribacillus butanolivorans	421767	S	2	0	2	0.00000
Weizmannia coagulans	1398	S	8	0	8	0.00000
Priestia megaterium	1404	S	4	4	8	0.00000
Priestia filamentosa	1402861	S	2	0	2	0.00000
Priestia flexa	86664	S	1	0	1	0.00000
Alkalihalobacillus halodurans	86665	S	4	0	4	0.00000
Alkalihalobacillus krulwichiae	199441	S	2	0	2	0.00000
Alkalihalobacillus clausii	79880	S	1	0	1	0.00000
Alkalihalobacillus pseudofirmus	79885	S	1	0	1	0.00000
Virgibacillus sp. Bac330	2419841	S	2	0	2	0.00000
Virgibacillus sp. SK37	403957	S	1	0	1	0.00000
Virgibacillus sp. MSP4-1	2700081	S	1	0	1	0.00000
Virgibacillus halodenitrificans	1482	S	1	0	1	0.00000
Virgibacillus dokdonensis	302167	S	1	0	1	0.00000
Virgibacillus phasianinus	2017483	S	1	0	1	0.00000
Oceanobacillus iheyensis	182710	S	4	0	4	0.00000
Oceanobacillus zhaokaii	2052660	S	2	0	2	0.00000
Oceanobacillus kimchii	746691	S	1	0	1	0.00000
Mesobacillus foraminis	279826	S	6	0	6	0.00000
Mesobacillus jeotgali	129985	S	1	0	1	0.00000
Anaerobacillus isosaccharinicus	1532552	S	6	0	6	0.00000
Geobacillus sp. WCH70	471223	S	1	1	2	0.00000
Geobacillus sp. 44B	1963023	S	1	0	1	0.00000
Geobacillus stearothermophilus	1422	S	1	1	2	0.00000
Geobacillus subterraneus	129338	S	1	0	1	0.00000
Halobacillus mangrovi	402384	S	3	0	3	0.00000
Halobacillus halophilus	1570	S	1	0	1	0.00000
Halobacillus litoralis	45668	S	1	0	1	0.00000
Anoxybacillus amylolyticus	294699	S	2	0	2	0.00000
Anoxybacillus kamchatkensis	196180	S	1	2	3	0.00000
Parageobacillus toebii	153151	S	4	8	12	0.00001
Radiobacillus deserti	2594883	S	3	0	3	0.00000
Pradoshia sp. D12	2651284	S	3	0	3	0.00000
Fictibacillus arsenicus	255247	S	1	0	1	0.00000
Fictibacillus phosphorivorans	1221500	S	1	0	1	0.00000
Gracilibacillus sp. SCU50	2663022	S	2	0	2	0.00000
Neobacillus mesonae	1193713	S	2	0	2	0.00000
Psychrobacillus glaciei	2283160	S	1	0	1	0.00000
Psychrobacillus sp. AK 1817	2303505	S	1	0	1	0.00000
Sediminibacillus sp. DP4-553-S	2729421	S	2	0	2	0.00000
Lederbergia lentus	1467	S	2	0	2	0.00000
Paraliobacillus zengyii	2213194	S	2	0	2	0.00000
Caldibacillus thermoamylovorans	35841	S	1	0	1	0.00000
Aeribacillus pallidus	33936	S	1	0	1	0.00000
Terribacillus goriensis	386490	S	1	0	1	0.00000
Lentibacillus amyloliquefaciens	1472767	S	1	0	1	0.00000
Pontibacillus sp. ALD_SL1	2777185	S	1	0	1	0.00000
Amphibacillus xylanus	1449	S	1	0	1	0.00000
Paenibacillus sp. BIHB4019	1870819	S	6	0	6	0.00000
Paenibacillus sp. FSL R5-0912	1536771	S	6	2	8	0.00000
Paenibacillus sp. FSL H7-0357	1536774	S	6	0	6	0.00000
Paenibacillus sp. 32O-W	1695218	S	5	0	5	0.00000
Paenibacillus sp. E222	2748863	S	4	0	4	0.00000
Paenibacillus sp. FSL P4-0081	1536769	S	4	1	5	0.00000
Paenibacillus sp. FSL R5-0345	1536770	S	4	0	4	0.00000
Paenibacillus sp. JDR-2	324057	S	3	0	3	0.00000
Paenibacillus sp. B01	2660554	S	3	0	3	0.00000
Paenibacillus sp. 37	2607911	S	3	0	3	0.00000
Paenibacillus sp. FSL H7-0737	1536775	S	2	0	2	0.00000
Paenibacillus sp. JNUCC-31	2777983	S	2	0	2	0.00000
Paenibacillus sp. UniB2	2726185	S	2	0	2	0.00000
Paenibacillus sp. HB172198	2565926	S	2	0	2	0.00000
Paenibacillus sp. FSL R7-0331	1536773	S	1	0	1	0.00000
Paenibacillus sp. IHBB 10380	1566358	S	1	0	1	0.00000
Paenibacillus sp. FSL R7-0273	1536772	S	1	0	1	0.00000
Paenibacillus sp. JNUCC-32	2777984	S	1	1	2	0.00000
Paenibacillus sp. URB8-2	2741301	S	1	0	1	0.00000
Paenibacillus sp. DCT19	2211212	S	1	0	1	0.00000
Paenibacillus sp. M-152	2487928	S	1	3	4	0.00000
Paenibacillus bovis	1616788	S	13	0	13	0.00001
Paenibacillus larvae	1464	S	10	1597	1607	0.00098
Paenibacillus yonginensis	1462996	S	10	0	10	0.00001
Paenibacillus lentus	1338368	S	10	0	10	0.00001
Paenibacillus polymyxa	1406	S	9	4	13	0.00001
Paenibacillus xylanilyticus	248903	S	8	0	8	0.00000
Paenibacillus ihbetae	1870820	S	6	0	6	0.00000
Paenibacillus durus	44251	S	5	0	5	0.00000
Paenibacillus mucilaginosus	61624	S	4	-4	0	0.00000
Paenibacillus terrae	159743	S	4	0	4	0.00000
Paenibacillus borealis	160799	S	4	0	4	0.00000
Paenibacillus rhizovicinus	2704463	S	4	0	4	0.00000
Paenibacillus lycopersici	2704462	S	3	0	3	0.00000
Paenibacillus antarcticus	253703	S	3	0	3	0.00000
Paenibacillus physcomitrellae	1619311	S	3	0	3	0.00000
Paenibacillus stellifer	169760	S	3	0	3	0.00000
Paenibacillus crassostreae	1763538	S	2	0	2	0.00000
Paenibacillus graminis	189425	S	2	0	2	0.00000
Paenibacillus guangzhouensis	1473112	S	2	0	2	0.00000
Paenibacillus naphthalenovorans	162209	S	2	0	2	0.00000
Paenibacillus psychroresistens	1778678	S	2	0	2	0.00000
Paenibacillus riograndensis	483937	S	2	0	2	0.00000
Paenibacillus chitinolyticus	79263	S	2	0	2	0.00000
Paenibacillus cellulositrophicus	562959	S	2	0	2	0.00000
Paenibacillus uliginis	683737	S	2	0	2	0.00000
Paenibacillus beijingensis	1126833	S	2	0	2	0.00000
Paenibacillus baekrokdamisoli	1712516	S	1	0	1	0.00000
Paenibacillus cellulosilyticus	375489	S	1	0	1	0.00000
Paenibacillus thiaminolyticus	49283	S	1	0	1	0.00000
Paenibacillus swuensis	1178515	S	1	0	1	0.00000
Paenibacillus jilunlii	682956	S	1	0	1	0.00000
Paenibacillus xylanexedens	528191	S	1	0	1	0.00000
Paenibacillus donghaensis	414771	S	1	0	1	0.00000
Paenibacillus barcinonensis	198119	S	1	0	1	0.00000
Paenibacillus albus	2495582	S	1	0	1	0.00000
Paenibacillus peoriae	59893	S	1	1	2	0.00000
Paenibacillus kribbensis	172713	S	1	0	1	0.00000
Paenibacillus protaetiae	2509456	S	1	0	1	0.00000
Brevibacillus brevis	1393	S	7	0	7	0.00000
Brevibacillus sp. SCSIO 07484	2496837	S	5	0	5	0.00000
Brevibacillus sp. JNUCC-41	2778370	S	1	0	1	0.00000
Brevibacillus agri	51101	S	5	0	5	0.00000
Brevibacillus laterosporus	1465	S	3	3	6	0.00000
Saccharibacillus brassicae	2583377	S	16	0	16	0.00001
Cohnella sp. LGH	1619153	S	2	0	2	0.00000
Cohnella sp. MFER-1	2728023	S	2	0	2	0.00000
Cohnella abietis	2507935	S	2	0	2	0.00000
Cohnella candidum	2674991	S	1	0	1	0.00000
Thermobacillus composti	377615	S	4	0	4	0.00000
Aneurinibacillus soli	1500254	S	2	0	2	0.00000
Planococcus versutus	1302659	S	4	1	5	0.00000
Planococcus donghaensis	414778	S	2	0	2	0.00000
Planococcus sp. Y42	2213202	S	2	0	2	0.00000
Planococcus maritimus	192421	S	1	0	1	0.00000
Planococcus plakortidis	1038856	S	1	0	1	0.00000
Planococcus massiliensis	1499687	S	1	0	1	0.00000
Planococcus faecalis	1598147	S	1	4	5	0.00000
Sporosarcina sp. PTS2304	2283194	S	2	0	2	0.00000
Sporosarcina sp. Te-1	2818390	S	2	0	2	0.00000
Sporosarcina sp. P37	1930546	S	1	3	4	0.00000
Sporosarcina ureae	1571	S	3	0	3	0.00000
Sporosarcina pasteurii	1474	S	2	0	2	0.00000
Solibacillus silvestris	76853	S	5	0	5	0.00000
Solibacillus sp. R5-41	2048654	S	5	0	5	0.00000
Paenisporosarcina antarctica	417367	S	3	0	3	0.00000
Paenisporosarcina sp. K2R23-3	2320858	S	2	0	2	0.00000
Viridibacillus sp. JNUCC-6	2779527	S	2	0	2	0.00000
Jeotgalibacillus malaysiensis	1508404	S	1	0	1	0.00000
Ureibacillus thermosphaericus	51173	S	1	0	1	0.00000
Planomicrobium glaciei	459472	S	1	0	1	0.00000
Alicyclobacillus acidocaldarius	405212	S	11	0	11	0.00001
Alicyclobacillus ferrooxydans	471514	S	2	0	2	0.00000
Alicyclobacillus sp. SO9	2665646	S	2	0	2	0.00000
Kyrpidia spormannii	2055160	S	4	2	6	0.00000
Kyrpidia tusciae	33943	S	1	1	2	0.00000
Tumebacillus algifaecis	1214604	S	4	2	6	0.00000
Tumebacillus avium	1903704	S	1	0	1	0.00000
Effusibacillus sp. skT53	2743772	S	1	0	1	0.00000
Listeria sp. PSOL-1	1844999	S	12	0	12	0.00001
Listeria monocytogenes	1639	S	4	1	5	0.00000
Listeria ivanovii	1638	S	1	0	1	0.00000
Listeria seeligeri	1640	S	1	0	1	0.00000
Listeria grayi	1641	S	1	0	1	0.00000
Listeria innocua	1642	S	1	0	1	0.00000
Brochothrix thermosphacta	2756	S	1	0	1	0.00000
Gemella haemolysans	1379	S	6	0	6	0.00000
Gemella morbillorum	29391	S	5	0	5	0.00000
Gemella sanguinis	84135	S	3	0	3	0.00000
Exiguobacterium mexicanum	340146	S	1	2	3	0.00000
Novibacillus thermophilus	1471761	S	4	0	4	0.00000
Thermoactinomyces vulgaris	2026	S	2	0	2	0.00000
Kroppenstedtia eburnea	714067	S	2	0	2	0.00000
Sporolactobacillus terrae	269673	S	2	0	2	0.00000
Streptococcus thermophilus	1308	S	100	10	110	0.00007
Streptococcus equinus	1335	S	47	13	60	0.00004
Streptococcus salivarius	1304	S	28	13	41	0.00003
Streptococcus sp. oral taxon 061	712623	S	4	0	4	0.00000
Streptococcus sp. oral taxon 431	712633	S	3	0	3	0.00000
Streptococcus sp. HSISM1	1316408	S	3	0	3	0.00000
Streptococcus sp. KS 6	2598457	S	2	1	3	0.00000
Streptococcus sp. I-G2	1156431	S	1	0	1	0.00000
Streptococcus sp. HSISS3	1316412	S	1	0	1	0.00000
Streptococcus sp. NPS 308	1902136	S	1	0	1	0.00000
Streptococcus mitis	28037	S	14	3	17	0.00001
Streptococcus lutetiensis	150055	S	9	23	32	0.00002
Streptococcus sanguinis	1305	S	8	0	8	0.00000
Streptococcus oralis	1303	S	5	1	6	0.00000
Streptococcus suis	1307	S	5	0	5	0.00000
Streptococcus agalactiae	1311	S	4	23	27	0.00002
Streptococcus urinalis	149016	S	4	0	4	0.00000
Streptococcus cristatus	45634	S	3	0	3	0.00000
Streptococcus pneumoniae	1313	S	2	0	2	0.00000
Streptococcus ruminantium	1917441	S	2	2	4	0.00000
Streptococcus canis	1329	S	2	0	2	0.00000
Streptococcus iniae	1346	S	2	0	2	0.00000
Streptococcus pluranimalium	82348	S	2	0	2	0.00000
Streptococcus gordonii	1302	S	1	0	1	0.00000
Streptococcus respiraculi	2021971	S	1	0	1	0.00000
Streptococcus gwangjuense	1433513	S	1	0	1	0.00000
Streptococcus dysgalactiae	1334	S	1	1	2	0.00000
Streptococcus infantarius	102684	S	1	1	2	0.00000
Streptococcus parauberis	1348	S	1	0	1	0.00000
Streptococcus acidominimus	1326	S	1	0	1	0.00000
Streptococcus porcinus	1340	S	1	0	1	0.00000
Streptococcus ratti	1341	S	1	0	1	0.00000
Lactococcus lactis	1358	S	148	630	778	0.00048
Lactococcus raffinolactis	1366	S	13	0	13	0.00001
Lactococcus cremoris	1359	S	11	1	12	0.00001
Lactococcus taiwanensis	1151742	S	9	0	9	0.00001
Lactococcus garvieae	1363	S	8	1	9	0.00001
Lactococcus sp. KACC 19320	2592653	S	6	0	6	0.00000
Lactococcus piscium	1364	S	5	0	5	0.00000
Lactococcus allomyrinae	2419773	S	1	0	1	0.00000
Ligilactobacillus ruminis	1623	S	68	1	69	0.00004
Ligilactobacillus salivarius	1624	S	2	0	2	0.00000
Ligilactobacillus saerimneri	228229	S	1	0	1	0.00000
Lactobacillus delbrueckii	1584	S	7	1	8	0.00000
Lactobacillus kefiranofaciens	267818	S	7	1	8	0.00000
Lactobacillus johnsonii	33959	S	5	0	5	0.00000
Lactobacillus helveticus	1587	S	4	4	8	0.00000
Lactobacillus acidophilus	1579	S	4	0	4	0.00000
Lactobacillus amylovorus	1604	S	4	1	5	0.00000
Lactobacillus crispatus	47770	S	3	0	3	0.00000
Lactobacillus jensenii	109790	S	3	0	3	0.00000
Lactobacillus gasseri	1596	S	2	6	8	0.00000
Lactobacillus terrae	2269374	S	2	0	2	0.00000
Lactobacillus taiwanensis	508451	S	2	0	2	0.00000
Lactobacillus sp. 3B(2020)	2695882	S	1	0	1	0.00000
Lactobacillus amylolyticus	83683	S	1	0	1	0.00000
Weissella cibaria	137591	S	44	2	46	0.00003
Weissella confusa	1583	S	5	0	5	0.00000
Weissella hellenica	46256	S	2	0	2	0.00000
Weissella jogaejeotgali	1631871	S	2	0	2	0.00000
Weissella koreensis	165096	S	1	0	1	0.00000
Weissella diestrammenae	1162633	S	1	0	1	0.00000
Weissella cryptocerci	2506420	S	1	0	1	0.00000
Limosilactobacillus reuteri	1598	S	24	0	24	0.00001
Limosilactobacillus mucosae	97478	S	13	0	13	0.00001
Limosilactobacillus fermentum	1613	S	7	0	7	0.00000
Limosilactobacillus vaginalis	1633	S	2	0	2	0.00000
Limosilactobacillus pontis	35787	S	1	0	1	0.00000
Limosilactobacillus gastricus	227942	S	1	0	1	0.00000
Leuconostoc mesenteroides	1245	S	14	2	16	0.00001
Leuconostoc pseudomesenteroides	33968	S	7	2	9	0.00001
Leuconostoc lactis	1246	S	5	3	8	0.00000
Leuconostoc gelidum	1244	S	4	0	4	0.00000
Leuconostoc carnosum	1252	S	2	0	2	0.00000
Latilactobacillus curvatus	28038	S	23	1	24	0.00001
Latilactobacillus sakei	1599	S	13	0	13	0.00001
Latilactobacillus fuchuensis	164393	S	2	0	2	0.00000
Lactiplantibacillus plantarum	1590	S	9	24	33	0.00002
Lactiplantibacillus paraplantarum	60520	S	7	1	8	0.00000
Companilactobacillus crustorum	392416	S	4	0	4	0.00000
Companilactobacillus farciminis	1612	S	2	0	2	0.00000
Companilactobacillus paralimentarius	83526	S	2	0	2	0.00000
Companilactobacillus zhachilii	2304606	S	2	0	2	0.00000
Companilactobacillus ginsenosidimutans	1007676	S	1	0	1	0.00000
Companilactobacillus allii	1847728	S	1	0	1	0.00000
Oenococcus sicerae	2203724	S	5	0	5	0.00000
Oenococcus kitaharae	336988	S	4	0	4	0.00000
Lacticaseibacillus paracasei	1597	S	4	2	6	0.00000
Lacticaseibacillus casei	1582	S	2	0	2	0.00000
Lacticaseibacillus rhamnosus	47715	S	1	0	1	0.00000
Lacticaseibacillus manihotivorans	88233	S	1	0	1	0.00000
Liquorilactobacillus mali	1618	S	7	2	9	0.00001
Pediococcus damnosus	51663	S	3	0	3	0.00000
Pediococcus claussenii	187452	S	2	0	2	0.00000
Pediococcus pentosaceus	1255	S	1	0	1	0.00000
Pediococcus acidilactici	1254	S	1	0	1	0.00000
Loigolactobacillus coryniformis	1610	S	5	1	6	0.00000
Loigolactobacillus bifermentans	1607	S	1	0	1	0.00000
Fructilactobacillus sanfranciscensis	1625	S	5	0	5	0.00000
Fructilactobacillus fructivorans	1614	S	1	0	1	0.00000
Paucilactobacillus oligofermentans	293371	S	3	0	3	0.00000
Paucilactobacillus nenjiangensis	1296540	S	2	0	2	0.00000
Paucilactobacillus hokkaidonensis	1193095	S	1	0	1	0.00000
Lapidilactobacillus dextrinicus	51664	S	3	0	3	0.00000
Levilactobacillus brevis	1580	S	2	0	2	0.00000
Levilactobacillus suantsaii	2292255	S	1	0	1	0.00000
Apilactobacillus bombintestini	2419772	S	3	0	3	0.00000
Lentilactobacillus kefiri	33962	S	2	0	2	0.00000
Lentilactobacillus curieae	1138822	S	1	0	1	0.00000
Secundilactobacillus malefermentans	176292	S	1	0	1	0.00000
Secundilactobacillus paracollinoides	240427	S	1	0	1	0.00000
Bombilactobacillus bombi	1303590	S	1	0	1	0.00000
Jeotgalibaca porci	1868793	S	50	3	53	0.00003
Jeotgalibaca dankookensis	708126	S	6	0	6	0.00000
Jeotgalibaca arthritidis	1868794	S	3	2	5	0.00000
Jeotgalibaca sp. PTS2502	1903686	S	3	2	5	0.00000
Carnobacterium maltaromaticum	2751	S	12	0	12	0.00001
Carnobacterium inhibens	147709	S	11	0	11	0.00001
Carnobacterium sp. 17-4	208596	S	8	0	8	0.00000
Carnobacterium sp. CS13	2800128	S	2	0	2	0.00000
Carnobacterium divergens	2748	S	9	0	9	0.00001
Marinilactibacillus sp. 15R	1911586	S	2	0	2	0.00000
Dolosigranulum pigrum	29394	S	1	0	1	0.00000
Enterococcus faecalis	1351	S	22	4	26	0.00002
Enterococcus faecium	1352	S	20	10	30	0.00002
Enterococcus casseliflavus	37734	S	4	1	5	0.00000
Enterococcus hirae	1354	S	3	0	3	0.00000
Enterococcus sp. FDAARGOS_375	2060307	S	2	3	5	0.00000
Enterococcus sp. M190262	2582830	S	1	1	2	0.00000
Enterococcus cecorum	44008	S	2	0	2	0.00000
Enterococcus durans	53345	S	2	0	2	0.00000
Enterococcus rotai	118060	S	2	0	2	0.00000
Enterococcus saigonensis	1805431	S	2	0	2	0.00000
Enterococcus gallinarum	1353	S	1	2	3	0.00000
Enterococcus mundtii	53346	S	1	0	1	0.00000
Enterococcus thailandicus	417368	S	1	0	1	0.00000
Enterococcus wangshanyuanii	2005703	S	1	0	1	0.00000
Vagococcus carniphilus	218144	S	3	0	3	0.00000
Vagococcus hydrophili	2714947	S	3	0	3	0.00000
Vagococcus teuberi	519472	S	2	0	2	0.00000
Vagococcus zengguangii	2571750	S	2	0	2	0.00000
Vagococcus coleopterorum	2714946	S	2	0	2	0.00000
Vagococcus sp. CF-49	2562451	S	1	0	1	0.00000
Tetragenococcus halophilus	51669	S	5	0	5	0.00000
Tetragenococcus koreensis	290335	S	4	0	4	0.00000
Tetragenococcus osmophilus	526944	S	2	0	2	0.00000
Melissococcus plutonius	33970	S	7	0	7	0.00000
Aerococcus urinaeequi	51665	S	11	2	13	0.00001
Aerococcus viridans	1377	S	5	1	6	0.00000
Aerococcus urinae	1376	S	2	0	2	0.00000
Aerococcus urinaehominis	128944	S	1	0	1	0.00000
Abiotrophia defectiva	46125	S	4	0	4	0.00000
Megamonas funiformis	437897	S	160	3	163	0.00010
Megamonas hypermegale	158847	S	13	0	13	0.00001
Selenomonas sp. Marseille-Q3039	2754044	S	7	0	7	0.00000
Selenomonas sp. oral taxon 126	712528	S	4	0	4	0.00000
Selenomonas sp. oral taxon 920	1884263	S	3	0	3	0.00000
Selenomonas sp. oral taxon 478	712538	S	2	0	2	0.00000
Selenomonas sputigena	69823	S	7	0	7	0.00000
Selenomonas ruminantium	971	S	1	0	1	0.00000
Pectinatus frisingensis	865	S	4	0	4	0.00000
Pelosinus fermentans	365349	S	16	2	18	0.00001
Pelosinus sp. UFO1	484770	S	6	1	7	0.00000
Methylomusa anaerophila	1930071	S	5	0	5	0.00000
Sporomusa termitida	2377	S	3	0	3	0.00000
Veillonella parvula	29466	S	8	1	9	0.00001
Veillonella rodentium	248315	S	5	0	5	0.00000
Veillonella dispar	39778	S	2	1	3	0.00000
Veillonella atypica	39777	S	1	0	1	0.00000
Megasphaera elsdenii	907	S	7	0	7	0.00000
Megasphaera stantonii	2144175	S	3	0	3	0.00000
Dialister massiliensis	2161821	S	7	0	7	0.00000
Dialister pneumosintes	39950	S	1	0	1	0.00000
Phascolarctobacterium faecium	33025	S	10	1	11	0.00001
Phascolarctobacterium sp. Marseille-Q4147	2823317	S	8	1	9	0.00001
Acidaminococcus intestini	187327	S	6	1	7	0.00000
Acidaminococcus fermentans	905	S	3	1	4	0.00000
Faecalibacillus intestinalis	1982626	S	32	57	89	0.00005
Erysipelatoclostridium ramosum	1547	S	10	0	10	0.00001
[Clostridium] innocuum	1522	S	5	0	5	0.00000
Longibaculum sp. KGMB06250	2584943	S	15	26	41	0.00003
Faecalitalea cylindroides	39483	S	13	2	15	0.00001
Amedibacterium intestinale	2583452	S	8	1	9	0.00001
Erysipelothrix larvae	1514105	S	3	1	4	0.00000
Bulleidia sp. zg-1006	2806552	S	3	0	3	0.00000
Faecalibaculum rodentium	1702221	S	1	0	1	0.00000
Intestinibaculum porci	2487118	S	1	0	1	0.00000
Turicibacter sanguinis	154288	S	1	0	1	0.00000
Turicibacter sp. H121	1712675	S	1	0	1	0.00000
Murdochiella vaginalis	1852373	S	18	1	19	0.00001
Finegoldia magna	1260	S	5	0	5	0.00000
Parvimonas micra	33033	S	5	0	5	0.00000
Anaerococcus mediterraneensis	1870984	S	2	0	2	0.00000
Anaerococcus prevotii	33034	S	1	0	1	0.00000
Anaerococcus vaginalis	33037	S	1	0	1	0.00000
Peptoniphilus harei	54005	S	2	0	2	0.00000
Schnuerera ultunensis	45497	S	4	0	4	0.00000
Tissierellia sp. JN-28	2507161	S	2	0	2	0.00000
Gudongella oleilytica	1582259	S	2	0	2	0.00000
Keratinibaculum paraultunense	1278232	S	1	0	1	0.00000
Gottschalkia acidurici	1556	S	2	0	2	0.00000
Sedimentibacter sp. zth1	2816908	S	2	0	2	0.00000
Ezakiella massiliensis	1852374	S	2	0	2	0.00000
Limnochorda pilosa	1555112	S	4	0	4	0.00000
endosymbiont 'TC1' of Trimyema compressum	243899	S	1	0	1	0.00000
Nostoc sp. PCC 7524	28072	S	19	4	23	0.00001
Nostoc sp. NIES-4103	2005458	S	15	3	18	0.00001
Nostoc sp. TCL26-01	2576904	S	13	2	15	0.00001
Nostoc sp. CENA543	1869241	S	12	2	14	0.00001
Nostoc sp. 'Peltigera membranacea cyanobiont' N6	1261031	S	11	6	17	0.00001
Nostoc sp. C052	2576902	S	11	5	16	0.00001
Nostoc sp. TCL240-02	2572090	S	10	12	22	0.00001
Nostoc sp. PCC 7107	317936	S	5	3	8	0.00000
Nostoc sp. 'Lobaria pulmonaria (5183) cyanobiont'	1618022	S	3	1	4	0.00000
Nostoc sp. C057	2576903	S	2	6	8	0.00000
Nostoc sp. NIES-2111	1973475	S	1	4	5	0.00000
Nostoc sp. UHCC 0702	2814655	S	1	0	1	0.00000
Nostoc carneum	374162	S	19	81	100	0.00006
Nostoc piscinale	224012	S	10	3	13	0.00001
Nostoc edaphicum	264686	S	10	6	16	0.00001
Nostoc punctiforme	272131	S	8	14	22	0.00001
Nostoc flagelliforme	1306274	S	7	5	12	0.00001
Nostoc linckia	92942	S	6	4	10	0.00001
Nostoc sphaeroides	446679	S	6	5	11	0.00001
Anabaena sp. WA102	1647413	S	12	44	56	0.00003
Anabaena sp. YBS01	2490939	S	5	145	150	0.00009
Anabaena cylindrica	1165	S	12	4	16	0.00001
Trichormus azollae	1164	S	19	3	22	0.00001
Cylindrospermum stagnale	142864	S	13	2	15	0.00001
Calothrix sp. NIES-2100	1954172	S	10	9	19	0.00001
Calothrix sp. PCC 7507	99598	S	6	2	8	0.00000
Calothrix sp. 336/3	1337936	S	5	0	5	0.00000
Calothrix sp. NIES-3974	2005462	S	4	0	4	0.00000
Calothrix sp. NIES-2098	1954171	S	3	2	5	0.00000
Calothrix parasitica	1973486	S	25	2	27	0.00002
Calothrix brevissima	938406	S	24	21	45	0.00003
Calothrix parietina	32054	S	23	2	25	0.00002
Sphaerospermopsis kisseleviana	289435	S	26	6	32	0.00002
Anabaenopsis elenkinii	156213	S	14	4	18	0.00001
Anabaenopsis circularis	109266	S	6	7	13	0.00001
Dolichospermum compactum	136073	S	13	31	44	0.00003
Dolichospermum flos-aquae	1166	S	2	37	39	0.00002
Raphidiopsis curvata	312883	S	8	4	12	0.00001
Cylindrospermopsis curvispora	747548	S	2	0	2	0.00000
Nodularia spumigena	70799	S	2	3	5	0.00000
Fischerella sp. NIES-3754	1752063	S	18	19	37	0.00002
Fischerella sp. NIES-4106	2005456	S	11	1	12	0.00001
Rivularia sp. PCC 7116	373994	S	20	1	21	0.00001
Microchaete diplosiphon	1197	S	2	7	9	0.00001
Scytonema sp. NIES-4073	2005464	S	6	5	11	0.00001
Scytonema sp. HK-05	1137095	S	5	2	7	0.00000
Brasilonema sennae	1397703	S	6	0	6	0.00000
Tolypothrix sp. PCC 7910	2099387	S	3	5	8	0.00000
Oscillatoria nigro-viridis	482564	S	329	52	381	0.00023
Oscillatoria acuminata	118323	S	8	1	9	0.00001
Moorea producens	1155739	S	7	0	7	0.00000
Planktothrix agardhii	1160	S	16	11	27	0.00002
Planktothrix rubescens	59512	S	5	1	6	0.00000
Trichodesmium erythraeum	1206	S	11	0	11	0.00001
Oxynema sp. AP17	2064643	S	5	0	5	0.00000
Microcoleus sp. PCC 7113	1173027	S	4	0	4	0.00000
Limnospira indica	147322	S	1	15	16	0.00001
[Phormidium] sp. ETS-05	222819	S	21	2	23	0.00001
Crinalium epipsammum	241425	S	10	1	11	0.00001
Cyanothece sp. PCC 7425	395961	S	2	0	2	0.00000
Geitlerinema sp. PCC 7407	1173025	S	1	0	1	0.00000
Microcystis aeruginosa	1126	S	75	24	99	0.00006
Microcystis sp. MC19	1967666	S	9	3	12	0.00001
Microcystis viridis	44822	S	3	5	8	0.00000
Geminocystis sp. NIES-3708	1615909	S	30	8	38	0.00002
Geminocystis sp. NIES-3709	1617448	S	10	2	12	0.00001
Geminocystis herdmanii	669359	S	13	1	14	0.00001
Chondrocystis sp. NIES-4102	2005460	S	24	14	38	0.00002
Gloeocapsa sp. PCC 7428	1173026	S	1	0	1	0.00000
Gloeothece citriformis	2546356	S	9	0	9	0.00001
Gloeothece verrucosa	2546359	S	4	0	4	0.00000
Halothece sp. PCC 7418	65093	S	6	4	10	0.00001
Euhalothece natronophila	577489	S	2	0	2	0.00000
Rippkaea orientalis	2546366	S	7	2	9	0.00001
Crocosphaera subtropica	2546360	S	4	0	4	0.00000
Candidatus Atelocyanobacterium thalassa	713887	S	3	1	4	0.00000
Cyanobacterium aponinum	379064	S	26	9	35	0.00002
Synechococcus sp. PCC 7336	195250	S	10	0	10	0.00001
Synechococcus sp. JA-2-3B'a(2-13)	321332	S	9	2	11	0.00001
Synechococcus sp. JA-3-3Ab	321327	S	9	2	11	0.00001
Synechococcus sp. PCC 7502	1173263	S	8	0	8	0.00000
Synechococcus sp. PCC 6312	195253	S	7	0	7	0.00000
Synechococcus sp. CBW1108	1353147	S	6	2	8	0.00000
Synechococcus sp. MIT S9220	166309	S	6	2	8	0.00000
Synechococcus sp. ROS8604	1442557	S	5	2	7	0.00000
Synechococcus sp. CBW1004	1353136	S	4	2	6	0.00000
Synechococcus sp. WH 8020	32052	S	4	0	4	0.00000
Synechococcus sp. PCC 73109	374982	S	4	19	23	0.00001
Synechococcus sp. CBW1107	2789857	S	3	1	4	0.00000
Synechococcus sp. NIES-970	1827144	S	3	1	4	0.00000
Synechococcus sp. LTW-R	2751170	S	2	0	2	0.00000
Synechococcus sp. CB0101	232348	S	2	0	2	0.00000
Synechococcus sp. SynAce01	1916956	S	2	0	2	0.00000
Synechococcus sp. RSCCF101	2511069	S	1	0	1	0.00000
Synechococcus sp. PROS-U-1	1400866	S	1	0	1	0.00000
Synechococcus sp. SYN20	1050714	S	1	1	2	0.00000
Synechococcus sp. A15-44	1050646	S	1	2	3	0.00000
Synechococcus sp. KORDI-100	1280380	S	1	0	1	0.00000
Synechococcus sp. NOUM97013	1442555	S	1	0	1	0.00000
Synechococcus sp. PROS-7-1	1442556	S	1	0	1	0.00000
Synechococcus sp. PCC 11901	2579791	S	1	5	6	0.00000
Synechococcus sp. BIOS-E4-1	1400864	S	1	0	1	0.00000
Synechococcus sp. RS9915	221358	S	1	9	10	0.00001
Synechococcus sp. RS9909	221352	S	1	0	1	0.00000
Synechococcus sp. CBW1006	1353138	S	1	9	10	0.00001
Synechococcus sp. Minos11	221341	S	1	0	1	0.00000
Synechococcus lividus	33070	S	11	1	12	0.00001
Synechococcus elongatus	32046	S	5	3	8	0.00000
Dactylococcopsis salina	292566	S	14	10	24	0.00001
Cyanobium gracile	59930	S	10	4	14	0.00001
Cyanobium sp. NIES-981	1851505	S	4	2	6	0.00000
Thermosynechococcus sp. TA-1	2813673	S	1	3	4	0.00000
Prochlorococcus marinus	1219	S	56	42	98	0.00006
Prochlorococcus sp. MIT 0801	1501269	S	2	11	13	0.00001
Leptolyngbya sp. PCC 7376	111781	S	17	3	20	0.00001
Leptolyngbya sp. NIES-3755	1752064	S	4	0	4	0.00000
Leptolyngbya sp. PCC 6402	272136	S	3	0	3	0.00000
Leptolyngbya sp. BL0902	1115757	S	2	0	2	0.00000
Leptolyngbya sp. O-77	1080068	S	1	4	5	0.00000
Leptolyngbya boryana	1184	S	7	5	12	0.00001
Pseudanabaena sp. ABRG5-3	685565	S	26	2	28	0.00002
Pseudanabaena sp. PCC 7367	82654	S	8	0	8	0.00000
Chamaesiphon minutus	1173032	S	18	1	19	0.00001
Synechocystis sp. PCC 6714	1147	S	1	0	1	0.00000
Synechocystis sp. CACIAM 05	1933929	S	1	13	14	0.00001
Acaryochloris marina	155978	S	11	0	11	0.00001
Halomicronema hongdechloris	1209493	S	1	0	1	0.00000
Stanieria cyanosphaera	102116	S	19	17	36	0.00002
Stanieria sp. NIES-3757	1807358	S	6	3	9	0.00001
Pleurocapsa minor	54308	S	3	0	3	0.00000
cyanobacterium endosymbiont of Epithemia turgida	718217	S	11	3	14	0.00001
cyanobacterium endosymbiont of Rhopalodia gibberula	1763363	S	4	1	5	0.00000
Gloeomargarita lithophora	1188228	S	12	0	12	0.00001
Gloeobacter violaceus	33072	S	3	1	4	0.00000
Gloeobacter kilaueensis	1416614	S	3	1	4	0.00000
Chroococcidiopsis thermalis	54299	S	4	0	4	0.00000
Mycoplasma sp. (ex Biomphalaria glabrata)	1749074	S	7	0	7	0.00000
Mycoplasma sp. Phocoena C-264-GEN	754517	S	3	0	3	0.00000
Mycoplasma sp. 1654_15	2725994	S	3	0	3	0.00000
Mycoplasma sp. Pen4	640330	S	1	0	1	0.00000
Mycoplasma sp. Mirounga ES2805-ORL	754514	S	1	0	1	0.00000
Mycoplasma sp. C264-NAS	2726117	S	1	0	1	0.00000
Mycoplasma struthionis	538220	S	9	1	10	0.00001
Mycoplasma mycoides	2102	S	3	3	6	0.00000
Mycoplasma leachii	2105	S	2	0	2	0.00000
Mycoplasma gallisepticum	2096	S	5	1	6	0.00000
Mycoplasma penetrans	28227	S	5	0	5	0.00000
Mycoplasma iowae	2116	S	3	0	3	0.00000
Mycoplasma alkalescens	45363	S	2	0	2	0.00000
Mycoplasma anserisalpingitidis	519450	S	2	0	2	0.00000
Mycoplasma phocicerebrale	142649	S	2	0	2	0.00000
Mycoplasma bovoculi	45362	S	2	0	2	0.00000
Mycoplasma canadense	29554	S	2	0	2	0.00000
Mycoplasma haemofelis	29501	S	2	0	2	0.00000
Mycoplasma neurolyticum	2120	S	2	0	2	0.00000
Mycoplasma hominis	2098	S	2	0	2	0.00000
Mycoplasma pneumoniae	2104	S	1	0	1	0.00000
Mycoplasma cloacale	92401	S	1	0	1	0.00000
Mycoplasma dispar	86660	S	1	0	1	0.00000
Mycoplasma nasistruthionis	353852	S	1	0	1	0.00000
Mycoplasma hyopneumoniae	2099	S	1	0	1	0.00000
Mycoplasma arthritidis	2111	S	1	0	1	0.00000
Mycoplasma hyosynoviae	29559	S	1	0	1	0.00000
Mycoplasma orale	2121	S	1	0	1	0.00000
Mycoplasma putrefaciens	2123	S	1	0	1	0.00000
Mycoplasma agalactiae	2110	S	7	0	7	0.00000
Mycoplasma phocirhinis	142650	S	7	0	7	0.00000
Mycoplasma bovis	28903	S	5	1	6	0.00000
Mycoplasma synoviae	2109	S	4	2	6	0.00000
Mycoplasma citelli	171281	S	3	0	3	0.00000
Mycoplasma felis	33923	S	2	0	2	0.00000
Mycoplasma glycophilum	171285	S	2	0	2	0.00000
Mycoplasma cynos	171284	S	2	0	2	0.00000
Mycoplasma columbinasale	114880	S	2	0	2	0.00000
Mycoplasma canis	29555	S	1	0	1	0.00000
Mycoplasma gallinaceum	29556	S	1	0	1	0.00000
Mycoplasma meleagridis	29561	S	1	0	1	0.00000
Mycoplasma bovirhinis	29553	S	1	0	1	0.00000
Mycoplasma maculosum	114885	S	1	0	1	0.00000
Mycoplasma columborale	171282	S	1	0	1	0.00000
Mycoplasma bovigenitalium	2112	S	1	0	1	0.00000
Ureaplasma parvum	134821	S	3	0	3	0.00000
Ureaplasma urealyticum	2130	S	1	0	1	0.00000
Ureaplasma diversum	42094	S	1	0	1	0.00000
Candidatus Hepatoplasma crinochetorum	295596	S	5	0	5	0.00000
Spiroplasma sp. TIUS-1	216963	S	5	0	5	0.00000
Spiroplasma sp. BIUS-1	216964	S	1	0	1	0.00000
Spiroplasma culicicola	216935	S	5	0	5	0.00000
Spiroplasma litorale	216942	S	4	0	4	0.00000
Spiroplasma melliferum	2134	S	3	3	6	0.00000
Spiroplasma eriocheiris	315358	S	3	0	3	0.00000
Spiroplasma diminutum	216936	S	3	0	3	0.00000
Spiroplasma chinense	216932	S	3	0	3	0.00000
Spiroplasma monobiae	2136	S	3	0	3	0.00000
Spiroplasma floricola	216937	S	2	0	2	0.00000
Spiroplasma citri	2133	S	2	2	4	0.00000
Spiroplasma clarkii	2139	S	2	0	2	0.00000
Spiroplasma corruscae	216934	S	2	0	2	0.00000
Spiroplasma helicoides	216938	S	1	0	1	0.00000
Spiroplasma apis	2137	S	1	0	1	0.00000
Spiroplasma syrphidicola	216945	S	1	0	1	0.00000
Spiroplasma turonicum	216946	S	1	0	1	0.00000
Spiroplasma tabanidicola	324079	S	1	0	1	0.00000
Spiroplasma taiwanense	2145	S	1	0	1	0.00000
Mesoplasma coleopterae	324078	S	8	2	10	0.00001
Mesoplasma florum	2151	S	7	1	8	0.00000
Mesoplasma syrphidae	225999	S	2	0	2	0.00000
Mesoplasma lactucae	138853	S	1	0	1	0.00000
Mesoplasma chauliocola	216427	S	1	0	1	0.00000
Mesoplasma tabanidae	219745	S	1	0	1	0.00000
Entomoplasma freundtii	74700	S	1	0	1	0.00000
Entomoplasma melaleucae	81459	S	1	0	1	0.00000
Entomoplasma somnilux	215578	S	1	0	1	0.00000
Acholeplasma laidlawii	2148	S	12	0	12	0.00001
Acholeplasma palmae	38986	S	8	0	8	0.00000
Acholeplasma axanthum	29552	S	6	0	6	0.00000
Acholeplasma brassicae	61635	S	4	0	4	0.00000
Candidatus Phytoplasma australiense	59748	S	1	0	1	0.00000
Candidatus Phytoplasma solani	69896	S	1	0	1	0.00000
Candidatus Phytoplasma mali	37692	S	1	0	1	0.00000
Candidatus Izimaplasma sp. HR1	1541959	S	3	0	3	0.00000
Meiothermus silvanus	52022	S	82	4	86	0.00005
Meiothermus ruber	277	S	13	2	15	0.00001
Meiothermus taiwanensis	172827	S	6	1	7	0.00000
Thermus scotoductus	37636	S	13	1	14	0.00001
Thermus thermophilus	274	S	5	2	7	0.00000
Thermus aquaticus	271	S	4	0	4	0.00000
Thermus brockianus	56956	S	4	0	4	0.00000
Thermus oshimai	56957	S	1	0	1	0.00000
Thermus caldilimi	2483360	S	1	0	1	0.00000
Oceanithermus profundus	187137	S	1	0	1	0.00000
Deinococcus sp. S14-83	2489213	S	6	2	8	0.00000
Deinococcus sp. NW-56	2080419	S	2	1	3	0.00000
Deinococcus sp. AJ005	2652443	S	2	4	6	0.00000
Deinococcus actinosclerus	1768108	S	4	7	11	0.00001
Deinococcus peraridilitoris	432329	S	4	0	4	0.00000
Deinococcus ficus	317577	S	4	0	4	0.00000
Deinococcus gobiensis	502394	S	3	0	3	0.00000
Deinococcus swuensis	1182571	S	3	1	4	0.00000
Deinococcus wulumuqiensis	980427	S	3	3	6	0.00000
Deinococcus maricopensis	309887	S	3	0	3	0.00000
Deinococcus deserti	310783	S	2	0	2	0.00000
Deinococcus metallilatus	1211322	S	2	0	2	0.00000
Deinococcus geothermalis	68909	S	1	0	1	0.00000
Deinococcus proteolyticus	55148	S	1	0	1	0.00000
Truepera radiovictrix	332249	S	6	0	6	0.00000
Candidatus Promineofilum breve	1806508	S	18	0	18	0.00001
Dehalococcoides mccartyi	61435	S	6	5	11	0.00001
Dehalogenimonas formicexedens	1839801	S	2	0	2	0.00000
Dehalogenimonas lykanthroporepellens	552810	S	1	0	1	0.00000
Roseiflexus castenholzii	120962	S	7	1	8	0.00000
Roseiflexus sp. RS-1	357808	S	2	0	2	0.00000
Chloroflexus aggregans	152260	S	3	0	3	0.00000
Chloroflexus aurantiacus	1108	S	1	-1	0	0.00000
Brevefilum fermentans	1986204	S	10	0	10	0.00001
Anaerolinea thermophila	167964	S	1	0	1	0.00000
Pelolinea submarina	913107	S	1	0	1	0.00000
Sphaerobacter thermophilus	2057	S	5	0	5	0.00000
Caldilinea aerophila	133453	S	5	0	5	0.00000
Thermobaculum terrenum	166501	S	2	0	2	0.00000
Ktedonosporobacter rubrisoli	2509675	S	2	0	2	0.00000
Tepidiforma bonchosmolovskayae	2601677	S	1	0	1	0.00000
Chthonomonas calidirosea	454171	S	5	0	5	0.00000
Fimbriimonas ginsengisoli	1005039	S	5	0	5	0.00000
Flavobacterium sp. KBS0721	1179672	S	189	89	278	0.00017
Flavobacterium sp. MDT1-60	1979344	S	131	33	164	0.00010
Flavobacterium sp. M31R6	2739062	S	125	20	145	0.00009
Flavobacterium sp. Sr18	935222	S	119	16	135	0.00008
Flavobacterium sp. SLB02	2665645	S	82	29	111	0.00007
Flavobacterium sp. HYN0086	2249356	S	80	31	111	0.00007
Flavobacterium sp. CLA17	2724135	S	78	16	94	0.00006
Flavobacterium sp. 140616W15	2478552	S	74	16	90	0.00006
Flavobacterium sp. BB8	2816357	S	65	16	81	0.00005
Flavobacterium sp. I3-2	2748319	S	46	34	80	0.00005
Flavobacterium sp. CJ74	2294119	S	40	2	42	0.00003
Flavobacterium sp. xlx-214	2654325	S	31	4	35	0.00002
Flavobacterium sp. LPB0248	2614441	S	27	21	48	0.00003
Flavobacterium sp. P2-65	2748320	S	24	2	26	0.00002
Flavobacterium sp. CS20	2775246	S	11	4	15	0.00001
Flavobacterium sangjuense	2518177	S	204	13	217	0.00013
Flavobacterium johnsoniae	986	S	179	83	262	0.00016
Flavobacterium nackdongense	2547394	S	138	9	147	0.00009
Flavobacterium psychrophilum	96345	S	118	18	136	0.00008
Flavobacterium commune	1306519	S	98	12	110	0.00007
Flavobacterium columnare	996	S	72	15	87	0.00005
Flavobacterium branchiophilum	55197	S	68	4	72	0.00004
Flavobacterium gilvum	1492737	S	63	8	71	0.00004
Flavobacterium faecale	1355330	S	62	6	68	0.00004
Flavobacterium anhuiense	459526	S	56	30	86	0.00005
Flavobacterium crocinum	2183896	S	48	18	66	0.00004
Flavobacterium crassostreae	1763534	S	47	9	56	0.00003
Flavobacterium indicum	312277	S	40	3	43	0.00003
Flavobacterium haoranii	683124	S	40	11	51	0.00003
Flavobacterium nitrogenifigens	1617283	S	37	26	63	0.00004
Flavobacterium alkalisoli	2602769	S	35	2	37	0.00002
Flavobacterium kingsejongi	1678728	S	31	3	34	0.00002
Flavobacterium pallidum	2172098	S	21	1	22	0.00001
Flavobacterium arcticum	1784713	S	21	1	22	0.00001
Flavobacterium magnum	2162713	S	20	1	21	0.00001
Flavobacterium sediminis	2201181	S	16	9	25	0.00002
Flavobacterium album	2175091	S	14	0	14	0.00001
Polaribacter sp. SM13	2818493	S	11	2	13	0.00001
Polaribacter sp. MED152	313598	S	9	1	10	0.00001
Polaribacter sp. SA4-10	754397	S	9	1	10	0.00001
Polaribacter sp. G4M1	2808900	S	9	1	10	0.00001
Polaribacter sp. ALD11	2058137	S	8	2	10	0.00001
Polaribacter sp. Hel1_33_78	1336804	S	7	1	8	0.00000
Polaribacter sp. L3A8	2686361	S	7	1	8	0.00000
Polaribacter sp. KT 15	1896175	S	6	12	18	0.00001
Polaribacter sp. L12M9	2738844	S	6	6	12	0.00001
Polaribacter sp. BM10	1529069	S	3	5	8	0.00000
Polaribacter sp. KT25b	1855336	S	3	0	3	0.00000
Polaribacter sp. SA4-12	1312072	S	2	0	2	0.00000
Polaribacter sejongensis	985043	S	8	1	9	0.00001
Polaribacter reichenbachii	996801	S	7	0	7	0.00000
Polaribacter vadi	1774273	S	6	0	6	0.00000
Polaribacter haliotis	1888915	S	4	4	8	0.00000
Capnocytophaga canimorsus	28188	S	15	3	18	0.00001
Capnocytophaga sp. FDAARGOS_737	2545799	S	2	0	2	0.00000
Capnocytophaga sp. H2931	1945657	S	1	4	5	0.00000
Capnocytophaga sp. H4358	1945658	S	1	4	5	0.00000
Capnocytophaga gingivalis	1017	S	11	0	11	0.00001
Capnocytophaga stomatis	1848904	S	9	1	10	0.00001
Capnocytophaga cynodegmi	28189	S	8	1	9	0.00001
Capnocytophaga haemolytica	45243	S	4	0	4	0.00000
Capnocytophaga endodontalis	2708117	S	3	1	4	0.00000
Capnocytophaga ochracea	1018	S	2	2	4	0.00000
Capnocytophaga sputigena	1019	S	2	0	2	0.00000
Capnocytophaga leadbetteri	327575	S	2	0	2	0.00000
Winogradskyella sp. J14-2	1936080	S	8	0	8	0.00000
Winogradskyella sp. PG-2	754409	S	7	0	7	0.00000
Winogradskyella sp. PC-19	754417	S	5	2	7	0.00000
Winogradskyella sediminis	1382466	S	13	5	18	0.00001
Winogradskyella forsetii	2686077	S	12	6	18	0.00001
Winogradskyella schleiferi	2686078	S	7	6	13	0.00001
Winogradskyella helgolandensis	2697010	S	4	0	4	0.00000
Myroides odoratus	256	S	22	2	24	0.00001
Myroides phaeus	702745	S	12	4	16	0.00001
Myroides fluvii	2572594	S	8	1	9	0.00001
Myroides odoratimimus	76832	S	4	7	11	0.00001
Myroides sp. A21	1583100	S	2	4	6	0.00000
Myroides sp. ZB35	1458492	S	1	2	3	0.00000
Myroides profundi	480520	S	2	0	2	0.00000
Nonlabens sp. Ci31	2608253	S	9	1	10	0.00001
Nonlabens sp. MB-3u-79	2058134	S	7	1	8	0.00000
Nonlabens sp. Hel1_33_55	1336802	S	2	0	2	0.00000
Nonlabens sp. MIC269	1476901	S	2	3	5	0.00000
Nonlabens sp. SY33080	2719911	S	2	2	4	0.00000
Nonlabens ponticola	2496866	S	9	0	9	0.00001
Nonlabens marinus	930802	S	7	1	8	0.00000
Nonlabens dokdonensis	328515	S	6	0	6	0.00000
Nonlabens spongiae	331648	S	6	2	8	0.00000
Nonlabens sediminis	319236	S	2	4	6	0.00000
Kordia sp. SMS9	2282170	S	35	1	36	0.00002
Kordia antarctica	1218801	S	22	1	23	0.00001
Tenacibaculum todarodis	1850252	S	13	4	17	0.00001
Tenacibaculum sp. DSM 106434	2358479	S	6	4	10	0.00001
Tenacibaculum sp. SZ-18	754423	S	5	0	5	0.00000
Tenacibaculum jejuense	584609	S	9	0	9	0.00001
Tenacibaculum dicentrarchi	669041	S	7	1	8	0.00000
Tenacibaculum maritimum	107401	S	6	0	6	0.00000
Tenacibaculum mesophilum	104268	S	3	2	5	0.00000
Formosa sp. Hel1_33_131	1336794	S	10	2	12	0.00001
Formosa sp. Hel1_31_208	1798225	S	8	0	8	0.00000
Formosa sp. L2A11	2686363	S	6	2	8	0.00000
Formosa sp. Hel3_A1_48	1336795	S	2	1	3	0.00000
Formosa agariphila	320324	S	13	4	17	0.00001
Formosa sediminum	2594004	S	6	1	7	0.00000
Lacinutrix sp. WUR7	2653681	S	18	3	21	0.00001
Lacinutrix sp. Bg11-31	2057808	S	12	1	13	0.00001
Lacinutrix sp. 5H-3-7-4	983544	S	5	2	7	0.00000
Lacinutrix venerupis	1486034	S	12	2	14	0.00001
Cellulophaga lytica	979	S	9	1	10	0.00001
Cellulophaga algicola	59600	S	8	2	10	0.00001
Cellulophaga baltica	76594	S	8	1	9	0.00001
Cellulophaga sp. L1A9	2686362	S	8	6	14	0.00001
Muricauda sp. 501str8	2698672	S	31	22	53	0.00003
Muricauda ruestringensis	111501	S	6	0	6	0.00000
Muricauda lutaonensis	516051	S	4	0	4	0.00000
Gramella fulva	2126553	S	14	0	14	0.00001
Gramella sp. MAR_2010_147	1250205	S	7	0	7	0.00000
Gramella echinicola	279359	S	5	0	5	0.00000
Gramella forsetii	411153	S	5	1	6	0.00000
Gramella salexigens	1913577	S	5	0	5	0.00000
Gramella flava	1486245	S	2	0	2	0.00000
Aquimarina sp. BL5	1714860	S	12	0	12	0.00001
Aquimarina sp. TRL1	2736252	S	12	0	12	0.00001
Aquimarina sp. AD1	1714848	S	7	0	7	0.00000
Aquimarina sp. AD10	1714849	S	6	0	6	0.00000
Maribacter sp. T28	1836467	S	7	0	7	0.00000
Maribacter sp. MJ134	2496865	S	4	0	4	0.00000
Maribacter sp. HTCC2170	313603	S	3	0	3	0.00000
Maribacter sp. 1_2014MBL_MicDiv	1644130	S	2	4	6	0.00000
Maribacter cobaltidurans	1178778	S	4	4	8	0.00000
Maribacter dokdonensis	320912	S	3	7	10	0.00001
Algibacter sp. L1A34	2686365	S	8	3	11	0.00001
Algibacter sp. L3A6	2686366	S	8	3	11	0.00001
Algibacter alginicilyticus	1736674	S	15	5	20	0.00001
Aequorivita sublithincola	101385	S	16	0	16	0.00001
Aequorivita sp. H23M31	2494375	S	7	0	7	0.00000
Aequorivita sp. KX20305	2803865	S	4	0	4	0.00000
Antarcticibacterium flavum	2058175	S	13	2	15	0.00001
Antarcticibacterium arcticum	2585771	S	7	1	8	0.00000
Dokdonia sp. 4H-3-7-5	983548	S	6	3	9	0.00001
Dokdonia sp. MED134	313590	S	3	3	6	0.00000
Dokdonia sp. Dokd-P16	2173169	S	3	1	4	0.00000
Dokdonia sp. PRO95	1239415	S	1	0	1	0.00000
Dokdonia donghaensis	326320	S	1	1	2	0.00000
Salegentibacter salegens	143223	S	12	1	13	0.00001
Salegentibacter sp. T436	1729720	S	6	6	12	0.00001
Psychroflexus torquis	57029	S	13	0	13	0.00001
Psychroflexus sp. ALD_RP9	2777186	S	4	0	4	0.00000
Lutibacter profundi	1622118	S	17	1	18	0.00001
Leeuwenhoekiella sp. ZYFB001	2719912	S	16	4	20	0.00001
Mariniflexile sp. TRM1-10	2027857	S	15	1	16	0.00001
Siansivirga zeaxanthinifaciens	762954	S	14	3	17	0.00001
Olleya sp. Bg11-27	2058135	S	7	12	19	0.00001
Olleya aquimaris	639310	S	5	2	7	0.00000
Urechidicola croceus	1850246	S	12	10	22	0.00001
Wenyingzhuangia fucanilytica	1790137	S	12	1	13	0.00001
Arenibacter algicola	616991	S	11	1	12	0.00001
Seonamhaeicola sp. S2-3	1936081	S	11	2	13	0.00001
Tamlana sp. s12	1630406	S	9	2	11	0.00001
Tamlana carrageenivorans	2069432	S	1	0	1	0.00000
Changchengzhania lutea	2049305	S	10	1	11	0.00001
Zobellia galactanivorans	63186	S	10	0	10	0.00001
Galbibacter sp. BG1	1170699	S	10	1	11	0.00001
Flavivirga eckloniae	1803846	S	8	0	8	0.00000
Aureitalea sp. RR4-38	2094025	S	8	0	8	0.00000
Zunongwangia profunda	398743	S	8	10	18	0.00001
Croceibacter atlanticus	313588	S	7	1	8	0.00000
Gillisia sp. Hel1_33_143	1336796	S	7	3	10	0.00001
Amniculibacterium sp. G2-70	2767188	S	7	3	10	0.00001
Costertonia aggregata	343403	S	6	1	7	0.00000
Euzebyella marina	1761453	S	5	4	9	0.00001
Muriicola sp. MMS17-SY002	2507538	S	4	0	4	0.00000
Sediminicola sp. YIK13	1453352	S	4	0	4	0.00000
Oceanihabitans sp. IOP_32	2529032	S	4	1	5	0.00000
Flagellimonas maritima	1383885	S	3	0	3	0.00000
Altibacter sp. ALE3EI	2562285	S	3	0	3	0.00000
Robiginitalea biformata	252307	S	2	0	2	0.00000
Psychroserpens sp. NJDZ02	2570561	S	1	2	3	0.00000
Chryseobacterium sp. NEB161	2724619	S	29	18	47	0.00003
Chryseobacterium sp. 3008163	2478663	S	26	3	29	0.00002
Chryseobacterium sp. cx-624	2758037	S	16	2	18	0.00001
Chryseobacterium sp. IHB B 17019	1721091	S	15	1	16	0.00001
Chryseobacterium sp. SNU WT5	2594269	S	15	2	17	0.00001
Chryseobacterium sp. G0186	2487064	S	14	7	21	0.00001
Chryseobacterium sp. StRB126	878220	S	12	2	14	0.00001
Chryseobacterium sp. JV274	1932669	S	11	2	13	0.00001
Chryseobacterium sp. G0201	2487065	S	10	2	12	0.00001
Chryseobacterium sp. NBC 122	2547600	S	9	0	9	0.00001
Chryseobacterium sp. POL2	2713414	S	9	2	11	0.00001
Chryseobacterium sp. 6424	2039166	S	8	1	9	0.00001
Chryseobacterium sp. T16E-39	2015076	S	6	0	6	0.00000
Chryseobacterium sp. G0162	2487063	S	6	7	13	0.00001
Chryseobacterium sp.	1871047	S	4	0	4	0.00000
Chryseobacterium balustinum	246	S	81	24	105	0.00006
Chryseobacterium indoltheticum	254	S	46	8	54	0.00003
Chryseobacterium gleum	250	S	24	22	46	0.00003
Chryseobacterium glaciei	1685010	S	21	3	24	0.00001
Chryseobacterium cucumeris	1813611	S	17	3	20	0.00001
Chryseobacterium aureum	2497456	S	15	2	17	0.00001
Chryseobacterium carnipullorum	1124835	S	15	4	19	0.00001
Chryseobacterium shandongense	1493872	S	13	5	18	0.00001
Chryseobacterium indologenes	253	S	12	3	15	0.00001
Chryseobacterium nakagawai	1241982	S	9	11	20	0.00001
Chryseobacterium gallinarum	1324352	S	9	1	10	0.00001
Chryseobacterium bernardetii	1241978	S	8	8	16	0.00001
Chryseobacterium piperi	558152	S	6	0	6	0.00000
Chryseobacterium manosquense	2754694	S	6	12	18	0.00001
Chryseobacterium arthrosphaerae	651561	S	5	1	6	0.00000
Chryseobacterium joostei	112234	S	4	1	5	0.00000
Chryseobacterium camelliae	1265445	S	1	0	1	0.00000
Kaistella carnis	1241979	S	21	4	25	0.00002
Kaistella jeonii	266749	S	18	0	18	0.00001
Kaistella daneshvariae	2487074	S	11	0	11	0.00001
Kaistella antarctica	266748	S	9	0	9	0.00001
Kaistella flava (ex Peng et al. 2021)	2038776	S	9	0	9	0.00001
Chryseobacterium haifense	421525	S	4	7	11	0.00001
Epilithonimonas vandammei	2487072	S	31	26	57	0.00003
Chryseobacterium lactis	1241981	S	6	3	9	0.00001
Chryseobacterium taklimakanense	536441	S	7	1	8	0.00000
Elizabethkingia bruuniana	1756149	S	52	130	182	0.00011
Elizabethkingia sp. JS20170427COW	2583851	S	13	0	13	0.00001
Elizabethkingia sp. M8	2796140	S	2	10	12	0.00001
Elizabethkingia sp. 2-6	2575699	S	1	1	2	0.00000
Elizabethkingia meningoseptica	238	S	10	0	10	0.00001
Elizabethkingia miricola	172045	S	8	6	14	0.00001
Elizabethkingia anophelis	1117645	S	7	7	14	0.00001
Elizabethkingia ursingii	1756150	S	2	0	2	0.00000
Cloacibacterium normanense	237258	S	43	3	46	0.00003
Empedobacter falsenii	343874	S	12	5	17	0.00001
Empedobacter brevis	247	S	11	2	13	0.00001
Empedobacter stercoris	1628248	S	10	2	12	0.00001
Apibacter raozihei	2500547	S	9	0	9	0.00001
Apibacter sp. B2966	2656761	S	2	4	6	0.00000
Weeksella virosa	1014	S	13	2	15	0.00001
Ornithobacterium rhinotracheale	28251	S	13	2	15	0.00001
Riemerella anatipestifer	34085	S	12	1	13	0.00001
Bergeyella cardium	1585976	S	2	0	2	0.00000
Blattabacterium cuenoti	1653831	S	57	3	60	0.00004
Blattabacterium sp. (Blaberus giganteus)	1186051	S	3	0	3	0.00000
Blattabacterium sp. (Blattella germanica)	624186	S	1	0	1	0.00000
Blattabacterium sp. DPU	2715232	S	1	0	1	0.00000
Fluviicola taffensis	191579	S	34	0	34	0.00002
Candidatus Sulcia muelleri	336810	S	14	0	14	0.00001
Candidatus Walczuchella monophlebidarum	1415657	S	8	0	8	0.00000
Owenweeksia hongkongensis	253245	S	10	0	10	0.00001
Croceimicrobium hydrocarbonivorans	2761580	S	6	0	6	0.00000
Ichthyobacterium seriolicida	242600	S	2	0	2	0.00000
Bacteroides uniformis	820	S	241	171	412	0.00025
Bacteroides thetaiotaomicron	818	S	148	16	164	0.00010
Bacteroides fragilis	817	S	127	97	224	0.00014
Bacteroides sp. HF-5287	2650157	S	16	3	19	0.00001
Bacteroides sp. M10	2763022	S	12	6	18	0.00001
Bacteroides sp. CACC 737	2755405	S	11	38	49	0.00003
Bacteroides sp. HF-162	2785531	S	8	36	44	0.00003
Bacteroides sp. CBA7301	2715212	S	7	0	7	0.00000
Bacteroides sp. A1C1	2528203	S	4	16	20	0.00001
Bacteroides sp. HF-5141	2650158	S	4	0	4	0.00000
Bacteroides sp. ZJ-18	2709390	S	3	18	21	0.00001
Bacteroides caccae	47678	S	90	3	93	0.00006
Bacteroides ovatus	28116	S	74	52	126	0.00008
Bacteroides cellulosilyticus	246787	S	66	4	70	0.00004
Bacteroides xylanisolvens	371601	S	56	50	106	0.00006
Bacteroides intestinalis	329854	S	54	2	56	0.00003
Bacteroides eggerthii	28111	S	28	4	32	0.00002
Bacteroides coprosuis	151276	S	4	0	4	0.00000
Bacteroides helcogenes	290053	S	3	0	3	0.00000
Bacteroides heparinolyticus	28113	S	2	0	2	0.00000
Bacteroides zoogleoformans	28119	S	2	0	2	0.00000
Bacteroides caecimuris	1796613	S	2	0	2	0.00000
Phocaeicola vulgatus	821	S	667	251	918	0.00056
Phocaeicola dorei	357276	S	244	107	351	0.00021
Phocaeicola coprophilus	387090	S	24	6	30	0.00002
Phocaeicola salanitronis	376805	S	15	1	16	0.00001
Prevotella copri	165179	S	210	37	247	0.00015
Prevotella sp. WR041	2801997	S	28	0	28	0.00002
Prevotella intermedia	28131	S	9	1	10	0.00001
Prevotella denticola	28129	S	6	0	6	0.00000
Prevotella dentalis	52227	S	6	0	6	0.00000
Prevotella melaninogenica	28132	S	4	0	4	0.00000
Prevotella oris	28135	S	4	0	4	0.00000
Prevotella fusca	589436	S	4	0	4	0.00000
Prevotella ruminicola	839	S	2	0	2	0.00000
Prevotella enoeca	76123	S	2	0	2	0.00000
Prevotella jejuni	1177574	S	2	0	2	0.00000
Prevotella scopos	589437	S	1	0	1	0.00000
Paraprevotella xylaniphila	454155	S	11	1	12	0.00001
Parabacteroides distasonis	823	S	51	62	113	0.00007
Parabacteroides goldsteinii	328812	S	8	0	8	0.00000
Parabacteroides sp. CT06	2025876	S	2	18	20	0.00001
Tannerella forsythia	28112	S	4	-4	0	0.00000
Tannerella sp. oral taxon HOT-286	712710	S	2	0	2	0.00000
Alistipes onderdonkii	328813	S	56	10	66	0.00004
Alistipes finegoldii	214856	S	17	5	22	0.00001
Alistipes communis	2585118	S	13	2	15	0.00001
Alistipes shahii	328814	S	9	3	12	0.00001
Alistipes megaguti	2364787	S	6	0	6	0.00000
Alistipes sp. dk3624	2662363	S	2	0	2	0.00000
Odoribacter splanchnicus	28118	S	21	2	23	0.00001
Butyricimonas virosa	544645	S	13	0	13	0.00001
Butyricimonas faecalis	2093856	S	4	1	5	0.00000
Paludibacter propionicigenes	185300	S	35	0	35	0.00002
Muribaculum gordoncarteri	2530390	S	6	0	6	0.00000
Muribaculum intestinale	1796646	S	4	0	4	0.00000
Duncaniella dubosii	2518971	S	6	0	6	0.00000
Sodaliphilus pleomorphus	2606626	S	2	0	2	0.00000
Dysgonomonas sp. HDW5A	2714926	S	5	7	12	0.00001
Petrimonas mucosa	1642646	S	5	0	5	0.00000
Proteiniphilum saccharofermentans	1642647	S	2	0	2	0.00000
Coprobacter sp. 2CBH44	2751153	S	15	2	17	0.00001
Barnesiella viscericola	397865	S	3	0	3	0.00000
Tenuifilum thalassicum	2590900	S	14	0	14	0.00001
Porphyromonas gingivalis	837	S	2	0	2	0.00000
Porphyromonas crevioricanis	393921	S	2	0	2	0.00000
Draconibacterium orientale	1168034	S	11	1	12	0.00001
Draconibacterium sp. M1	2706887	S	3	0	3	0.00000
Labilibaculum antarcticum	1717717	S	5	0	5	0.00000
Alkalitalea saponilacus	889453	S	4	0	4	0.00000
Spirosoma sp. KUDC1026	2745947	S	97	6	103	0.00006
Spirosoma sp. PL0136	2710596	S	17	1	18	0.00001
Spirosoma sp. KCTC 42546	2520506	S	13	1	14	0.00001
Spirosoma sp. CJU-R4	2728024	S	8	0	8	0.00000
Spirosoma pollinicola	2057025	S	54	1	55	0.00003
Spirosoma aerolatum	1211326	S	16	0	16	0.00001
Spirosoma radiotolerans	1379870	S	15	0	15	0.00001
Spirosoma taeanense	2735870	S	7	0	7	0.00000
Spirosoma aureum	2692134	S	6	3	9	0.00001
Spirosoma montaniterrae	1178516	S	5	0	5	0.00000
Spirosoma rigui	564064	S	4	0	4	0.00000
Spirosoma endbachense	2666025	S	4	1	5	0.00000
Runella sp. HYN0085	2259595	S	23	2	25	0.00002
Runella sp. SP2	2268026	S	19	1	20	0.00001
Runella slithyformis	106	S	26	1	27	0.00002
Aquirufa nivalisilvae	2516557	S	63	8	71	0.00004
Cytophaga hutchinsonii	985	S	24	2	26	0.00002
Dyadobacter sp. Q3-56	2747268	S	10	1	11	0.00001
Dyadobacter fermentans	94254	S	9	1	10	0.00001
Rhodocytophaga rosea	2704465	S	17	0	17	0.00001
Fibrella aestuarina	651143	S	9	0	9	0.00001
Fibrella sp. ES10-3-2-2	1834519	S	8	0	8	0.00000
Arcticibacterium luteifluviistationis	1784714	S	17	1	18	0.00001
Leadbetterella byssophila	316068	S	12	3	15	0.00001
Hymenobacter sp. PAMC 26554	1484116	S	17	0	17	0.00001
Hymenobacter sp. S2-20-2	2761579	S	12	1	13	0.00001
Hymenobacter sp. DG01	2584940	S	9	1	10	0.00001
Hymenobacter sp. APR13	1356852	S	8	1	9	0.00001
Hymenobacter sp. NBH84	2596915	S	7	0	7	0.00000
Hymenobacter sp. PAMC 26628	1484118	S	6	0	6	0.00000
Hymenobacter sp. TS19	2735321	S	6	0	6	0.00000
Hymenobacter sp. HDW8	2714932	S	4	8	12	0.00001
Hymenobacter sp. BRD128	2675878	S	3	0	3	0.00000
Hymenobacter sp. DG25A	1385663	S	2	0	2	0.00000
Hymenobacter sp. DG25B	1385664	S	2	0	2	0.00000
Hymenobacter sp. BRD67	2675877	S	2	0	2	0.00000
Hymenobacter qilianensis	1385715	S	12	1	13	0.00001
Hymenobacter swuensis	1446467	S	9	1	10	0.00001
Hymenobacter nivis	1850093	S	9	0	9	0.00001
Hymenobacter jejuensis	2502781	S	9	0	9	0.00001
Hymenobacter sedentarius	1411621	S	6	0	6	0.00000
Hymenobacter russus	2724192	S	6	0	6	0.00000
Hymenobacter oligotrophus	2319843	S	4	0	4	0.00000
Hymenobacter radiodurans	2496028	S	4	9	13	0.00001
Hymenobacter baengnokdamensis	2615203	S	4	2	6	0.00000
Hymenobacter busanensis	2607656	S	3	0	3	0.00000
Pontibacter sp. SGAir0037	2571030	S	11	1	12	0.00001
Pontibacter russatus	2694929	S	7	0	7	0.00000
Pontibacter akesuensis	388950	S	6	0	6	0.00000
Pontibacter korlensis	400092	S	5	0	5	0.00000
Pontibacter pudoricolor	2694930	S	5	0	5	0.00000
Pontibacter actiniarum	323450	S	3	0	3	0.00000
Adhaeribacter swui	2086471	S	9	0	9	0.00001
Adhaeribacter radiodurans	2745197	S	9	0	9	0.00001
Rufibacter sp. DG15C	1379909	S	4	2	6	0.00000
Rufibacter tibetensis	512763	S	2	0	2	0.00000
Rufibacter radiotolerans	1379910	S	2	0	2	0.00000
Nibribacter ruber	2698458	S	1	0	1	0.00000
Echinicola sp. LN3S3	2591634	S	10	0	10	0.00001
Echinicola sp. 20G	2781961	S	3	0	3	0.00000
Echinicola rosea	1807691	S	8	3	11	0.00001
Echinicola vietnamensis	390884	S	3	1	4	0.00000
Echinicola strongylocentroti	1795355	S	2	0	2	0.00000
Belliella baltica	232259	S	19	7	26	0.00002
Aquiflexum balticum	280473	S	18	2	20	0.00001
Algoriphagus sp. Y33	2772483	S	8	0	8	0.00000
Algoriphagus sanaruensis	1727163	S	6	0	6	0.00000
Algoriphagus machipongonensis	388413	S	3	0	3	0.00000
Cyclobacterium marinum	104	S	8	2	10	0.00001
Cyclobacterium amurskyense	320787	S	2	0	2	0.00000
Flammeovirga sp. MY04	1191459	S	10	1	11	0.00001
Flammeovirga pectinis	2494373	S	8	1	9	0.00001
Chryseolinea soli	2321403	S	7	1	8	0.00000
Fulvivirga sp. S481	2810512	S	5	0	5	0.00000
Cardinium endosymbiont of Sogatella furcifera	650378	S	6	0	6	0.00000
Cardinium endosymbiont of Encarsia pergandiella	249402	S	1	0	1	0.00000
Candidatus Cardinium hertigii	247481	S	1	0	1	0.00000
Candidatus Amoebophilus asiaticus	281120	S	3	0	3	0.00000
Roseivirga pacifica	1267423	S	9	0	9	0.00001
Marivirga tractuosa	1006	S	7	5	12	0.00001
Bernardetia litoralis	999	S	6	0	6	0.00000
Pedobacter sp. KBS0701	2578106	S	48	13	61	0.00004
Pedobacter sp. G11	2482728	S	22	3	25	0.00002
Pedobacter sp. HDW13	2714940	S	22	3	25	0.00002
Pedobacter sp. SW-16	2766984	S	20	4	24	0.00001
Pedobacter sp. PACM 27299	1727164	S	19	1	20	0.00001
Pedobacter sp. JBR3-12	2789740	S	19	1	20	0.00001
Pedobacter sp. CJ43	2605747	S	14	0	14	0.00001
Pedobacter sp. eg	2201271	S	8	0	8	0.00000
Pedobacter roseus	336820	S	47	13	60	0.00004
Pedobacter cryoconitis	188932	S	31	1	32	0.00002
Pedobacter ginsengisoli	363852	S	28	1	29	0.00002
Pedobacter heparinus	984	S	27	1	28	0.00002
Pedobacter steynii	430522	S	26	1	27	0.00002
Pedobacter suwonensis	332999	S	12	2	14	0.00001
Mucilaginibacter ginsenosidivorax	862126	S	47	0	47	0.00003
Mucilaginibacter sp. 14171R-50	2703789	S	28	0	28	0.00002
Mucilaginibacter sp. F39-2	2728022	S	13	0	13	0.00001
Mucilaginibacter mallensis	652787	S	31	0	31	0.00002
Mucilaginibacter celer	2305508	S	26	0	26	0.00002
Mucilaginibacter xinganensis	1234841	S	18	0	18	0.00001
Mucilaginibacter paludis	423351	S	16	0	16	0.00001
Mucilaginibacter gotjawali	1550579	S	13	0	13	0.00001
Mucilaginibacter rubeus	2027860	S	13	38	51	0.00003
Mucilaginibacter ginkgonis	2682091	S	10	0	10	0.00001
Mucilaginibacter mali	2740462	S	10	0	10	0.00001
Mucilaginibacter gossypii	551996	S	8	6	14	0.00001
Mucilaginibacter ginsenosidivorans	398053	S	7	0	7	0.00000
Sphingobacterium sp. UDSM-2020	2795738	S	48	5	53	0.00003
Sphingobacterium sp. ML3W	1538644	S	29	2	31	0.00002
Sphingobacterium sp. CZ-2	2557994	S	9	1	10	0.00001
Sphingobacterium sp. DR205	2713573	S	7	0	7	0.00000
Sphingobacterium sp. dk4302	2662364	S	3	0	3	0.00000
Sphingobacterium sp. B29	1933220	S	2	5	7	0.00000
Sphingobacterium sp. G1-14	2003121	S	1	3	4	0.00000
Sphingobacterium spiritivorum	258	S	17	5	22	0.00001
Sphingobacterium multivorum	28454	S	12	19	31	0.00002
Sphingobacterium mizutaii	1010	S	9	0	9	0.00001
Sphingobacterium daejeonense	371142	S	9	1	10	0.00001
Sphingobacterium lactis	797291	S	9	3	12	0.00001
Sphingobacterium thalpophilum	259	S	5	2	7	0.00000
Sphingobacterium psychroaquaticum	561061	S	5	0	5	0.00000
Sphingobacterium hotanense	649196	S	2	0	2	0.00000
Solitalea canadensis	995	S	11	0	11	0.00001
Olivibacter sp. SDN3	2764720	S	3	0	3	0.00000
Olivibacter sp. LS-1	2592345	S	2	17	19	0.00001
Pseudopedobacter saltans	151895	S	3	0	3	0.00000
Chitinophaga sp. MD30	2033437	S	13	1	14	0.00001
Chitinophaga sp. XS-30	2604421	S	3	0	3	0.00000
Chitinophaga sp. 1310	2725416	S	3	12	15	0.00001
Chitinophaga sp. 1303	2725414	S	2	8	10	0.00001
Chitinophaga pinensis	79329	S	17	4	21	0.00001
Chitinophaga caeni	2029983	S	9	1	10	0.00001
Chitinophaga alhagiae	2203219	S	5	0	5	0.00000
Chitinophaga agri	2703787	S	4	2	6	0.00000
Arachidicoccus ginsenosidivorans	496057	S	16	4	20	0.00001
Arachidicoccus sp. B3-10	2545455	S	11	0	11	0.00001
Arachidicoccus sp. BS20	1850526	S	2	0	2	0.00000
Arachidicoccus soli	2341117	S	11	2	13	0.00001
Panacibacter ginsenosidivorans	1813871	S	38	1	39	0.00002
Lacibacter sp. S13-6-6	2760713	S	36	1	37	0.00002
Flavisolibacter ginsenosidimutans	661481	S	12	1	13	0.00001
Flavisolibacter tropicus	1492898	S	7	2	9	0.00001
Flavihumibacter sp. SB-02	2676868	S	20	2	22	0.00001
Niabella ginsenosidivorans	1176587	S	9	0	9	0.00001
Niabella soli	446683	S	8	0	8	0.00000
Pseudocnuella soli	2502779	S	17	3	20	0.00001
Filimonas lacunae	477680	S	14	2	16	0.00001
Niastella koreensis	354356	S	12	2	14	0.00001
Paraflavitalea soli	2315862	S	12	1	13	0.00001
Pseudobacter ginsenosidimutans	661488	S	6	0	6	0.00000
Haliscomenobacter hydrossis	2350	S	41	0	41	0.00003
Saprospira grandis	1008	S	2	0	2	0.00000
Rhodothermus marinus	29549	S	11	0	11	0.00001
Salinibacter ruber	146919	S	5	0	5	0.00000
Chlorobaculum limnaeum	274537	S	11	0	11	0.00001
Chlorobaculum parvum	274539	S	4	0	4	0.00000
Chlorobaculum tepidum	1097	S	2	0	2	0.00000
Chlorobium chlorochromatii	337090	S	5	0	5	0.00000
Chlorobium phaeobacteroides	1096	S	3	0	3	0.00000
Chlorobium phaeovibrioides	1094	S	2	0	2	0.00000
Pelodictyon luteolum	1100	S	4	0	4	0.00000
Pelodictyon phaeoclathratiforme	34090	S	2	0	2	0.00000
Prosthecochloris sp. HL-130-GSB	1974213	S	5	0	5	0.00000
Prosthecochloris sp. CIB 2401	1868325	S	1	0	1	0.00000
Prosthecochloris aestuarii	1102	S	4	0	4	0.00000
Chloroherpeton thalassium	100716	S	4	0	4	0.00000
Ignavibacterium album	591197	S	3	0	3	0.00000
Melioribacter roseus	1134405	S	3	0	3	0.00000
Candidatus Cyclonatronum proteinivorum	1457365	S	4	0	4	0.00000
Gemmatimonas sp. TET16	2732249	S	38	1	39	0.00002
Gemmatimonas phototrophica	1379270	S	37	2	39	0.00002
Gemmatimonas aurantiaca	173480	S	22	0	22	0.00001
Gemmatirosa kalamazoonesis	861299	S	27	0	27	0.00002
Candidatus Cloacimonas acidaminovorans	456827	S	51	0	51	0.00003
Fibrobacter succinogenes	833	S	3	0	3	0.00000
Limnoglobus roseus	2598579	S	143	5	148	0.00009
Urbifossiella limnaea	2528023	S	131	9	140	0.00009
Gemmata obscuriglobus	114	S	46	4	50	0.00003
Gemmata massiliana	1210884	S	29	13	42	0.00003
Gemmata sp. SH-PL17	1630693	S	19	10	29	0.00002
Frigoriglobus tundricola	2774151	S	100	14	114	0.00007
Tuwongella immobilis	692036	S	8	0	8	0.00000
Pirellula sp. SH-Sr6A	1632865	S	24	0	24	0.00001
Pirellula staleyi	125	S	8	0	8	0.00000
Anatilimnocola aggregata	2528021	S	29	4	33	0.00002
Lignipirellula cremea	2528010	S	18	2	20	0.00001
Aureliella helgolandensis	2527968	S	15	0	15	0.00001
Stieleria maiorica	2795974	S	8	2	10	0.00001
Stieleria neptunia	2527979	S	6	0	6	0.00000
Rosistilla oblonga	2527990	S	6	1	7	0.00000
Rosistilla carotiformis	2528017	S	4	1	5	0.00000
Bremerella volcania	2527984	S	11	1	12	0.00001
Mariniblastus fucicola	980251	S	10	0	10	0.00001
Rhodopirellula baltica	265606	S	9	0	9	0.00001
Roseimaritima ulvae	980254	S	5	0	5	0.00000
Lacipirellula limnantheis	2528024	S	81	5	86	0.00005
Lacipirellula parvula	2650471	S	26	1	27	0.00002
Pirellulimonas nuda	2528009	S	20	0	20	0.00001
Aeoliella mucimassa	2527972	S	9	0	9	0.00001
Botrimarina mediterranea	2528022	S	7	0	7	0.00000
Bythopirellula goksoyri	1400387	S	5	0	5	0.00000
Thermogutta terrifontis	1331910	S	6	0	6	0.00000
Planctomyces sp. SH-PL14	1632864	S	26	2	28	0.00002
Planctomyces sp. SH-PL62	1636152	S	20	9	29	0.00002
Gimesia maris	122	S	7	4	11	0.00001
Gimesia panareensis	2527978	S	7	2	9	0.00001
Gimesia aquarii	2527964	S	3	0	3	0.00000
Gimesia chilikensis	2605989	S	3	8	11	0.00001
Gimesia algae	2527971	S	2	2	4	0.00000
Gimesia alba	2527973	S	2	1	3	0.00000
Gimesia fumaroli	2527976	S	1	0	1	0.00000
Planctopirus ephydatiae	2528019	S	15	3	18	0.00001
Planctopirus limnophila	120	S	9	1	10	0.00001
Symmachiella dynata	2527995	S	24	3	27	0.00002
Maioricimonas rarisocia	2528026	S	14	3	17	0.00001
Fuerstia marisgermanicae	1891926	S	11	0	11	0.00001
Crateriforma conspicua	2527996	S	10	2	12	0.00001
Alienimonas californiensis	2527989	S	9	1	10	0.00001
Calycomorphotria hydatis	2528027	S	9	0	9	0.00001
Caulifigura coniformis	2527983	S	8	0	8	0.00000
Rubinisphaera brasiliensis	119	S	5	0	5	0.00000
Thalassoglobus polymorphus	2527994	S	5	0	5	0.00000
Polystyrenella longa	2528007	S	2	0	2	0.00000
Singulisphaera acidiphila	466153	S	29	7	36	0.00002
Paludisphaera borealis	1387353	S	26	7	33	0.00002
Tautonia plasticadhaerens	2527974	S	24	1	25	0.00002
Aquisphaera giovannonii	406548	S	20	3	23	0.00001
Isosphaera pallida	128	S	3	0	3	0.00000
Humisphaera borealis	2807512	S	36	0	36	0.00002
Sedimentisphaera cyanobacteriorum	1940790	S	7	6	13	0.00001
Sedimentisphaera salicampi	1941349	S	4	0	4	0.00000
Limihaloglobus sulfuriphilus	1851148	S	1	0	1	0.00000
Anaerohalosphaera lusitana	1936003	S	2	0	2	0.00000
Phycisphaera mikurensis	547188	S	10	0	10	0.00001
Poriferisphaera corsica	2528020	S	1	0	1	0.00000
Candidatus Kuenenia stuttgartiensis	174633	S	3	0	3	0.00000
Opitutus sp. GAS368	1882749	S	88	7	95	0.00006
Opitutus terrae	107709	S	34	1	35	0.00002
Lacunisphaera limnophila	1838286	S	110	10	120	0.00007
Nibricoccus aquaticus	2576891	S	71	2	73	0.00004
Ereboglobus luteus	1796921	S	30	1	31	0.00002
Coraliomargarita akajimensis	395922	S	4	0	4	0.00000
Roseimicrobium sp. ORNL1	2711231	S	60	2	62	0.00004
Luteolibacter luteus	2728835	S	55	0	55	0.00003
Verrucomicrobium spinosum	2736	S	41	3	44	0.00003
Verrucomicrobium sp. GAS474	1882831	S	10	0	10	0.00001
Akkermansia muciniphila	239935	S	68	1	69	0.00004
Akkermansia glycaniphila	1679444	S	4	0	4	0.00000
Candidatus Xiphinematobacter sp. Idaho Grape	1704307	S	5	0	5	0.00000
Methylacidimicrobium sp. AP8	2730359	S	2	0	2	0.00000
Methylacidimicrobium sp. B4	2796139	S	2	1	3	0.00000
Methylacidiphilum infernorum	511746	S	1	3	4	0.00000
Methylacidiphilum sp. IT6	2795386	S	1	0	1	0.00000
Chlamydia abortus	83555	S	8	2	10	0.00001
Chlamydia sp. 2742-308	1806891	S	4	0	4	0.00000
Chlamydia sp. H15-1957-10C	1967782	S	1	0	1	0.00000
Chlamydia sp. S15-834C	1967783	S	1	0	1	0.00000
Chlamydia muridarum	83560	S	2	0	2	0.00000
Chlamydia pecorum	85991	S	2	0	2	0.00000
Chlamydia avium	1457141	S	1	0	1	0.00000
Candidatus Protochlamydia amoebophila	362787	S	2	1	3	0.00000
Candidatus Protochlamydia naegleriophila	389348	S	2	1	3	0.00000
Parachlamydia acanthamoebae	83552	S	3	1	4	0.00000
Waddlia chondrophila	71667	S	3	0	3	0.00000
Simkania negevensis	83561	S	2	0	2	0.00000
Candidatus Vampirococcus archaeovorus	1930593	S	3	0	3	0.00000
Kiritimatiella glycovorans	1307763	S	3	2	5	0.00000
Granulicella sp. 5B5	1617967	S	7	0	7	0.00000
Granulicella sp. WH15	2602070	S	4	0	4	0.00000
Granulicella tundricola	940615	S	9	0	9	0.00001
Granulicella mallensis	940614	S	7	0	7	0.00000
Terriglobus albidus	1592106	S	13	0	13	0.00001
Terriglobus roseus	392734	S	4	0	4	0.00000
Terriglobus saanensis	870903	S	1	0	1	0.00000
Acidobacterium capsulatum	33075	S	6	0	6	0.00000
Acidobacterium sp. 4Y35	2763107	S	3	0	3	0.00000
Acidisarcina polymorpha	2211140	S	7	0	7	0.00000
Candidatus Koribacter versatilis	658062	S	5	0	5	0.00000
Edaphobacter sp. 4G125	2763071	S	3	0	3	0.00000
Edaphobacter sp. 12200R-103	2703788	S	1	0	1	0.00000
Paludibaculum fermentans	1473598	S	22	1	23	0.00001
Candidatus Solibacter usitatus	332163	S	21	2	23	0.00001
Luteitalea pratensis	1855912	S	34	1	35	0.00002
Chloracidobacterium thermophilum	458033	S	3	0	3	0.00000
Treponema phagedenis	162	S	5	1	6	0.00000
Treponema parvum	138851	S	4	0	4	0.00000
Treponema brennaborense	81028	S	2	0	2	0.00000
Treponema azotonutricium	150829	S	2	0	2	0.00000
Treponema succinifaciens	167	S	1	0	1	0.00000
Treponema putidum	221027	S	1	2	3	0.00000
Treponema pedis	409322	S	1	0	1	0.00000
Treponema ruminis	744515	S	1	0	1	0.00000
Sphaerochaeta globosa	1131703	S	4	0	4	0.00000
Sphaerochaeta pleomorpha	1131707	S	2	0	2	0.00000
Thiospirochaeta perfilievii	252967	S	5	1	6	0.00000
Spirochaeta thermophila	154	S	3	0	3	0.00000
Spirochaeta africana	46355	S	1	0	1	0.00000
Salinispira pacifica	1307761	S	3	0	3	0.00000
Borrelia coriaceae	144	S	2	0	2	0.00000
Borrelia sp. A-FGy1	2608247	S	2	0	2	0.00000
Borrelia crocidurae	29520	S	1	4	5	0.00000
Borrelia maritima	2761123	S	1	0	1	0.00000
Borreliella burgdorferi	139	S	4	1	5	0.00000
Borreliella garinii	29519	S	2	0	2	0.00000
Candidatus Borrelia tachyglossi	1964448	S	1	0	1	0.00000
Leptospira biflexa	172	S	9	-9	0	0.00000
Leptospira interrogans	173	S	4	0	4	0.00000
Leptospira santarosai	28183	S	2	0	2	0.00000
Leptospira mayottensis	1137606	S	2	0	2	0.00000
Leptospira weilii	28184	S	1	0	1	0.00000
Leptospira tipperaryensis	2564040	S	1	0	1	0.00000
Turneriella parva	29510	S	11	0	11	0.00001
Brachyspira hyodysenteriae	159	S	4	0	4	0.00000
Brachyspira pilosicoli	52584	S	3	0	3	0.00000
Brachyspira hampsonii	1287055	S	3	0	3	0.00000
Brachyspira intermedia	84377	S	2	0	2	0.00000
Brachyspira murdochii	84378	S	1	0	1	0.00000
Thermosipho sp. FR-w03	2814656	S	2	2	4	0.00000
Thermosipho africanus	2421	S	1	10	11	0.00001
Thermosipho melanesiensis	46541	S	1	9	10	0.00001
Fervidobacterium pennivorans	93466	S	4	2	6	0.00000
Fervidobacterium nodosum	2424	S	3	1	4	0.00000
Pseudothermotoga hypogea	57487	S	1	0	1	0.00000
Mesotoga infera	1236046	S	14	0	14	0.00001
Kosmotoga pacifica	1330330	S	10	0	10	0.00001
Tepiditoga spiralis	2108365	S	4	8	12	0.00001
Petrotoga mobilis	69499	S	1	1	2	0.00000
Athalassotoga saccharophila	1441386	S	1	0	1	0.00000
Fusobacterium nucleatum	851	S	13	6	19	0.00001
Fusobacterium varium	856	S	7	0	7	0.00000
Fusobacterium ulcerans	861	S	4	0	4	0.00000
Fusobacterium sp. NSJ-57	2764326	S	3	0	3	0.00000
Fusobacterium necrophorum	859	S	2	0	2	0.00000
Fusobacterium hwasookii	1583098	S	2	0	2	0.00000
Fusobacterium gonidiaformans	849	S	1	0	1	0.00000
Fusobacterium mortiferum	850	S	1	0	1	0.00000
Fusobacterium pseudoperiodonticum	2663009	S	1	0	1	0.00000
Ilyobacter polytropus	167642	S	1	0	1	0.00000
Leptotrichia sp. oral taxon 212	712357	S	4	0	4	0.00000
Leptotrichia sp. oral taxon 498	712368	S	1	1	2	0.00000
Leptotrichia buccalis	40542	S	4	1	5	0.00000
Leptotrichia wadei	157687	S	4	1	5	0.00000
Leptotrichia hofstadii	157688	S	2	0	2	0.00000
Leptotrichia shahii	157691	S	1	0	1	0.00000
Streptobacillus moniliformis	34105	S	5	0	5	0.00000
Sebaldella termitidis	826	S	4	0	4	0.00000
Pseudoleptotrichia goodfellowii	157692	S	4	0	4	0.00000
Candidatus Saccharimonas aalborgensis	1332188	S	25	5	30	0.00002
Candidatus Nanosynbacter lyticus	2093824	S	7	2	9	0.00001
Candidatus Bipolaricaulis anaerobius	2026885	S	7	0	7	0.00000
Candidatus Babela massiliensis	673862	S	6	0	6	0.00000
Candidatus Chazhemtobacterium aquaticus	2715735	S	4	0	4	0.00000
Nitrospira moscoviensis	42253	S	7	0	7	0.00000
Nitrospira japonica	1325564	S	7	1	8	0.00000
Candidatus Nitrospira inopinata	1715989	S	6	0	6	0.00000
Leptospirillum ferrooxidans	180	S	3	1	4	0.00000
Dissulfurispira thermophila	2715679	S	1	0	1	0.00000
Cloacibacillus porcorum	1197717	S	7	1	8	0.00000
Fretibacterium fastidiosum	651822	S	3	0	3	0.00000
Thermovirga lienii	336261	S	2	0	2	0.00000
Acetomicrobium mobile	97477	S	1	0	1	0.00000
Aminobacterium colombiense	81468	S	1	0	1	0.00000
Jonquetella anthropi	428712	S	1	0	1	0.00000
Sulfurihydrogenibium azorense	309806	S	3	0	3	0.00000
Sulfurihydrogenibium sp. YO3AOP1	436114	S	2	0	2	0.00000
Persephonella marina	309805	S	1	0	1	0.00000
Hydrogenobacter sp. T-8	1632019	S	1	0	1	0.00000
Aquifex aeolicus	63363	S	1	0	1	0.00000
Flexistipes sinusarabici	2352	S	3	0	3	0.00000
Deferribacter desulfuricans	197162	S	3	0	3	0.00000
Geovibrio thiophilus	139438	S	2	0	2	0.00000
Calditerrivibrio nitroreducens	477976	S	1	0	1	0.00000
Thermodesulfobacterium geofontis	1295609	S	3	0	3	0.00000
Caldimicrobium thiodismutans	1653476	S	2	0	2	0.00000
Thermodesulfatator indicus	171695	S	1	0	1	0.00000
Candidatus Endomicrobium trichonymphae	1408204	S	1	0	1	0.00000
Endomicrobium proavitum	1408281	S	1	0	1	0.00000
Elusimicrobium minutum	423605	S	3	0	3	0.00000
Abyssogena phaseoliformis symbiont	596095	S	2	0	2	0.00000
Isorropodon fossajaponicum symbiont	883811	S	2	0	2	0.00000
Coprothermobacter proteolyticus	35786	S	4	0	4	0.00000
Dictyoglomus thermophilum	14	S	2	0	2	0.00000
Dictyoglomus turgidum	513050	S	1	0	1	0.00000
Desulfurispirillum indicum	936456	S	2	0	2	0.00000
Caldithrix abyssi	187145	S	2	0	2	0.00000
Caldisericum exile	693075	S	1	0	1	0.00000
Methanosarcina sp. MTP4	1434100	S	7	0	7	0.00000
Methanosarcina sp. Kolksee	1434099	S	1	4	5	0.00000
Methanosarcina sp. WWM596	1434103	S	1	7	8	0.00000
Methanosarcina mazei	2209	S	14	1	15	0.00001
Methanosarcina barkeri	2208	S	12	1	13	0.00001
Methanosarcina lacustris	170861	S	6	0	6	0.00000
Methanosarcina horonobensis	418008	S	4	0	4	0.00000
Methanosarcina flavescens	1715806	S	4	1	5	0.00000
Methanosarcina thermophila	2210	S	3	-3	0	0.00000
Methanosarcina acetivorans	2214	S	2	0	2	0.00000
Methanosarcina siciliae	38027	S	2	0	2	0.00000
Methanomethylovorans hollandica	101192	S	13	0	13	0.00001
Methanohalophilus mahii	2176	S	1	0	1	0.00000
Methanothrix soehngenii	2223	S	74	0	74	0.00005
Methanosaeta harundinacea	301375	S	3	0	3	0.00000
Methanothrix thermoacetophila	2224	S	1	0	1	0.00000
Methanoregula formicica	882104	S	8	0	8	0.00000
Methanoregula boonei	358766	S	1	0	1	0.00000
Methanosphaerula palustris	475088	S	2	0	2	0.00000
Methanocorpusculum labreanum	83984	S	5	0	5	0.00000
Methanospirillum hungatei	2203	S	3	0	3	0.00000
Methanoplanus limicola	2315	S	1	0	1	0.00000
Natrialba magadii	13769	S	19	4	23	0.00001
Halovivax sp. KZCA124	2817025	S	6	0	6	0.00000
Halovivax ruber	387341	S	1	0	1	0.00000
Haloterrigena daqingensis	588898	S	2	0	2	0.00000
Haloterrigena salifodinae	2675099	S	2	0	2	0.00000
Haloterrigena sp. YPL8	1699371	S	1	0	1	0.00000
Natronococcus occultus	29288	S	2	0	2	0.00000
Natrinema sp. YPL30	1710539	S	1	1	2	0.00000
Natronorubrum bangense	61858	S	2	0	2	0.00000
Halopiger xanaduensis	387343	S	2	0	2	0.00000
Halobellus limi	699433	S	5	1	6	0.00000
Haloferax gibbonsii	35746	S	3	1	4	0.00000
Halogeometricum borinquense	60847	S	4	0	4	0.00000
Haloquadratum walsbyi	293091	S	3	0	3	0.00000
Haloplanus aerogenes	660522	S	1	0	1	0.00000
Haloprofundus sp. MHR1	2572921	S	1	0	1	0.00000
Halorubrum sp. RHB-C	2739057	S	4	1	5	0.00000
Halorubrum sp. PV6	634157	S	2	0	2	0.00000
Halorubrum sp. BOL3-1	2497325	S	1	0	1	0.00000
Halorubrum lacusprofundi	2247	S	2	1	3	0.00000
Halorubrum ezzemoulense	337243	S	1	0	1	0.00000
Halobonum sp. NJ-3-1	2743089	S	1	1	2	0.00000
Halosimplex litoreum	1198301	S	4	0	4	0.00000
Halosimplex rubrum	869889	S	2	0	2	0.00000
Halorhabdus tiamatea	430914	S	2	0	2	0.00000
Natronomonas sp. C90	2747817	S	1	0	1	0.00000
Halobacterium hubeiense	1407499	S	2	0	2	0.00000
Halobacterium sp. DL1	751944	S	1	0	1	0.00000
Halarchaeum sp. CBA1220	1853682	S	2	0	2	0.00000
Halorussus sp. RC-68	2505977	S	1	0	1	0.00000
Halorussus sp. ZS-3	2650975	S	1	0	1	0.00000
Salarchaeum sp. JOR-1	2599399	S	1	0	1	0.00000
Methanobrevibacter smithii	2173	S	28	0	28	0.00002
Methanobrevibacter sp. YE315	1609968	S	10	0	10	0.00001
Methanobrevibacter sp. AbM4	224719	S	5	0	5	0.00000
Methanobrevibacter olleyae	294671	S	9	0	9	0.00001
Methanobrevibacter millerae	230361	S	7	0	7	0.00000
Methanobrevibacter ruminantium	83816	S	2	0	2	0.00000
Methanobacterium formicicum	2162	S	7	0	7	0.00000
Methanobacterium congolense	118062	S	5	0	5	0.00000
Methanobacterium lacus	877455	S	4	0	4	0.00000
Methanobacterium paludis	868131	S	1	0	1	0.00000
Methanosphaera sp. BMS	1789762	S	2	0	2	0.00000
Methanothermus fervidus	2180	S	1	0	1	0.00000
Methanococcus maripaludis	39152	S	6	0	6	0.00000
Methanococcus aeolicus	42879	S	4	0	4	0.00000
Methanococcus vannielii	2187	S	2	0	2	0.00000
Methanothermococcus okinawensis	155863	S	1	0	1	0.00000
Methanocaldococcus bathoardescens	1301915	S	2	1	3	0.00000
Methanocaldococcus fervens	83171	S	1	0	1	0.00000
Methanofervidicoccus sp. A16	2607662	S	1	0	1	0.00000
Thermococcus barossii	54077	S	2	0	2	0.00000
Thermococcus paralvinellae	582419	S	2	0	2	0.00000
Thermococcus sibiricus	172049	S	2	0	2	0.00000
Pyrococcus sp. 12/1	758582	S	2	0	2	0.00000
Archaeoglobus profundus	84156	S	3	0	3	0.00000
Archaeoglobus fulgidus	2234	S	1	0	1	0.00000
Candidatus Nitrosotalea okcheonensis	1903276	S	18	0	18	0.00001
Candidatus Nitrosotenuis cloacae	1603555	S	6	0	6	0.00000
Candidatus Nitrosotenuis aquarius	1846278	S	1	0	1	0.00000
Nitrosopumilus cobalaminigenes	1470066	S	3	0	3	0.00000
Candidatus Nitrosopumilus sediminis	1229909	S	2	0	2	0.00000
Nitrosopumilus ureiphilus	1470067	S	2	0	2	0.00000
Candidatus Nitrosopumilus koreensis	1510466	S	2	0	2	0.00000
Nitrosopumilus oxyclinae	1959104	S	2	0	2	0.00000
Nitrosarchaeum sp. AC2	2259673	S	4	0	4	0.00000
Candidatus Nitrosomarinus catalina	1898749	S	1	0	1	0.00000
Candidatus Nitrosocosmicus franklandus	1798806	S	2	0	2	0.00000
Candidatus Nitrosocosmicus hydrocola	1826872	S	1	0	1	0.00000
Candidatus Nitrosocaldus islandicus	2045011	S	1	1	2	0.00000
Sulfolobus sp. A20	1891280	S	2	0	2	0.00000
Sulfolobus sp. S-194	2512240	S	1	0	1	0.00000
Acidianus ambivalens	2283	S	1	0	1	0.00000
Acidianus manzaensis	282676	S	1	0	1	0.00000
Acidianus hospitalis	563177	S	1	0	1	0.00000
Sulfurisphaera ohwakuensis	69656	S	2	0	2	0.00000
Sulfurisphaera tokodaii	111955	S	1	0	1	0.00000
Saccharolobus solfataricus	2287	S	2	1	3	0.00000
Sulfuracidifex tepidarius	1294262	S	1	0	1	0.00000
Thermofilum uzonense	1550241	S	1	3	4	0.00000
Pyrobaculum aerophilum	13773	S	1	0	1	0.00000
Pyrobaculum arsenaticum	121277	S	1	0	1	0.00000
Pyrobaculum calidifontis	181486	S	1	0	1	0.00000
Caldisphaera lagunensis	200415	S	2	0	2	0.00000
Picrophilus torridus	82076	S	2	0	2	0.00000
Ferroplasma acidarmanus	97393	S	1	3	4	0.00000
Candidatus Methanomassiliicoccus intestinalis	1406512	S	1	0	1	0.00000
Aciduliprofundum boonei	379547	S	2	4	6	0.00000
Candidatus Prometheoarchaeum syntrophicum	2594042	S	5	0	5	0.00000
Flavobacterium phage vB_FspS_mymlan6-1	2686266	S	9	30	39	0.00002
Flavobacterium phage vB_FspS_filifjonk9-1	2686245	S	7	13	20	0.00001
Synechococcus phage S-CBS3	753085	S	4	0	4	0.00000
Actinoplanes phage phiAsp2	279303	S	2	0	2	0.00000
Streptomyces phage Blueeyedbeauty	2250336	S	2	0	2	0.00000
Microbacterium phage PoRanda	2743924	S	2	0	2	0.00000
Streptomyces phage Comrade	2301714	S	2	0	2	0.00000
Streptomyces phage Yaboi	2301621	S	1	0	1	0.00000
Tsukamurella phage TPA4	1647476	S	1	0	1	0.00000
Geobacillus phage GBK2	1458842	S	1	0	1	0.00000
Flavobacterium phage vB_FspS_snusmum6-1	2686273	S	1	1	2	0.00000
Flavobacterium phage vB_FspS_tooticki6-1	2686279	S	1	4	5	0.00000
Paracoccus phage vB_PmaS-R3	2494563	S	1	0	1	0.00000
Propionibacterium phage BruceLethal	1654740	S	1	0	1	0.00000
Propionibacterium phage Enoki	1654780	S	1	0	1	0.00000
Propionibacterium virus PHL060L00	1982277	S	2	2	4	0.00000
Propionibacterium virus Keiki	1982255	S	1	4	5	0.00000
Propionibacterium virus Procrass1	1982304	S	1	0	1	0.00000
Propionibacterium virus PHL132N00	1982291	S	1	1	2	0.00000
Propionibacterium virus PAD20	1982271	S	1	0	1	0.00000
Propionibacterium virus PHL152M00	1982295	S	1	0	1	0.00000
Caulobacter virus CcrColossus	2734194	S	2	0	2	0.00000
Salmonella virus AG11	2005691	S	2	0	2	0.00000
Sphingobium virus Lacusarx	2560778	S	3	0	3	0.00000
Mycobacterium phage Larenn	1560285	S	1	0	1	0.00000
Mycobacterium virus Switzer	1993883	S	1	0	1	0.00000
Streptomyces virus Jay2Jay	2560786	S	2	0	2	0.00000
Mycobacterium phage Taquito	1897500	S	1	1	2	0.00000
Pseudomonas virus PMBT3	2734251	S	2	0	2	0.00000
Rhodococcus virus Trina	2560705	S	1	0	1	0.00000
Mycobacterium virus Deadp	1089120	S	1	5	6	0.00000
Gordonia virus BetterKatz	2560485	S	1	0	1	0.00000
Salmonella phage TS13	2500149	S	1	0	1	0.00000
Gordonia virus Eyre	2560492	S	1	0	1	0.00000
Gordonia virus GAL1	2560493	S	1	0	1	0.00000
Arthrobacter virus Sonali	2734279	S	1	0	1	0.00000
Rhodococcus virus Poco6	1982369	S	1	0	1	0.00000
Rhizobium phage RHEph10	1220717	S	1	0	1	0.00000
Lactococcus phage P656	2662298	S	1	0	1	0.00000
uncultured crAssphage	1211417	S	18	0	18	0.00001
Cellulophaga phage phi18:3	1327983	S	2	1	3	0.00000
Cellulophaga phage phi19:3	1327971	S	1	0	1	0.00000
Bacteroides phage crAss001	2301731	S	1	0	1	0.00000
Streptomyces phage Immanuel3	2053813	S	8	4	12	0.00001
Rhodoferax phage P26218	1636270	S	8	0	8	0.00000
Pseudomonas phage vB_PaeP_Tr60_Ab31	1449437	S	3	27	30	0.00002
Enterobacter phage EcP1	942016	S	1	0	1	0.00000
Streptomyces phage FlowerPower	2182408	S	1	1	2	0.00000
Pseudoalteromonas phage HP1	1357706	S	1	0	1	0.00000
Erwinia virus Frozen	1982578	S	4	0	4	0.00000
Erwinia virus Ea9-2	1982577	S	2	0	2	0.00000
Pseudomonas virus Bjorn	2560658	S	2	0	2	0.00000
Escherichia virus APEC7	1920755	S	1	0	1	0.00000
Cyanophage S-RIM32	1278479	S	7	0	7	0.00000
Prochlorococcus phage P-TIM68	1542477	S	2	0	2	0.00000
Serratia phage Moabite	2587814	S	1	0	1	0.00000
Tenacibaculum phage pT24	1880590	S	1	0	1	0.00000
Acinetobacter phage YMC13/03/R2096	1560342	S	1	0	1	0.00000
Streptomyces phage BRock	1913591	S	1	0	1	0.00000
Bacillus phage vB_BboS-125	2419618	S	1	0	1	0.00000
Pseudomonas virus KIL4	2560666	S	9	2	11	0.00001
Clostridium virus phiCD27	559189	S	2	38	40	0.00002
Synechococcus virus ST4	2734145	S	2	0	2	0.00000
Aeromonas virus 31	321023	S	1	0	1	0.00000
Ralstonia virus RSL2	1980925	S	1	0	1	0.00000
Campylobacter virus CP30A	1980966	S	1	0	1	0.00000
Synechococcus virus SRIM50	2734122	S	1	0	1	0.00000
Synechococcus virus STIM5	2734088	S	1	0	1	0.00000
Erwinia virus Ea35-70	1984778	S	1	0	1	0.00000
Synechococcus virus Bellamy	2734095	S	1	0	1	0.00000
Prochlorococcus virus MED4-213	2734106	S	1	0	1	0.00000
Synechococcus virus SRIM44	2734152	S	1	0	1	0.00000
Edwardsiella virus GF2	2560409	S	1	2	3	0.00000
Citrobacter phage CVT22	1622234	S	2	0	2	0.00000
Escherichia virus EG1	2733876	S	1	0	1	0.00000
Pagavirus S05C849	2733940	S	1	0	1	0.00000
Ralstonia phage RSP15	1785960	S	1	0	1	0.00000
Staphylococcus virus Remus	1857890	S	1	-1	0	0.00000
Elephantid betaherpesvirus 1	146015	S	1	0	1	0.00000
Equid gammaherpesvirus 5	10371	S	1	0	1	0.00000
Cyprinid herpesvirus 1	317858	S	2	0	2	0.00000
Paramecium bursaria Chlorella virus A1	381899	S	60	0	60	0.00004
Acanthocystis turfacea chlorella virus 1	322019	S	4	0	4	0.00000
Only Syngen Nebraska virus 5	1917232	S	1	3	4	0.00000
Bathycoccus sp. RCC1105 virus BpV	933845	S	5	0	5	0.00000
Yellowstone lake phycodnavirus 2	1586714	S	2	0	2	0.00000
Micromonas pusilla virus SP1	373996	S	1	0	1	0.00000
Chrysochromulina ericina virus	455364	S	1	0	1	0.00000
Aureococcus anophagefferens virus	1474867	S	1	0	1	0.00000
Phaeocystis globosa virus	251749	S	1	0	1	0.00000
Megavirus chiliensis	1094892	S	4	0	4	0.00000
Mimivirus terra2	1128151	S	2	0	2	0.00000
Yellowstone lake mimivirus	1586712	S	3	0	3	0.00000
Cafeteria roenbergensis virus	1513235	S	3	0	3	0.00000
Invertebrate iridescent virus 31	345199	S	7	0	7	0.00000
Invertebrate iridescent virus 9	345195	S	2	0	2	0.00000
Singapore grouper iridovirus	262968	S	1	0	1	0.00000
Tokyovirus A1	1826170	S	1	0	1	0.00000
Choristoneura biennis entomopoxvirus	10288	S	1	0	1	0.00000
Melanoplus sanguinipes entomopoxvirus	83191	S	1	0	1	0.00000
Chimeric virus 14	1608440	S	40	0	40	0.00002
Pandoravirus inopinatum	1605721	S	4	0	4	0.00000
Pandoravirus salinus	1349410	S	1	0	1	0.00000
Pandoravirus macleodensis	2107707	S	1	0	1	0.00000
Pandoravirus neocaledonia	2107708	S	1	0	1	0.00000
Lymantria dispar multiple nucleopolyhedrovirus	10449	S	2	0	2	0.00000
Agrotis ipsilon multiple nucleopolyhedrovirus	208013	S	2	0	2	0.00000
Sucra jujuba nucleopolyhedrovirus	1563660	S	1	0	1	0.00000
Mythimna unipuncta granulovirus B	2169746	S	1	0	1	0.00000
Heliothis zea nudivirus	29250	S	5	0	5	0.00000
Drosophila innubila nudivirus	2057187	S	1	0	1	0.00000
Rhinolophus associated gemykibivirus 2	2004966	S	1	0	1	0.00000
Sulfolobus virus STSV1	285013	S	1	0	1	0.00000
