name	taxonomy_id	taxonomy_lvl	kraken_assigned_reads	added_reads	new_est_reads	fraction_total_reads
Homo sapiens	9606	S	862658	349	863007	0.99504
Variovorax sp. 38R	2774875	S	16	14	30	0.00003
Variovorax sp. PAMC26660	2762322	S	11	1	12	0.00001
Variovorax sp. PAMC 28711	1795631	S	7	0	7	0.00001
Variovorax sp. RKNM96	2681552	S	6	1	7	0.00001
Variovorax sp. HW608	1034889	S	6	0	6	0.00001
Variovorax sp. WDL1	207745	S	4	5	9	0.00001
Variovorax sp. PBL-H6	434009	S	4	9	13	0.00001
Variovorax sp. SRS16	282217	S	3	13	16	0.00002
Variovorax sp. RA8	662548	S	2	1	3	0.00000
Variovorax sp. PBS-H4	434008	S	2	0	2	0.00000
Variovorax sp. PBL-E5	434014	S	1	5	6	0.00001
Variovorax sp. PAMC28562	2762323	S	1	0	1	0.00000
Variovorax boronicumulans	436515	S	35	22	57	0.00007
Variovorax paradoxus	34073	S	32	8	40	0.00005
Acidovorax sp. KKS102	358220	S	58	15	73	0.00008
Acidovorax sp. JMULE5	2518343	S	38	5	43	0.00005
Acidovorax sp. RAC01	1842533	S	13	3	16	0.00002
Acidovorax sp. 1608163	2478662	S	11	1	12	0.00001
Acidovorax sp. T1	1858609	S	7	9	16	0.00002
Acidovorax sp. HDW3	2714923	S	4	0	4	0.00000
Acidovorax sp. JS42	232721	S	1	11	12	0.00001
Acidovorax carolinensis	553814	S	11	5	16	0.00002
Acidovorax avenae	80867	S	4	2	6	0.00001
Acidovorax antarcticus	2743470	S	4	0	4	0.00000
Acidovorax monticola	1926868	S	3	0	3	0.00000
Diaphorobacter sp. HDW4A	2714924	S	51	14	65	0.00007
Diaphorobacter sp. JS3051	2792224	S	2	20	22	0.00003
Diaphorobacter sp. HDW4B	2714925	S	1	0	1	0.00000
Diaphorobacter aerolatus	1288495	S	9	3	12	0.00001
Diaphorobacter polyhydroxybutyrativorans	1546149	S	1	4	5	0.00001
Diaphorobacter ruginosibacter	1715720	S	1	0	1	0.00000
Delftia lacustris	558537	S	7	23	30	0.00003
Delftia acidovorans	80866	S	5	5	10	0.00001
Delftia tsuruhatensis	180282	S	1	2	3	0.00000
Hydrogenophaga sp. PBC	795665	S	6	1	7	0.00001
Hydrogenophaga sp. PBL-H3	434010	S	4	2	6	0.00001
Hydrogenophaga sp. RAC07	1842537	S	4	1	5	0.00001
Hydrogenophaga sp. BPS33	2651974	S	4	1	5	0.00001
Hydrogenophaga sp. YM1	2806262	S	4	1	5	0.00001
Hydrogenophaga sp. NH-16	2184519	S	1	0	1	0.00000
Hydrogenophaga sp. BA0156	2716225	S	1	0	1	0.00000
Hydrogenophaga pseudoflava	47421	S	4	0	4	0.00000
Comamonas testosteroni	285	S	5	2	7	0.00001
Comamonas kerstersii	225992	S	4	0	4	0.00000
Comamonas aquatica	225991	S	3	0	3	0.00000
Comamonas piscis	1562974	S	3	0	3	0.00000
Comamonas sp. NLF-7-7	2597701	S	3	0	3	0.00000
Comamonas thiooxydans	363952	S	2	1	3	0.00000
Rhodoferax sp. BAB1	2741720	S	4	0	4	0.00000
Rhodoferax sp. AJA081-3	2752316	S	3	0	3	0.00000
Rhodoferax sp. PAMC29310	2822760	S	3	0	3	0.00000
Rhodoferax koreense	1842727	S	4	1	5	0.00001
Rhodoferax sediminis	2509614	S	4	0	4	0.00000
Rhodoferax antarcticus	81479	S	2	0	2	0.00000
Rhodoferax saidenbachensis	1484693	S	1	0	1	0.00000
Ottowia oryzae	2109914	S	11	0	11	0.00001
Ottowia sp. 27C	2816950	S	2	0	2	0.00000
Ottowia sp. oral taxon 894	1658672	S	1	0	1	0.00000
Alicycliphilus denitrificans	179636	S	12	12	24	0.00003
Polaromonas sp. JS666	296591	S	5	1	6	0.00001
Polaromonas naphthalenivorans	216465	S	4	0	4	0.00000
Limnohabitans sp. 63ED37-2	1678128	S	7	0	7	0.00001
Limnohabitans sp. 103DPR2	1678129	S	1	0	1	0.00000
Kinneretia sp. DAIF2	2714952	S	7	0	7	0.00001
Curvibacter sp. AEP1-3	1844971	S	7	0	7	0.00001
Ramlibacter tataouinensis	94132	S	6	0	6	0.00001
Verminephrobacter eiseniae	364317	S	6	0	6	0.00001
Schlegelella thermodepolymerans	215580	S	4	0	4	0.00000
Serpentinomonas mccroryi	1458426	S	2	0	2	0.00000
Melaminivora sp. SC2-9	2109913	S	2	0	2	0.00000
Pulveribacter suum	2116657	S	1	0	1	0.00000
Simplicispira suum	2109915	S	1	0	1	0.00000
Janthinobacterium sp. HH102	1537274	S	28	42	70	0.00008
Janthinobacterium sp. LM6	1938606	S	28	9	37	0.00004
Janthinobacterium sp. 1_2014MBL_MicDiv	1644131	S	15	2	17	0.00002
Janthinobacterium sp. PLB02	2808899	S	4	6	10	0.00001
Janthinobacterium sp. B9-8	1236179	S	1	0	1	0.00000
Janthinobacterium tructae	2590869	S	20	6	26	0.00003
Janthinobacterium agaricidamnosum	55508	S	17	18	35	0.00004
Janthinobacterium lividum	29581	S	9	9	18	0.00002
Janthinobacterium svalbardensis	368607	S	8	2	10	0.00001
Collimonas fungivorans	158899	S	6	0	6	0.00001
Collimonas arenae	279058	S	1	0	1	0.00000
Collimonas pratensis	279113	S	1	0	1	0.00000
Massilia sp. YMA4	1593482	S	1	0	1	0.00000
Massilia sp. NR 4-1	1678028	S	1	0	1	0.00000
Massilia sp. CCM 8941	2765360	S	1	0	1	0.00000
Massilia umbonata	864828	S	1	0	1	0.00000
Massilia flava	871742	S	1	0	1	0.00000
Massilia violaceinigra	2045208	S	1	0	1	0.00000
Undibacterium sp. KW1	2058624	S	2	0	2	0.00000
Undibacterium sp. YM2	2058625	S	2	0	2	0.00000
Herbaspirillum seropedicae	964	S	1	1	2	0.00000
Duganella sp. AF9R3	2728021	S	1	0	1	0.00000
Noviherbaspirillum sp. UKPF54	2601898	S	1	0	1	0.00000
Burkholderia pseudomallei	28450	S	3	7	10	0.00001
Burkholderia thailandensis	57975	S	3	1	4	0.00000
Burkholderia lata	482957	S	2	2	4	0.00000
Burkholderia sp. IDO3	1705310	S	2	6	8	0.00001
Burkholderia sp. CCGE1003	640512	S	1	0	1	0.00000
Burkholderia gladioli	28095	S	1	0	1	0.00000
Polynucleobacter difficilis	556054	S	10	0	10	0.00001
Polynucleobacter acidiphobus	556053	S	2	0	2	0.00000
Polynucleobacter asymbioticus	576611	S	1	0	1	0.00000
Paraburkholderia caribensis	75105	S	2	1	3	0.00000
Paraburkholderia sp. SOS3	1926494	S	1	0	1	0.00000
Paraburkholderia sp. PGU19	2735434	S	1	0	1	0.00000
Paraburkholderia phytofirmans	261302	S	2	1	3	0.00000
Paraburkholderia graminis	60548	S	1	0	1	0.00000
Paraburkholderia acidiphila	2571747	S	1	0	1	0.00000
Paraburkholderia aromaticivorans	2026199	S	1	0	1	0.00000
Paraburkholderia phenoliruptrix	252970	S	1	0	1	0.00000
Cupriavidus metallidurans	119219	S	3	1	4	0.00000
Cupriavidus taiwanensis	164546	S	3	1	4	0.00000
Cupriavidus basilensis	68895	S	1	0	1	0.00000
Cupriavidus pauculus	82633	S	1	0	1	0.00000
Cupriavidus neocaledonicus	1040979	S	1	0	1	0.00000
Ralstonia insidiosa	190721	S	1	1	2	0.00000
Pandoraea fibrosis	1891094	S	1	0	1	0.00000
Limnobacter sp. SAORIC-580	2732163	S	1	0	1	0.00000
Chitinimonas arctica	2594795	S	1	0	1	0.00000
Ephemeroptericola cinctiostellae	2268024	S	1	0	1	0.00000
Roseateles depolymerans	76731	S	10	1	11	0.00001
Paucibacter sp. KCTC 42545	1768242	S	9	1	10	0.00001
Rhizobacter sp. AJA081-3	2753607	S	5	0	5	0.00001
Rhizobacter gummiphilus	946333	S	3	0	3	0.00000
Mitsuaria sp. 7	1658665	S	7	1	8	0.00001
Rubrivivax gelatinosus	28068	S	6	1	7	0.00001
Inhella inkyongensis	392593	S	5	0	5	0.00001
Aquabacterium olei	1296669	S	4	0	4	0.00000
Leptothrix cholodnii	34029	S	3	0	3	0.00000
Thiomonas intermedia	926	S	3	0	3	0.00000
Sphaerotilus natans	34103	S	3	0	3	0.00000
Xylophilus rhododendri	2697032	S	1	0	1	0.00000
Achromobacter xylosoxidans	85698	S	4	8	12	0.00001
Achromobacter sp. AONIH1	1758194	S	1	0	1	0.00000
Achromobacter sp. MFA1 R4	1881016	S	1	0	1	0.00000
Bordetella petrii	94624	S	2	0	2	0.00000
Bordetella genomosp. 13	463040	S	2	0	2	0.00000
Bordetella hinzii	103855	S	1	0	1	0.00000
Bordetella trematum	123899	S	1	0	1	0.00000
Bordetella flabilis	463014	S	1	0	1	0.00000
Bordetella genomosp. 6	463024	S	1	1	2	0.00000
Bordetella genomosp. 9	1416803	S	1	0	1	0.00000
Bordetella sp. N	1746199	S	1	0	1	0.00000
Alcaligenes faecalis	511	S	2	0	2	0.00000
Castellaniella defragrans	75697	S	1	0	1	0.00000
Sulfuritalea hydrogenivorans	748811	S	4	0	4	0.00000
Methyloversatilis sp. RAC08	1842540	S	1	0	1	0.00000
Methylophilus medardicus	2588534	S	1	0	1	0.00000
Methylotenera versatilis	1055487	S	1	0	1	0.00000
Candidatus Methylopumilus turicensis	1581680	S	1	0	1	0.00000
Gallionella capsiferriformans	370405	S	2	0	2	0.00000
Candidatus Nitrotoga sp. AM1P	2559597	S	1	0	1	0.00000
Ferriphaselus amnicola	1188319	S	1	0	1	0.00000
Usitatibacter rugosus	2732067	S	2	0	2	0.00000
Usitatibacter palustris	2732487	S	1	0	1	0.00000
Nitrosomonas sp. Is79A3	261292	S	2	0	2	0.00000
Sulfurimicrobium lacus	2715678	S	2	0	2	0.00000
Thiobacillus denitrificans	36861	S	1	0	1	0.00000
Azospira oryzae	146939	S	2	0	2	0.00000
Azospira sp. I09	1765049	S	2	0	2	0.00000
Aromatoleum aromaticum	551760	S	1	0	1	0.00000
Oryzomicrobium terrae	1735038	S	1	0	1	0.00000
Rugosibacter aromaticivorans	1565605	S	1	0	1	0.00000
Azoarcus sp. M9-3-2	2016596	S	2	0	2	0.00000
Azoarcus sp. CIB	198107	S	1	0	1	0.00000
Azoarcus communis	41977	S	1	0	1	0.00000
Azoarcus pumilus	2067960	S	1	0	1	0.00000
Thauera humireducens	1134435	S	1	0	1	0.00000
Thauera sp. K11	2005884	S	1	0	1	0.00000
Laribacter hongkongensis	168471	S	2	0	2	0.00000
Vogesella sp. LIG4	1192162	S	1	0	1	0.00000
Vitreoscilla filiformis	63	S	1	0	1	0.00000
Neisseria animalis	492	S	1	0	1	0.00000
Candidatus Accumulibacter phosphatis	327160	S	3	0	3	0.00000
Casimicrobium huifangae	2591109	S	1	0	1	0.00000
Acinetobacter junii	40215	S	145	19	164	0.00019
Acinetobacter baumannii	470	S	6	18	24	0.00003
Acinetobacter nosocomialis	106654	S	1	0	1	0.00000
Acinetobacter haemolyticus	29430	S	3	0	3	0.00000
Acinetobacter sp. WCHA45	2004644	S	1	0	1	0.00000
Acinetobacter sp. TTH0-4	1646498	S	1	0	1	0.00000
Acinetobacter guillouiae	106649	S	2	0	2	0.00000
Acinetobacter tandoii	202954	S	1	0	1	0.00000
Acinetobacter indicus	756892	S	1	0	1	0.00000
Acinetobacter towneri	202956	S	1	1	2	0.00000
Acinetobacter lwoffii	28090	S	1	0	1	0.00000
Acinetobacter ursingii	108980	S	1	0	1	0.00000
Moraxella osloensis	34062	S	7	0	7	0.00001
Moraxella catarrhalis	480	S	1	0	1	0.00000
Psychrobacter arcticus	334543	S	1	0	1	0.00000
Pseudomonas fluorescens	294	S	20	3	23	0.00003
Pseudomonas tolaasii	29442	S	7	0	7	0.00001
Pseudomonas veronii	76761	S	5	3	8	0.00001
Pseudomonas synxantha	47883	S	3	0	3	0.00000
Pseudomonas cedrina	651740	S	1	0	1	0.00000
Pseudomonas protegens	380021	S	1	0	1	0.00000
Pseudomonas mandelii	75612	S	1	0	1	0.00000
Pseudomonas sp. OST1909	2777367	S	2	1	3	0.00000
Pseudomonas sp. CMR12a	658629	S	2	1	3	0.00000
Pseudomonas sp. J380	2605424	S	1	0	1	0.00000
Pseudomonas sp. ADAK13	2730847	S	1	0	1	0.00000
Pseudomonas sp. R4-39-08	1173288	S	1	0	1	0.00000
Pseudomonas sp. DG56-2	2320270	S	1	0	1	0.00000
Pseudomonas sp. UW4	1207075	S	1	0	1	0.00000
Pseudomonas sp. URMO17WK12:I11	1283291	S	1	0	1	0.00000
Pseudomonas sp. CC6-YY-74	1930532	S	1	0	1	0.00000
Pseudomonas sp. RtIB026	2749999	S	1	0	1	0.00000
Pseudomonas sp. 14181154	2662033	S	1	0	1	0.00000
Pseudomonas aeruginosa	287	S	3	3	6	0.00001
Pseudomonas citronellolis	53408	S	3	0	3	0.00000
Pseudomonas multiresinivorans	95301	S	2	0	2	0.00000
Pseudomonas alcaligenes	43263	S	1	0	1	0.00000
Pseudomonas furukawaii	1149133	S	1	0	1	0.00000
Pseudomonas stutzeri	316	S	6	0	6	0.00001
Pseudomonas putida	303	S	2	0	2	0.00000
Pseudomonas fulva	47880	S	2	3	5	0.00001
Pseudomonas kribbensis	1628086	S	2	0	2	0.00000
Pseudomonas lurida	244566	S	2	0	2	0.00000
Pseudomonas palleroniana	191390	S	1	0	1	0.00000
Pseudomonas chlororaphis	587753	S	1	0	1	0.00000
Klebsiella pneumoniae	573	S	112	168	280	0.00032
Klebsiella quasipneumoniae	1463165	S	1	0	1	0.00000
Citrobacter rodentium	67825	S	1	0	1	0.00000
Citrobacter freundii	546	S	1	3	4	0.00000
Enterobacter cloacae	550	S	1	3	4	0.00000
Escherichia coli	562	S	3	5	8	0.00001
Escherichia fergusonii	564	S	1	0	1	0.00000
Salmonella enterica	28901	S	1	2	3	0.00000
Pseudescherichia vulneris	566	S	2	0	2	0.00000
Phytobacter ursingii	1972431	S	1	0	1	0.00000
Cronobacter sakazakii	28141	S	1	0	1	0.00000
Candidatus Ishikawaella capsulata	168169	S	1	0	1	0.00000
Blochmannia endosymbiont of Polyrhachis (Hedomyrma) turneri	1505596	S	1	0	1	0.00000
Serratia marcescens	615	S	3	0	3	0.00000
Serratia liquefaciens	614	S	2	0	2	0.00000
Serratia fonticola	47917	S	2	0	2	0.00000
Serratia proteamaculans	28151	S	1	0	1	0.00000
Serratia rubidaea	61652	S	1	0	1	0.00000
Yersinia pseudotuberculosis	633	S	1	0	1	0.00000
Yersinia sp. KBS0713	1179669	S	1	1	2	0.00000
Ewingella americana	41202	S	1	0	1	0.00000
Photorhabdus thracensis	230089	S	4	0	4	0.00000
Proteus vulgaris	585	S	1	0	1	0.00000
Xenorhabdus bovienii	40576	S	1	0	1	0.00000
Buchnera aphidicola	9	S	3	0	3	0.00000
Pantoea sp. PSNIH1	1484158	S	2	0	2	0.00000
Hafnia alvei	569	S	1	0	1	0.00000
Lysobacter enzymogenes	69	S	17	0	17	0.00002
Lysobacter soli	453783	S	2	0	2	0.00000
Lysobacter lycopersici	1324796	S	2	0	2	0.00000
Lysobacter maris	1605891	S	2	0	2	0.00000
Lysobacter capsici	435897	S	1	0	1	0.00000
Xanthomonas euvesicatoria	456327	S	10	151	161	0.00019
Xanthomonas campestris	339	S	6	0	6	0.00001
Xanthomonas sp. GW	2724121	S	1	0	1	0.00000
Xanthomonas oryzae	347	S	1	0	1	0.00000
Xanthomonas arboricola	56448	S	1	0	1	0.00000
Xanthomonas hortorum	56454	S	1	0	1	0.00000
Xanthomonas vasicola	56459	S	1	0	1	0.00000
Stenotrophomonas maltophilia	40324	S	3	1	4	0.00000
Stenotrophomonas sp. Pemsol	2040586	S	1	0	1	0.00000
Stenotrophomonas sp. 364	2691571	S	1	0	1	0.00000
Stenotrophomonas rhizophila	216778	S	2	0	2	0.00000
Pseudoxanthomonas mexicana	128785	S	5	0	5	0.00001
Pseudoxanthomonas spadix	415229	S	2	0	2	0.00000
Arenimonas daejeonensis	370777	S	2	0	2	0.00000
Luteimonas sp. JM171	1896164	S	1	0	1	0.00000
Dokdonella koreensis	323415	S	2	0	2	0.00000
Dyella japonica	231455	S	1	0	1	0.00000
Halomonas sp. JS92-SW72	2306583	S	8	1	9	0.00001
Halomonas sp. YLGW01	2773308	S	1	0	1	0.00000
Halomonas sp. THAF12	2587849	S	1	0	1	0.00000
Halomonas sp. THAF5a	2587844	S	1	0	1	0.00000
Halomonas piezotolerans	2609667	S	1	0	1	0.00000
Halomonas hydrothermalis	115561	S	1	0	1	0.00000
Candidatus Portiera aleyrodidarum	91844	S	1	0	1	0.00000
Halotalea alkalilenta	376489	S	1	0	1	0.00000
Bacterioplanes sanyensis	1249553	S	2	0	2	0.00000
Thalassolituus oleivorans	187493	S	1	0	1	0.00000
Spartinivicinus ruber	2683272	S	3	0	3	0.00000
Haemophilus parainfluenzae	729	S	7	0	7	0.00001
Haemophilus influenzae	727	S	1	0	1	0.00000
Aggregatibacter sp. 2125159857	2820817	S	4	0	4	0.00000
Pasteurella multocida	747	S	1	0	1	0.00000
Mannheimia varigena	85404	S	1	0	1	0.00000
Actinobacillus pleuropneumoniae	715	S	1	0	1	0.00000
Vibrio harveyi	669	S	3	0	3	0.00000
Vibrio alginolyticus	663	S	1	0	1	0.00000
Vibrio owensii	696485	S	1	0	1	0.00000
Vibrio anguillarum	55601	S	2	0	2	0.00000
Vibrio spartinae	1918945	S	1	0	1	0.00000
Vibrio tritonius	1435069	S	1	0	1	0.00000
Photobacterium damselae	38293	S	1	0	1	0.00000
Marinobacter sp. JH2	2547598	S	1	1	2	0.00000
Glaciecola nitratireducens	300231	S	1	0	1	0.00000
Shewanella algae	38313	S	1	2	3	0.00000
Pseudoalteromonas aliena	247523	S	1	0	1	0.00000
Pseudoalteromonas prydzensis	182141	S	1	0	1	0.00000
Colwellia sp. MT41	58049	S	1	0	1	0.00000
Francisella halioticida	549298	S	3	2	5	0.00001
Thiomicrorhabdus aquaedulcis	2211106	S	1	0	1	0.00000
Thiothrix sp.	1032	S	1	0	1	0.00000
Methylomonas sp. LL1	2785785	S	4	0	4	0.00000
Methylomonas sp. LW13	107637	S	1	0	1	0.00000
Methylomicrobium album	39775	S	2	0	2	0.00000
Rheinheimera sp. F8	1763998	S	1	0	1	0.00000
Rheinheimera sp. LHK132	2498451	S	1	0	1	0.00000
Thioflavicoccus mobilis	80679	S	1	0	1	0.00000
Woeseia oceani	1548547	S	2	0	2	0.00000
Thioalkalivibrio nitratireducens	186931	S	1	0	1	0.00000
Thiohalobacter sp. COW1	2795687	S	1	0	1	0.00000
Legionella sp. MW5194	2662448	S	2	0	2	0.00000
Legionella sp. TUM19329	2708020	S	2	0	2	0.00000
Legionella hackeliae	449	S	1	0	1	0.00000
Candidatus Coxiella mudrowiae	2054173	S	1	0	1	0.00000
Halioglobus maricola	2601894	S	3	0	3	0.00000
Aeromonas sp. CU5	2033033	S	2	0	2	0.00000
Solimonas sp. K1W22B-7	2303331	S	2	0	2	0.00000
Candidatus Nardonella dryophthoridicola	1971485	S	1	0	1	0.00000
endosymbiont of unidentified scaly snail isolate Monju	1248727	S	1	0	1	0.00000
Immundisolibacter cernigliae	1810504	S	1	0	1	0.00000
Bradyrhizobium sp. CCBAU 51765	1325102	S	5	2	7	0.00001
Bradyrhizobium sp. BTAi1	288000	S	3	0	3	0.00000
Bradyrhizobium sp. ORS 285	115808	S	2	0	2	0.00000
Bradyrhizobium sp. CCBAU 051011	858422	S	2	0	2	0.00000
Bradyrhizobium sp. SK17	2057741	S	2	1	3	0.00000
Bradyrhizobium sp. 6(2017)	1197460	S	1	0	1	0.00000
Bradyrhizobium sp. CCBAU 51753	1325100	S	1	0	1	0.00000
Bradyrhizobium sp. CCBAU 53340	1325112	S	1	0	1	0.00000
Bradyrhizobium betae	244734	S	4	1	5	0.00001
Bradyrhizobium lablabi	722472	S	3	3	6	0.00001
Bradyrhizobium paxllaeri	190148	S	2	0	2	0.00000
Bradyrhizobium genosp. B	83627	S	1	0	1	0.00000
Bradyrhizobium canariense	255045	S	1	0	1	0.00000
Bradyrhizobium arachidis	858423	S	1	0	1	0.00000
Bradyrhizobium cosmicum	1404864	S	1	0	1	0.00000
Bradyrhizobium amphicarpaeae	1404768	S	1	0	1	0.00000
Bradyrhizobium diazoefficiens	1355477	S	1	0	1	0.00000
Bradyrhizobium zhanjiangense	1325107	S	1	0	1	0.00000
Bosea sp. ANAM02	2020412	S	5	1	6	0.00001
Bosea sp. F3-2	2599640	S	3	0	3	0.00000
Bosea sp. RAC05	1842539	S	1	0	1	0.00000
Bosea sp. AS-1	2015316	S	1	0	1	0.00000
Bosea vaviloviae	1526658	S	2	0	2	0.00000
Tardiphaga robiniae	943830	S	1	0	1	0.00000
Afipia sp. GAS231	1882747	S	2	1	3	0.00000
Rhodopseudomonas palustris	1076	S	2	0	2	0.00000
Variibacter gotjawalensis	1333996	S	2	0	2	0.00000
Nitrobacter hamburgensis	912	S	1	0	1	0.00000
Methylobacterium sp. WL1	2603276	S	6	1	7	0.00001
Methylobacterium sp. 17Sr1-43	2202828	S	2	0	2	0.00000
Methylobacterium sp. DM1	2067957	S	1	3	4	0.00000
Methylobacterium sp. 17Sr1-1	2202826	S	1	1	2	0.00000
Methylobacterium aquaticum	270351	S	3	3	6	0.00001
Methylobacterium brachiatum	269660	S	2	1	3	0.00000
Methylobacterium mesophilicum	39956	S	1	0	1	0.00000
Methylobacterium nodulans	114616	S	1	0	1	0.00000
Methylobacterium durans	2202825	S	1	0	1	0.00000
Methylorubrum populi	223967	S	6	3	9	0.00001
Methylorubrum extorquens	408	S	4	4	8	0.00001
Mesorhizobium sp. Pch-S	2082387	S	6	0	6	0.00001
Mesorhizobium sp. M1B.F.Ca.ET.045.04.1.1	2493673	S	2	0	2	0.00000
Mesorhizobium sp. 113-3-9	2744517	S	1	1	2	0.00000
Mesorhizobium sp. M8A.F.Ca.ET.057.01.1.1	2493679	S	1	0	1	0.00000
Mesorhizobium sp. 8	2584466	S	1	0	1	0.00000
Mesorhizobium sp. INR15	2654248	S	1	0	1	0.00000
Mesorhizobium sp. 131-2-1	2744518	S	1	0	1	0.00000
Mesorhizobium sp. DCY119	2108445	S	1	0	1	0.00000
Mesorhizobium loti	381	S	1	0	1	0.00000
Aminobacter sp. MDW-2	2666139	S	5	11	16	0.00002
Aminobacter sp. MSH1	374606	S	3	0	3	0.00000
Phyllobacterium zundukense	1867719	S	1	0	1	0.00000
Rhizobium leguminosarum	384	S	2	1	3	0.00000
Rhizobium sp. 007	2785056	S	1	2	3	0.00000
Agrobacterium tumefaciens	358	S	2	1	3	0.00000
Agrobacterium sp. T29	2580515	S	2	0	2	0.00000
Neorhizobium sp. NCHU2750	1825976	S	1	0	1	0.00000
Sinorhizobium meliloti	382	S	1	1	2	0.00000
Sinorhizobium sp. CCBAU 05631	794846	S	1	1	2	0.00000
Ensifer adhaerens	106592	S	2	0	2	0.00000
Aquabacter sp. L1I39	2820278	S	3	0	3	0.00000
Devosia sp. A16	1736675	S	2	0	2	0.00000
Devosia sp. I507	2083786	S	1	0	1	0.00000
Hyphomicrobium denitrificans	53399	S	1	0	1	0.00000
Hyphomicrobium sp. MC1	717785	S	1	0	1	0.00000
Rhodoplanes sp. Z2-YC6860	674703	S	1	0	1	0.00000
Pelagibacterium halotolerans	531813	S	1	0	1	0.00000
Labrenzia sp. THAF35	2587854	S	1	1	2	0.00000
Labrenzia sp. THAF82	2587861	S	1	0	1	0.00000
Stappia sp. ES.058	1881061	S	1	0	1	0.00000
Pannonibacter phragmitetus	121719	S	1	0	1	0.00000
Candidatus Hodgkinia cicadicola	573658	S	1	0	1	0.00000
Hartmannibacter diazotrophicus	1482074	S	1	0	1	0.00000
Pseudorhodoplanes sinuspersici	1235591	S	1	0	1	0.00000
Chelatococcus sp. CO-6	1702325	S	2	0	2	0.00000
Methylocystis rosea	173366	S	1	0	1	0.00000
Methylocystis bryophila	655015	S	1	0	1	0.00000
Aureimonas sp. LMG 31693	2758041	S	1	0	1	0.00000
Xanthobacter sp. YN2	2528964	S	1	0	1	0.00000
Breoghania sp. L-A4	2304600	S	1	0	1	0.00000
Pyruvatibacter mobilis	1712261	S	1	0	1	0.00000
Sphingomonas sp. PAMC26645	2565555	S	5	1	6	0.00001
Sphingomonas sp. DH-S5	2759526	S	2	0	2	0.00000
Sphingomonas sp. Cra20	1327635	S	2	0	2	0.00000
Sphingomonas sp. HMP6	1517551	S	2	0	2	0.00000
Sphingomonas sp. FARSPH	2219696	S	2	1	3	0.00000
Sphingomonas sp. AAP5	1523415	S	2	0	2	0.00000
Sphingomonas sp. NIC1	1961362	S	2	2	4	0.00000
Sphingomonas sp. MM-1	745310	S	1	2	3	0.00000
Sphingomonas sp. HDW15C	2714944	S	1	0	1	0.00000
Sphingomonas sp. LM7	1938607	S	1	0	1	0.00000
Sphingomonas koreensis	93064	S	7	7	14	0.00002
Sphingomonas panacisoli	1813879	S	6	0	6	0.00001
Sphingomonas alpina	653931	S	2	0	2	0.00000
Sphingomonas melonis	152682	S	2	8	10	0.00001
Sphingomonas sanxanigenens	397260	S	1	0	1	0.00000
Sphingomonas daechungensis	1176646	S	1	0	1	0.00000
Sphingomonas rhizophila	2071607	S	1	0	1	0.00000
Sphingobium sp. YG1	2082188	S	4	2	6	0.00001
Sphingobium sp. SCG-1	2072936	S	2	0	2	0.00000
Sphingobium sp. TKS	1315974	S	1	2	3	0.00000
Sphingobium sp. RAC03	1843368	S	1	0	1	0.00000
Sphingobium sp. KCTC 72723	2733867	S	1	0	1	0.00000
Sphingobium yanoikuyae	13690	S	4	4	8	0.00001
Sphingobium amiense	135719	S	1	2	3	0.00000
Sphingobium hydrophobicum	1673076	S	1	1	2	0.00000
Sphingopyxis sp. PAMC25046	2565556	S	2	2	4	0.00000
Sphingopyxis sp. QXT-31	1357916	S	1	0	1	0.00000
Sphingopyxis macrogoltabida	33050	S	2	1	3	0.00000
Sphingopyxis fribergensis	1515612	S	2	1	3	0.00000
Sphingopyxis terrae	33052	S	1	1	2	0.00000
Sphingopyxis lindanitolerans	2054227	S	1	0	1	0.00000
Novosphingobium sp. Gsoil 351	2675225	S	2	0	2	0.00000
Novosphingobium sp. PP1Y	702113	S	1	0	1	0.00000
Novosphingobium sp. P6W	1609758	S	1	0	1	0.00000
Novosphingobium pentaromativorans	205844	S	2	1	3	0.00000
Novosphingobium ginsenosidimutans	1176536	S	2	0	2	0.00000
Novosphingobium resinovorum	158500	S	1	0	1	0.00000
Sphingorhabdus lacus	392610	S	3	0	3	0.00000
Sphingorhabdus sp. YGSMI21	2077182	S	1	0	1	0.00000
Sphingorhabdus sp. SMR4y	2584094	S	1	0	1	0.00000
Blastomonas fulva	1550728	S	3	1	4	0.00000
Rhizorhabdus dicambivorans	1850238	S	2	3	5	0.00001
Citromicrobium sp. JL477	1634516	S	1	0	1	0.00000
Porphyrobacter sp. LM 6	1896196	S	2	0	2	0.00000
Porphyrobacter sp. CACIAM 03H1	2003315	S	2	0	2	0.00000
Porphyrobacter sp. YT40	2547601	S	1	0	1	0.00000
Erythrobacter aureus	2182384	S	1	0	1	0.00000
Altererythrobacter sp. B11	2060312	S	1	0	1	0.00000
Altererythrobacter sp. TH136	2067415	S	1	0	1	0.00000
Croceicoccus naphthovorans	1348774	S	1	1	2	0.00000
Qipengyuania flava	192812	S	1	0	1	0.00000
Sphingosinicella microcystinivorans	335406	S	1	0	1	0.00000
Paracoccus aminophilus	34003	S	1	0	1	0.00000
Paracoccus jeotgali	2065379	S	1	0	1	0.00000
Paracoccus sanguinis	1545044	S	1	0	1	0.00000
Paracoccus sp. Arc7-R13	2500532	S	1	0	1	0.00000
Tabrizicola piscis	2494374	S	4	0	4	0.00000
Roseovarius indicus	540747	S	3	2	5	0.00001
Cereibacter sphaeroides	1063	S	2	0	2	0.00000
Salipiger pacificus	311180	S	1	0	1	0.00000
Salipiger profundus	1229727	S	1	0	1	0.00000
Gemmobacter sp. HYN0069	2169400	S	2	0	2	0.00000
Rhodobacter blasticus	1075	S	1	0	1	0.00000
Pseudopuniceibacterium antarcticum	2613965	S	1	0	1	0.00000
Celeribacter indicus	1208324	S	1	0	1	0.00000
Maribius sp. THAF1	2587842	S	1	0	1	0.00000
Thalassobius gelatinovorus	53501	S	1	0	1	0.00000
Phaeobacter porticola	1844006	S	1	0	1	0.00000
Tateyamaria omphalii	299262	S	1	0	1	0.00000
Octadecabacter arcticus	53946	S	1	0	1	0.00000
Rhodobaca barguzinensis	441209	S	1	0	1	0.00000
Rhodovulum sulfidophilum	35806	S	1	0	1	0.00000
Brevundimonas sp. M20	2591463	S	2	0	2	0.00000
Brevundimonas sp. LVF1	2774189	S	2	0	2	0.00000
Brevundimonas sp. CS1	2813778	S	2	0	2	0.00000
Brevundimonas sp. LM2	1938605	S	1	0	1	0.00000
Brevundimonas sp. AJA228-03	2752515	S	1	0	1	0.00000
Brevundimonas sp. GRTSA-9	2800818	S	1	0	1	0.00000
Brevundimonas diminuta	293	S	2	0	2	0.00000
Brevundimonas naejangsanensis	588932	S	2	0	2	0.00000
Brevundimonas vesicularis	41276	S	1	0	1	0.00000
Brevundimonas mediterranea	74329	S	1	0	1	0.00000
Caulobacter henricii	69395	S	3	0	3	0.00000
Caulobacter vibrioides	155892	S	3	0	3	0.00000
Caulobacter sp. FWC26	69665	S	2	0	2	0.00000
Asticcacaulis excentricus	78587	S	2	0	2	0.00000
Phenylobacterium zucineum	284016	S	1	0	1	0.00000
Roseomonas sp. 546	2768162	S	1	2	3	0.00000
Roseococcus sp. NIBR12	2771361	S	1	0	1	0.00000
Magnetospirillum gryphiswaldense	55518	S	1	0	1	0.00000
Magnetospirillum sp. ME-1	1639348	S	1	1	2	0.00000
Azospirillum brasilense	192	S	1	0	1	0.00000
Azospirillum lipoferum	193	S	1	0	1	0.00000
Skermanella sp. TT6	2775420	S	1	0	1	0.00000
Wolbachia endosymbiont of Ctenocephalides felis wCfeT	2732593	S	1	0	1	0.00000
Wolbachia endosymbiont of Dipetalonema caudispina	1812112	S	1	0	1	0.00000
Wolbachia endosymbiont of Cruorifilaria tuberocauda	1812111	S	1	0	1	0.00000
Ehrlichia canis	944	S	2	0	2	0.00000
Anaplasma platys	949	S	1	0	1	0.00000
Rickettsia typhi	785	S	1	0	1	0.00000
Rickettsia bellii	33990	S	1	0	1	0.00000
Hyphomonas sp. CACIAM 19H1	1873716	S	2	0	2	0.00000
Hyphomonas sp. KY3	2016196	S	1	0	1	0.00000
Candidatus Pelagibacter sp. IMCC9063	1002672	S	1	0	1	0.00000
Candidatus Fonsibacter ubiquis	1925548	S	1	0	1	0.00000
Candidatus Nucleicultrix amoebiphila	1509244	S	1	0	1	0.00000
Marinicauda algicola	2029849	S	1	0	1	0.00000
Sorangium cellulosum	56	S	3	1	4	0.00000
Minicystis rosea	888845	S	2	0	2	0.00000
Sandaracinus amylolyticus	927083	S	1	0	1	0.00000
Corallococcus coralloides	184914	S	3	2	5	0.00001
Archangium violaceum	83451	S	1	0	1	0.00000
Anaeromyxobacter dehalogenans	161493	S	1	0	1	0.00000
Geobacter bremensis	60035	S	2	0	2	0.00000
Geobacter sp. M18	443143	S	1	0	1	0.00000
Desulfonema magnum	45655	S	2	0	2	0.00000
Desulfatibacillum aliphaticivorans	218208	S	1	0	1	0.00000
Desulfovibrio marinus	370038	S	1	0	1	0.00000
Desulfomicrobium baculatum	899	S	1	0	1	0.00000
Desulfobacca acetoxidans	60893	S	1	0	1	0.00000
Persicimonas caeni	2292766	S	1	0	1	0.00000
Aliarcobacter cryaerophilus	28198	S	1	0	1	0.00000
Aliarcobacter skirrowii	28200	S	1	0	1	0.00000
Aliarcobacter thereius	544718	S	1	0	1	0.00000
Halarcobacter ebronensis	1462615	S	1	0	1	0.00000
Poseidonibacter lekithochrous	1904463	S	1	0	1	0.00000
Campylobacter sp. RM16704	1500960	S	1	0	1	0.00000
Campylobacter lanienae	75658	S	1	0	1	0.00000
Helicobacter pylori	210	S	2	0	2	0.00000
Nautilia sp. PV-1	2579250	S	1	1	2	0.00000
Hydrogenophilus thermoluteolus	297	S	4	0	4	0.00000
Bacteriovorax stolpii	960	S	1	0	1	0.00000
Micrococcus luteus	1270	S	55	46	101	0.00012
Micrococcus sp. KBS0714	1179670	S	5	38	43	0.00005
Paenarthrobacter sp. YJN-D	2735317	S	44	4	48	0.00006
Arthrobacter sp. FB24	290399	S	1	0	1	0.00000
Arthrobacter sp. YN	2020486	S	1	0	1	0.00000
Arthrobacter sp. PAMC 25486	1494608	S	1	0	1	0.00000
Arthrobacter sp. D5-1	1477518	S	1	0	1	0.00000
Arthrobacter sp. QXT-31	1357915	S	1	0	1	0.00000
Arthrobacter sp. NEB 688	904039	S	1	0	1	0.00000
Arthrobacter dokdonellae	2211210	S	1	0	1	0.00000
Rothia mucilaginosa	43675	S	2	0	2	0.00000
Rothia dentocariosa	2047	S	1	0	1	0.00000
Rothia aeria	172042	S	1	0	1	0.00000
Glutamicibacter arilaitensis	256701	S	2	0	2	0.00000
Glutamicibacter sp. ZJUTW	1155384	S	2	0	2	0.00000
Kocuria rosea	1275	S	1	0	1	0.00000
Pseudarthrobacter sp. NIBRBAC000502771	2590774	S	1	0	1	0.00000
Microbacterium sp. PM5	2014534	S	10	2	12	0.00001
Microbacterium sp. 4R-513	2567934	S	4	0	4	0.00000
Microbacterium sp. 10M-3C3	2483401	S	2	0	2	0.00000
Microbacterium sp. No. 7	1714373	S	2	0	2	0.00000
Microbacterium sp. JZ31	1906274	S	2	0	2	0.00000
Microbacterium sp. LKL04	912630	S	1	0	1	0.00000
Microbacterium sp. Y-01	2048898	S	1	0	1	0.00000
Microbacterium hominis	162426	S	5	3	8	0.00001
Microbacterium lushaniae	2614639	S	1	0	1	0.00000
Microbacterium schleiferi	69362	S	1	0	1	0.00000
Microbacterium wangchenii	2541726	S	1	0	1	0.00000
Microbacterium protaetiae	2509458	S	1	0	1	0.00000
Microbacterium oleivorans	273677	S	1	0	1	0.00000
Microbacterium lemovicicum	1072463	S	1	0	1	0.00000
Microbacterium testaceum	2033	S	1	0	1	0.00000
Microbacterium amylolyticum	936337	S	1	0	1	0.00000
Microbacterium oryzae	743009	S	1	0	1	0.00000
Curtobacterium flaccumfaciens	2035	S	2	0	2	0.00000
Curtobacterium sp. MR_MD2014	1561023	S	1	0	1	0.00000
Curtobacterium sp. 24E2	2804758	S	1	0	1	0.00000
Leifsonia sp. 21MFCrub1.1	1798223	S	1	1	2	0.00000
Leifsonia shinshuensis	150026	S	1	0	1	0.00000
Agromyces aureus	453304	S	1	0	1	0.00000
Agromyces sp. HY052	2585717	S	1	0	1	0.00000
Leucobacter triazinivorans	1784719	S	1	0	1	0.00000
Leucobacter muris	1935379	S	1	0	1	0.00000
Frigoribacterium sp. NBH87	2596916	S	2	0	2	0.00000
Microterricola viridarii	412690	S	1	0	1	0.00000
Agreia sp. COWG	2773266	S	1	0	1	0.00000
Plantibacter flavus	150123	S	1	0	1	0.00000
Dermacoccus nishinomiyaensis	1274	S	9	0	9	0.00001
Dermacoccus sp. PAMC28757	2762331	S	2	0	2	0.00000
Brevibacterium sp. CS2	2575923	S	2	0	2	0.00000
Brevibacterium linens	1703	S	1	0	1	0.00000
Xylanimonas cellulosilytica	186189	S	2	0	2	0.00000
Xylanimonas allomyrinae	2509459	S	1	0	1	0.00000
Cellulomonas sp. H30R-01	2704467	S	1	0	1	0.00000
Oerskovia sp. KBS0722	1179673	S	1	0	1	0.00000
Brachybacterium ginsengisoli	1331682	S	1	0	1	0.00000
Brachybacterium vulturis	2017484	S	1	0	1	0.00000
Janibacter limosus	53458	S	1	0	1	0.00000
Ornithinimicrobium sp. HY006	2508882	S	1	0	1	0.00000
Luteimicrobium xylanilyticum	1133546	S	1	0	1	0.00000
Cutibacterium acnes	1747	S	228	6	234	0.00027
Cutibacterium avidum	33010	S	3	0	3	0.00000
Cutibacterium granulosum	33011	S	1	0	1	0.00000
Propionibacterium sp. oral taxon 193	671223	S	22	1	23	0.00003
Microlunatus sp. Gsoil 973	2672569	S	2	0	2	0.00000
Acidipropionibacterium acidipropionici	1748	S	2	0	2	0.00000
Tessaracoccus defluvii	1285901	S	1	0	1	0.00000
Brevilactibacter sp. MC1595	2819349	S	1	0	1	0.00000
Nocardioides sp. S5	2017486	S	1	0	1	0.00000
Nocardioides sp. WS12	2486272	S	1	0	1	0.00000
Nocardioides marinisabuli	419476	S	1	0	1	0.00000
Nocardioides mesophilus	433659	S	1	0	1	0.00000
Nocardioides humi	449461	S	1	0	1	0.00000
Nocardioides anomalus	2712223	S	1	0	1	0.00000
Rhodococcus qingshengii	334542	S	15	70	85	0.00010
Rhodococcus erythropolis	1833	S	7	20	27	0.00003
Rhodococcus sp. BH4	1807790	S	2	9	11	0.00001
Rhodococcus sp. NJ-530	2490853	S	1	4	5	0.00001
Rhodococcus sp. YL-1	1045808	S	1	3	4	0.00000
Rhodococcus sp. 008	1723645	S	1	4	5	0.00001
Rhodococcus ruber	1830	S	2	0	2	0.00000
Rhodococcus hoagii	43767	S	2	0	2	0.00000
Nocardia farcinica	37329	S	1	0	1	0.00000
Nocardia nova	37330	S	1	0	1	0.00000
Nocardia arthritidis	228602	S	1	0	1	0.00000
Nocardia sp. CS682	1047172	S	1	0	1	0.00000
Mycobacterium sp. JS623	212767	S	1	0	1	0.00000
Mycobacterium sp. YC-RL4	1682113	S	1	1	2	0.00000
Mycobacterium gallinarum	39689	S	2	0	2	0.00000
Mycobacterium gordonae	1778	S	1	0	1	0.00000
Mycobacterium shigaense	722731	S	1	0	1	0.00000
Mycobacterium conspicuum	44010	S	1	0	1	0.00000
Mycobacterium marseillense	701042	S	1	0	1	0.00000
Mycolicibacterium mucogenicum	56689	S	2	0	2	0.00000
Mycolicibacterium sp. Z-34	2736649	S	1	0	1	0.00000
Mycolicibacterium madagascariense	212765	S	1	0	1	0.00000
Mycolicibacterium doricum	126673	S	1	0	1	0.00000
Mycolicibacterium mageritense	53462	S	1	0	1	0.00000
Mycolicibacterium chubuense	1800	S	1	0	1	0.00000
Mycolicibacterium thermoresistibile	1797	S	1	0	1	0.00000
Mycolicibacter hiberniae	29314	S	1	0	1	0.00000
Corynebacterium tuberculostearicum	38304	S	4	0	4	0.00000
Corynebacterium stationis	1705	S	2	0	2	0.00000
Corynebacterium lactis	1231000	S	2	0	2	0.00000
Corynebacterium kefirresidentii	1979527	S	2	0	2	0.00000
Corynebacterium sphenisci	191493	S	1	0	1	0.00000
Corynebacterium sp. zg-917	2763010	S	1	0	1	0.00000
Corynebacterium amycolatum	43765	S	1	0	1	0.00000
Corynebacterium variabile	1727	S	1	0	1	0.00000
Corynebacterium liangguodongii	2079535	S	1	0	1	0.00000
Corynebacterium maris	575200	S	1	0	1	0.00000
Corynebacterium macginleyi	38290	S	1	0	1	0.00000
Gordonia iterans	1004901	S	2	0	2	0.00000
Gordonia sp. JH63	2698900	S	2	1	3	0.00000
Gordonia polyisoprenivorans	84595	S	1	0	1	0.00000
Tsukamurella paurometabola	2061	S	3	0	3	0.00000
Tsukamurella tyrosinosolvens	57704	S	3	0	3	0.00000
Dietzia timorensis	499555	S	1	0	1	0.00000
Streptomyces sp. P3	2135430	S	1	0	1	0.00000
Streptomyces sp. SAT1	1849967	S	1	0	1	0.00000
Streptomyces sp. SN-593	659352	S	1	0	1	0.00000
Streptomyces sp. QMT-12	2717324	S	1	0	1	0.00000
Streptomyces sp. CRXT-G-22	2768066	S	1	0	1	0.00000
Streptomyces sp. SCSIO 3032	1264596	S	1	0	1	0.00000
Streptomyces sp. CMB-StM0423	2059884	S	1	2	3	0.00000
Streptomyces broussonetiae	2686304	S	2	0	2	0.00000
Streptomyces venezuelae	54571	S	2	0	2	0.00000
Streptomyces lavendulae	1914	S	2	0	2	0.00000
Streptomyces lincolnensis	1915	S	1	0	1	0.00000
Streptomyces noursei	1971	S	1	0	1	0.00000
Streptomyces nitrosporeus	28894	S	1	0	1	0.00000
Streptomyces viridosporus	67581	S	1	0	1	0.00000
Streptomyces capitiformicae	2014920	S	1	0	1	0.00000
Streptomyces rapamycinicus	1226757	S	1	0	1	0.00000
Streptomyces lividans	1916	S	1	7	8	0.00001
Streptomyces nojiriensis	66374	S	1	0	1	0.00000
Streptomyces platensis	58346	S	1	0	1	0.00000
Streptomyces aquilus	2548456	S	1	0	1	0.00000
Streptomyces xinghaiensis	1038928	S	1	0	1	0.00000
Streptomyces cacaoi	1898	S	1	0	1	0.00000
Streptomyces griseus	1911	S	1	0	1	0.00000
Streptacidiphilus sp. PB12-B1b	2705012	S	2	0	2	0.00000
Kitasatospora albolonga	68173	S	1	0	1	0.00000
Amycolatopsis sp. Hca4	2742131	S	1	0	1	0.00000
Amycolatopsis sp. FDAARGOS 1241	2778070	S	1	0	1	0.00000
Amycolatopsis methanolica	1814	S	1	0	1	0.00000
Pseudonocardia sp. AL041005-10	445576	S	1	1	2	0.00000
Pseudonocardia sp. CGMCC 4.1532	2761535	S	1	0	1	0.00000
Kibdelosporangium phytohabitans	860235	S	1	0	1	0.00000
Saccharothrix syringae	103733	S	1	0	1	0.00000
Prauserella marina	530584	S	1	0	1	0.00000
Micromonospora aurantiaca	47850	S	1	1	2	0.00000
Micromonospora terminaliae	1914461	S	1	0	1	0.00000
Micromonospora coxensis	356852	S	1	0	1	0.00000
Micromonospora narathiwatensis	299146	S	1	0	1	0.00000
Plantactinospora sp. BB1	2071627	S	2	0	2	0.00000
Actinoplanes teichomyceticus	1867	S	1	0	1	0.00000
Bifidobacterium longum	216816	S	2	0	2	0.00000
Bifidobacterium bifidum	1681	S	1	0	1	0.00000
Bifidobacterium pullorum	78448	S	1	0	1	0.00000
Gardnerella leopoldii	2792978	S	1	0	1	0.00000
Actinomyces oris	544580	S	4	2	6	0.00001
Candidatus Planktophila sulfonica	1884904	S	4	0	4	0.00000
Candidatus Planktophila versatilis	1884905	S	1	0	1	0.00000
Candidatus Planktophila lacus	1884913	S	1	0	1	0.00000
Streptosporangium roseum	2001	S	1	0	1	0.00000
Streptosporangium sp. 'caverna'	2202249	S	1	0	1	0.00000
Actinomadura verrucosospora	46165	S	1	0	1	0.00000
Actinomadura sp. WMMA1423	2591108	S	1	0	1	0.00000
Frankia inefficax	298654	S	1	0	1	0.00000
Candidatus Frankia datiscae	2716812	S	1	0	1	0.00000
Jatrophihabitans sp. GAS493	1907575	S	2	0	2	0.00000
Jiangella alkaliphila	419479	S	1	0	1	0.00000
Actinomarinicola tropica	2789776	S	2	0	2	0.00000
Rubrobacter radiotolerans	42256	S	1	0	1	0.00000
Rubrobacter xylanophilus	49319	S	1	0	1	0.00000
Conexibacter woesei	191495	S	1	0	1	0.00000
Staphylococcus cohnii	29382	S	9	3	12	0.00001
Staphylococcus epidermidis	1282	S	8	1	9	0.00001
Staphylococcus aureus	1280	S	6	12	18	0.00002
Staphylococcus hominis	1290	S	3	0	3	0.00000
Staphylococcus capitis	29388	S	3	0	3	0.00000
Staphylococcus haemolyticus	1283	S	2	0	2	0.00000
Staphylococcus condimenti	70255	S	1	0	1	0.00000
Staphylococcus muscae	1294	S	1	0	1	0.00000
Staphylococcus saccharolyticus	33028	S	1	0	1	0.00000
Staphylococcus saprophyticus	29385	S	1	0	1	0.00000
Bacillus cereus	1396	S	5	4	9	0.00001
Bacillus sp. M4U3P1	2592382	S	3	0	3	0.00000
Bacillus velezensis	492670	S	2	4	6	0.00001
Bacillus vini	1476025	S	1	0	1	0.00000
Priestia megaterium	1404	S	8	2	10	0.00001
Amphibacillus xylanus	1449	S	2	0	2	0.00000
Lysinibacillus fusiformis	28031	S	1	1	2	0.00000
Weizmannia coagulans	1398	S	1	0	1	0.00000
Mesobacillus jeotgali	129985	S	1	0	1	0.00000
Cytobacillus kochii	859143	S	1	0	1	0.00000
Fictibacillus arsenicus	255247	S	1	0	1	0.00000
Anaerobacillus isosaccharinicus	1532552	S	1	0	1	0.00000
Virgibacillus necropolis	163877	S	1	0	1	0.00000
Cohnella sp. LGH	1619153	S	6	0	6	0.00001
Paenibacillus beijingensis	1126833	S	1	0	1	0.00000
Paenibacillus mucilaginosus	61624	S	1	-1	0	0.00000
Planococcus faecalis	1598147	S	1	0	1	0.00000
Planococcus sp. PAMC 21323	1526927	S	1	0	1	0.00000
Listeria monocytogenes	1639	S	1	0	1	0.00000
Streptococcus sp. oral taxon 061	712623	S	2	0	2	0.00000
Streptococcus sp. 1643	2576376	S	1	0	1	0.00000
Streptococcus gordonii	1302	S	2	0	2	0.00000
Streptococcus troglodytae	1111760	S	2	0	2	0.00000
Streptococcus suis	1307	S	2	1	3	0.00000
Streptococcus oralis	1303	S	1	0	1	0.00000
Streptococcus equinus	1335	S	1	0	1	0.00000
Lactococcus lactis	1358	S	6	2	8	0.00001
Lactococcus cremoris	1359	S	1	0	1	0.00000
Weissella sp. HDW19	2714949	S	3	0	3	0.00000
Limosilactobacillus fermentum	1613	S	2	0	2	0.00000
Companilactobacillus futsaii	938155	S	1	1	2	0.00000
Latilactobacillus graminis	60519	S	1	1	2	0.00000
Lactobacillus jensenii	109790	S	1	0	1	0.00000
Schleiferilactobacillus harbinensis	304207	S	1	0	1	0.00000
Carnobacterium maltaromaticum	2751	S	7	0	7	0.00001
Dolosigranulum pigrum	29394	S	2	0	2	0.00000
Jeotgalibaca porci	1868793	S	1	0	1	0.00000
Enterococcus cecorum	44008	S	2	0	2	0.00000
Enterococcus faecalis	1351	S	1	0	1	0.00000
Enterococcus hirae	1354	S	1	0	1	0.00000
Enterococcus mundtii	53346	S	1	0	1	0.00000
Enterococcus rotai	118060	S	1	0	1	0.00000
Aerococcus urinaeequi	51665	S	2	0	2	0.00000
Aerococcus viridans	1377	S	1	0	1	0.00000
Clostridium botulinum	1491	S	3	0	3	0.00000
Clostridium perfringens	1502	S	3	0	3	0.00000
Clostridium taeniosporum	394958	S	2	0	2	0.00000
Clostridium pasteurianum	1501	S	2	0	2	0.00000
Clostridium tyrobutyricum	1519	S	1	0	1	0.00000
Clostridium baratii	1561	S	1	0	1	0.00000
Clostridium scatologenes	1548	S	1	0	1	0.00000
Clostridium sporogenes	1509	S	1	1	2	0.00000
Geosporobacter ferrireducens	1424294	S	1	0	1	0.00000
Paeniclostridium sordellii	1505	S	2	0	2	0.00000
Filifactor alocis	143361	S	1	1	2	0.00000
Paraclostridium bifermentans	1490	S	1	0	1	0.00000
Clostridioides difficile	1496	S	1	0	1	0.00000
Acetivibrio saccincola	1677857	S	1	0	1	0.00000
Flavonifractor plautii	292800	S	1	0	1	0.00000
Ruminiclostridium herbifermentans	2488810	S	1	0	1	0.00000
Eubacterium callanderi	53442	S	1	0	1	0.00000
Aminipila butyrica	433296	S	1	0	1	0.00000
Thermodesulfobium acidiphilum	1794699	S	1	0	1	0.00000
Mahella australiensis	252966	S	1	0	1	0.00000
Keratinibaculum paraultunense	1278232	S	3	0	3	0.00000
Tissierellia sp. JN-28	2507161	S	1	0	1	0.00000
Murdochiella vaginalis	1852373	S	1	1	2	0.00000
Bulleidia sp. zg-1006	2806552	S	2	1	3	0.00000
Veillonella parvula	29466	S	1	0	1	0.00000
Anabaena sp. WA102	1647413	S	6	4	10	0.00001
Anabaena sp. 90	46234	S	2	7	9	0.00001
Nostoc sp. CENA543	1869241	S	3	0	3	0.00000
Nostoc sp. PCC 7524	28072	S	1	0	1	0.00000
Nostoc sp. C052	2576902	S	1	0	1	0.00000
Nostoc linckia	92942	S	2	0	2	0.00000
Nostoc carneum	374162	S	1	1	2	0.00000
Calothrix sp. 336/3	1337936	S	2	0	2	0.00000
Calothrix sp. NIES-2098	1954171	S	1	0	1	0.00000
Calothrix brevissima	938406	S	2	0	2	0.00000
Dolichospermum compactum	136073	S	2	1	3	0.00000
Nodularia spumigena	70799	S	1	-1	0	0.00000
Brasilonema sennae	1397703	S	1	0	1	0.00000
Rivularia sp. PCC 7116	373994	S	1	0	1	0.00000
Synechococcus sp. JA-2-3B'a(2-13)	321332	S	4	0	4	0.00000
Synechococcus sp. A15-44	1050646	S	1	0	1	0.00000
Synechococcus sp. PCC 6312	195253	S	1	0	1	0.00000
Synechococcus sp. PCC 73109	374982	S	1	0	1	0.00000
Dactylococcopsis salina	292566	S	1	0	1	0.00000
Acaryochloris marina	155978	S	3	0	3	0.00000
Pseudanabaena sp. ABRG5-3	685565	S	1	0	1	0.00000
Oscillatoria nigro-viridis	482564	S	4	0	4	0.00000
Oscillatoria acuminata	118323	S	1	0	1	0.00000
Moorea producens	1155739	S	1	0	1	0.00000
Cyanobacterium aponinum	379064	S	1	1	2	0.00000
Gloeomargarita lithophora	1188228	S	1	0	1	0.00000
Thermus scotoductus	37636	S	4	0	4	0.00000
Thermus thermophilus	274	S	3	0	3	0.00000
Thermus parvatiensis	456163	S	2	0	2	0.00000
Deinococcus actinosclerus	1768108	S	1	0	1	0.00000
Deinococcus deserti	310783	S	1	0	1	0.00000
Deinococcus swuensis	1182571	S	1	0	1	0.00000
Deinococcus radiodurans	1299	S	1	0	1	0.00000
Mycoplasma mobile	2118	S	1	0	1	0.00000
Mycoplasma canis	29555	S	1	0	1	0.00000
Spiroplasma melliferum	2134	S	1	0	1	0.00000
Spiroplasma tabanidicola	324079	S	1	0	1	0.00000
Spiroplasma chrysopicola	216933	S	1	0	1	0.00000
Candidatus Phytoplasma mali	37692	S	1	0	1	0.00000
Candidatus Promineofilum breve	1806508	S	2	0	2	0.00000
Flavobacterium psychrophilum	96345	S	7	0	7	0.00001
Flavobacterium sp. SLB02	2665645	S	3	0	3	0.00000
Flavobacterium sp. Sr18	935222	S	1	0	1	0.00000
Flavobacterium sp. MDT1-60	1979344	S	1	0	1	0.00000
Flavobacterium sp. M31R6	2739062	S	1	0	1	0.00000
Flavobacterium sp. CLA17	2724135	S	1	0	1	0.00000
Flavobacterium nackdongense	2547394	S	3	0	3	0.00000
Flavobacterium indicum	312277	S	3	0	3	0.00000
Flavobacterium johnsoniae	986	S	2	0	2	0.00000
Flavobacterium anhuiense	459526	S	2	1	3	0.00000
Flavobacterium faecale	1355330	S	2	0	2	0.00000
Flavobacterium columnare	996	S	1	0	1	0.00000
Flavobacterium crocinum	2183896	S	1	0	1	0.00000
Flavobacterium album	2175091	S	1	0	1	0.00000
Flavobacterium crassostreae	1763534	S	1	0	1	0.00000
Flavobacterium nitrogenifigens	1617283	S	1	0	1	0.00000
Flavobacterium gilvum	1492737	S	1	0	1	0.00000
Flavobacterium commune	1306519	S	1	0	1	0.00000
Polaribacter sp. SA4-12	1312072	S	2	0	2	0.00000
Polaribacter sp. ALD11	2058137	S	2	0	2	0.00000
Polaribacter sp. L12M9	2738844	S	1	0	1	0.00000
Polaribacter haliotis	1888915	S	2	0	2	0.00000
Polaribacter sejongensis	985043	S	1	0	1	0.00000
Polaribacter vadi	1774273	S	1	0	1	0.00000
Myroides odoratimimus	76832	S	6	8	14	0.00002
Myroides odoratus	256	S	1	0	1	0.00000
Myroides profundi	480520	S	1	0	1	0.00000
Capnocytophaga cynodegmi	28189	S	1	0	1	0.00000
Capnocytophaga endodontalis	2708117	S	1	0	1	0.00000
Lacinutrix sp. Bg11-31	2057808	S	2	0	2	0.00000
Lacinutrix sp. 5H-3-7-4	983544	S	1	0	1	0.00000
Nonlabens sp. Hel1_33_55	1336802	S	1	0	1	0.00000
Nonlabens sp. MB-3u-79	2058134	S	1	0	1	0.00000
Tenacibaculum sp. DSM 106434	2358479	S	2	0	2	0.00000
Formosa sp. Hel3_A1_48	1336795	S	1	0	1	0.00000
Olleya sp. Bg11-27	2058135	S	1	1	2	0.00000
Aquimarina sp. BL5	1714860	S	1	0	1	0.00000
Winogradskyella helgolandensis	2697010	S	1	0	1	0.00000
Muriicola sp. MMS17-SY002	2507538	S	1	0	1	0.00000
Siansivirga zeaxanthinifaciens	762954	S	1	0	1	0.00000
Psychroflexus sp. ALD_RP9	2777186	S	1	0	1	0.00000
Urechidicola croceus	1850246	S	1	0	1	0.00000
Chryseobacterium sp. 6424	2039166	S	2	0	2	0.00000
Chryseobacterium sp. G0186	2487064	S	1	0	1	0.00000
Chryseobacterium sp. SNU WT5	2594269	S	1	0	1	0.00000
Chryseobacterium sp. POL2	2713414	S	1	0	1	0.00000
Chryseobacterium sp. NEB161	2724619	S	1	0	1	0.00000
Chryseobacterium indologenes	253	S	1	0	1	0.00000
Chryseobacterium arthrosphaerae	651561	S	1	0	1	0.00000
Chryseobacterium shandongense	1493872	S	1	0	1	0.00000
Chryseobacterium balustinum	246	S	1	0	1	0.00000
Kaistella jeonii	266749	S	4	0	4	0.00000
Kaistella flava (ex Peng et al. 2021)	2038776	S	4	0	4	0.00000
Kaistella antarctica	266748	S	2	0	2	0.00000
Epilithonimonas vandammei	2487072	S	1	1	2	0.00000
Cloacibacterium normanense	237258	S	19	2	21	0.00002
Elizabethkingia anophelis	1117645	S	2	1	3	0.00000
Elizabethkingia sp. JS20170427COW	2583851	S	1	0	1	0.00000
Ornithobacterium rhinotracheale	28251	S	1	0	1	0.00000
Cruoricaptor ignavus	1118202	S	1	0	1	0.00000
Croceimicrobium hydrocarbonivorans	2761580	S	1	0	1	0.00000
Pedobacter sp. SW-16	2766984	S	30	13	43	0.00005
Pedobacter sp. JBR3-12	2789740	S	4	0	4	0.00000
Pedobacter sp. PACM 27299	1727164	S	2	0	2	0.00000
Pedobacter sp. G11	2482728	S	2	0	2	0.00000
Pedobacter sp. HDW13	2714940	S	2	0	2	0.00000
Pedobacter suwonensis	332999	S	1	0	1	0.00000
Pedobacter steynii	430522	S	1	0	1	0.00000
Mucilaginibacter ginkgonis	2682091	S	2	0	2	0.00000
Mucilaginibacter ginsenosidivorans	398053	S	1	0	1	0.00000
Mucilaginibacter gotjawali	1550579	S	1	0	1	0.00000
Sphingobacterium mizutaii	1010	S	1	0	1	0.00000
Sphingobacterium sp. dk4302	2662364	S	1	0	1	0.00000
Spirosoma sp. KUDC1026	2745947	S	17	0	17	0.00002
Spirosoma montaniterrae	1178516	S	1	0	1	0.00000
Spirosoma aerolatum	1211326	S	1	0	1	0.00000
Spirosoma pollinicola	2057025	S	1	0	1	0.00000
Runella slithyformis	106	S	1	0	1	0.00000
Hymenobacter sp. PAMC 26554	1484116	S	2	0	2	0.00000
Hymenobacter sp. NBH84	2596915	S	2	0	2	0.00000
Hymenobacter jejuensis	2502781	S	1	0	1	0.00000
Hymenobacter busanensis	2607656	S	1	0	1	0.00000
Adhaeribacter swui	2086471	S	1	0	1	0.00000
Echinicola vietnamensis	390884	S	2	1	3	0.00000
Belliella baltica	232259	S	1	0	1	0.00000
Flammeovirga sp. MY04	1191459	S	1	0	1	0.00000
Bacteroides uniformis	820	S	4	0	4	0.00000
Bacteroides sp. HF-162	2785531	S	2	0	2	0.00000
Bacteroides sp. CBA7301	2715212	S	1	0	1	0.00000
Bacteroides zoogleoformans	28119	S	2	0	2	0.00000
Bacteroides fragilis	817	S	1	0	1	0.00000
Alistipes onderdonkii	328813	S	2	0	2	0.00000
Prevotella copri	165179	S	1	0	1	0.00000
Prevotella jejuni	1177574	S	1	0	1	0.00000
Phocaeicola vulgatus	821	S	1	0	1	0.00000
Muribaculum gordoncarteri	2530390	S	1	0	1	0.00000
Coprobacter sp. 2CBH44	2751153	S	1	0	1	0.00000
Tenuifilum thalassicum	2590900	S	1	0	1	0.00000
Labilibaculum antarcticum	1717717	S	1	0	1	0.00000
Arachidicoccus sp. B3-10	2545455	S	2	0	2	0.00000
Arachidicoccus sp. BS20	1850526	S	1	0	1	0.00000
Arachidicoccus ginsenosidivorans	496057	S	1	0	1	0.00000
Lacibacter sp. S13-6-6	2760713	S	3	0	3	0.00000
Filimonas lacunae	477680	S	2	0	2	0.00000
Panacibacter ginsenosidivorans	1813871	S	2	0	2	0.00000
Chitinophaga sp. 1310	2725416	S	1	0	1	0.00000
Flavihumibacter sp. SB-02	2676868	S	1	0	1	0.00000
Pseudobacter ginsenosidimutans	661488	S	1	0	1	0.00000
Salinibacter ruber	146919	S	1	0	1	0.00000
Gemmatirosa kalamazoonesis	861299	S	1	0	1	0.00000
Gemmata massiliana	1210884	S	4	2	6	0.00001
Gemmata obscuriglobus	114	S	1	0	1	0.00000
Urbifossiella limnaea	2528023	S	7	0	7	0.00001
Frigoriglobus tundricola	2774151	S	3	1	4	0.00000
Tuwongella immobilis	692036	S	2	0	2	0.00000
Limnoglobus roseus	2598579	S	2	0	2	0.00000
Pirellula staleyi	125	S	1	0	1	0.00000
Bremerella volcania	2527984	S	1	0	1	0.00000
Lignipirellula cremea	2528010	S	1	0	1	0.00000
Stieleria neptunia	2527979	S	1	0	1	0.00000
Anatilimnocola aggregata	2528021	S	1	0	1	0.00000
Lacipirellula limnantheis	2528024	S	1	1	2	0.00000
Botrimarina mediterranea	2528022	S	1	0	1	0.00000
Singulisphaera acidiphila	466153	S	1	1	2	0.00000
Paludisphaera borealis	1387353	S	1	1	2	0.00000
Tautonia plasticadhaerens	2527974	S	1	0	1	0.00000
Gimesia alba	2527973	S	1	0	1	0.00000
Gimesia chilikensis	2605989	S	1	0	1	0.00000
Alienimonas californiensis	2527989	S	1	0	1	0.00000
Symmachiella dynata	2527995	S	1	0	1	0.00000
Sedimentisphaera cyanobacteriorum	1940790	S	1	0	1	0.00000
Verrucomicrobium spinosum	2736	S	3	0	3	0.00000
Verrucomicrobium sp. GAS474	1882831	S	3	0	3	0.00000
Luteolibacter luteus	2728835	S	2	0	2	0.00000
Roseimicrobium sp. ORNL1	2711231	S	2	0	2	0.00000
Ereboglobus luteus	1796921	S	2	0	2	0.00000
Opitutus terrae	107709	S	1	0	1	0.00000
Methylacidiphilum kamchatkense	431057	S	1	0	1	0.00000
Parachlamydia acanthamoebae	83552	S	1	4	5	0.00001
Spirochaeta africana	46355	S	4	0	4	0.00000
Treponema primitia	88058	S	1	0	1	0.00000
Treponema ruminis	744515	S	1	0	1	0.00000
Sediminispirochaeta smaragdinae	55206	S	1	0	1	0.00000
Borrelia crocidurae	29520	S	4	1	5	0.00001
Borreliella burgdorferi	139	S	1	0	1	0.00000
Leptospira biflexa	172	S	1	-1	0	0.00000
Granulicella tundricola	940615	S	2	0	2	0.00000
Acidisarcina polymorpha	2211140	S	1	0	1	0.00000
Candidatus Solibacter usitatus	332163	S	1	0	1	0.00000
Luteitalea pratensis	1855912	S	3	0	3	0.00000
Desulfurobacterium thermolithotrophum	64160	S	1	0	1	0.00000
Nitrospira sp. KM1	1936990	S	1	0	1	0.00000
Leptotrichia trevisanii	109328	S	1	0	1	0.00000
Desulfurispirillum indicum	936456	S	1	0	1	0.00000
Thermodesulfobacterium geofontis	1295609	S	1	0	1	0.00000
Jonquetella anthropi	428712	S	1	0	1	0.00000
Candidatus Nitrosotenuis cloacae	1603555	S	3	0	3	0.00000
Nitrosopumilus ureiphilus	1470067	S	1	0	1	0.00000
Candidatus Nitrosocosmicus hydrocola	1826872	S	1	0	1	0.00000
Acidianus brierleyi	41673	S	1	1	2	0.00000
Sulfolobus sp. A20	1891280	S	1	0	1	0.00000
Pyrobaculum calidifontis	181486	S	1	0	1	0.00000
Fervidicoccus fontis	683846	S	1	0	1	0.00000
Methanosarcina barkeri	2208	S	1	0	1	0.00000
Methanomethylovorans hollandica	101192	S	1	0	1	0.00000
Methanosalsum zhilinae	39669	S	1	0	1	0.00000
Haloprofundus sp. MHR1	2572921	S	1	0	1	0.00000
Methanococcus maripaludis	39152	S	1	0	1	0.00000
Methanobacterium lacus	877455	S	1	0	1	0.00000
Flavobacterium phage vB_FspS_filifjonk9-1	2686245	S	7	7	14	0.00002
Flavobacterium phage vB_FspS_tooticki6-1	2686279	S	2	4	6	0.00001
Flavobacterium phage vB_FspS_hattifnatt9-1	2686246	S	1	0	1	0.00000
Synechococcus phage S-CBS3	753085	S	1	0	1	0.00000
Propionibacterium virus PHL070N00	1982279	S	1	0	1	0.00000
Propionibacterium virus PA6	1982269	S	1	0	1	0.00000
Salmonella phage TS13	2500149	S	1	0	1	0.00000
Synechococcus virus ST4	2734145	S	1	0	1	0.00000
Acinetobacter phage Acj61	760732	S	1	0	1	0.00000
Curvibacter virus P26059B	2733926	S	2	0	2	0.00000
Human betaherpesvirus 5	10359	S	1	0	1	0.00000
Adoxophyes orana nucleopolyhedrovirus	542343	S	1	0	1	0.00000
Pandoravirus macleodensis	2107707	S	1	0	1	0.00000
