name	taxonomy_id	taxonomy_lvl	kraken_assigned_reads	added_reads	new_est_reads	fraction_total_reads
Homo sapiens	9606	S	1298295	457	1298752	0.99535
Variovorax sp. PAMC26660	2762322	S	14	2	16	0.00001
Variovorax sp. PAMC 28711	1795631	S	10	0	10	0.00001
Variovorax sp. 38R	2774875	S	9	7	16	0.00001
Variovorax sp. WDL1	207745	S	8	12	20	0.00002
Variovorax sp. RKNM96	2681552	S	5	1	6	0.00000
Variovorax sp. PAMC28562	2762323	S	4	0	4	0.00000
Variovorax sp. HW608	1034889	S	4	0	4	0.00000
Variovorax sp. PBS-H4	434008	S	3	0	3	0.00000
Variovorax sp. PBL-E5	434014	S	3	22	25	0.00002
Variovorax sp. SRS16	282217	S	2	12	14	0.00001
Variovorax sp. RA8	662548	S	2	1	3	0.00000
Variovorax sp. PBL-H6	434009	S	2	5	7	0.00001
Variovorax boronicumulans	436515	S	43	25	68	0.00005
Variovorax paradoxus	34073	S	31	7	38	0.00003
Acidovorax sp. KKS102	358220	S	49	8	57	0.00004
Acidovorax sp. JMULE5	2518343	S	46	4	50	0.00004
Acidovorax sp. T1	1858609	S	18	15	33	0.00003
Acidovorax sp. RAC01	1842533	S	15	2	17	0.00001
Acidovorax sp. 1608163	2478662	S	5	0	5	0.00000
Acidovorax sp. HDW3	2714923	S	5	0	5	0.00000
Acidovorax sp. JS42	232721	S	3	22	25	0.00002
Acidovorax carolinensis	553814	S	16	5	21	0.00002
Acidovorax avenae	80867	S	8	2	10	0.00001
Acidovorax monticola	1926868	S	6	0	6	0.00000
Acidovorax cattleyae	80868	S	4	1	5	0.00000
Acidovorax antarcticus	2743470	S	4	0	4	0.00000
Diaphorobacter sp. HDW4A	2714924	S	103	24	127	0.00010
Diaphorobacter sp. JS3051	2792224	S	3	21	24	0.00002
Diaphorobacter sp. HDW4B	2714925	S	1	0	1	0.00000
Diaphorobacter aerolatus	1288495	S	15	5	20	0.00002
Diaphorobacter polyhydroxybutyrativorans	1546149	S	2	5	7	0.00001
Hydrogenophaga sp. RAC07	1842537	S	7	1	8	0.00001
Hydrogenophaga sp. PBL-H3	434010	S	5	1	6	0.00000
Hydrogenophaga sp. NH-16	2184519	S	5	6	11	0.00001
Hydrogenophaga sp. BPS33	2651974	S	5	0	5	0.00000
Hydrogenophaga sp. BA0156	2716225	S	5	1	6	0.00000
Hydrogenophaga sp. PAMC20947	2565558	S	3	0	3	0.00000
Hydrogenophaga sp. YM1	2806262	S	3	0	3	0.00000
Hydrogenophaga sp. PBC	795665	S	2	0	2	0.00000
Delftia acidovorans	80866	S	9	6	15	0.00001
Delftia lacustris	558537	S	7	14	21	0.00002
Delftia tsuruhatensis	180282	S	3	4	7	0.00001
Delftia sp. HK171	1920191	S	2	2	4	0.00000
Delftia sp. Cs1-4	742013	S	1	0	1	0.00000
Comamonas aquatica	225991	S	13	1	14	0.00001
Comamonas testosteroni	285	S	8	4	12	0.00001
Comamonas koreensis	160825	S	7	0	7	0.00001
Comamonas serinivorans	1082851	S	2	0	2	0.00000
Comamonas piscis	1562974	S	2	0	2	0.00000
Comamonas sp. NLF-7-7	2597701	S	1	0	1	0.00000
Rhodoferax sp. AJA081-3	2752316	S	5	0	5	0.00000
Rhodoferax sp. BAB1	2741720	S	3	0	3	0.00000
Rhodoferax sp. PAMC29310	2822760	S	3	0	3	0.00000
Rhodoferax saidenbachensis	1484693	S	9	0	9	0.00001
Rhodoferax koreense	1842727	S	4	0	4	0.00000
Rhodoferax sediminis	2509614	S	4	0	4	0.00000
Rhodoferax antarcticus	81479	S	3	0	3	0.00000
Rhodoferax ferrireducens	192843	S	1	0	1	0.00000
Polaromonas sp. JS666	296591	S	3	6	9	0.00001
Polaromonas sp. W9N	1840323	S	1	0	1	0.00000
Polaromonas naphthalenivorans	216465	S	7	0	7	0.00001
Limnohabitans sp. 63ED37-2	1678128	S	10	0	10	0.00001
Limnohabitans sp. 103DPR2	1678129	S	2	0	2	0.00000
Kinneretia sp. DAIF2	2714952	S	10	0	10	0.00001
Schlegelella thermodepolymerans	215580	S	8	0	8	0.00001
Ottowia oryzae	2109914	S	4	0	4	0.00000
Ottowia sp. 27C	2816950	S	3	0	3	0.00000
Ottowia sp. oral taxon 894	1658672	S	1	0	1	0.00000
Curvibacter sp. AEP1-3	1844971	S	8	0	8	0.00001
Serpentinomonas raichei	1458425	S	4	0	4	0.00000
Serpentinomonas mccroryi	1458426	S	3	0	3	0.00000
Alicycliphilus denitrificans	179636	S	5	1	6	0.00000
Pulveribacter suum	2116657	S	4	0	4	0.00000
Ramlibacter tataouinensis	94132	S	3	0	3	0.00000
Hylemonella gracilis	80880	S	2	0	2	0.00000
Verminephrobacter eiseniae	364317	S	1	0	1	0.00000
Simplicispira suum	2109915	S	1	0	1	0.00000
Janthinobacterium sp. HH102	1537274	S	20	21	41	0.00003
Janthinobacterium sp. LM6	1938606	S	11	2	13	0.00001
Janthinobacterium sp. 1_2014MBL_MicDiv	1644131	S	10	1	11	0.00001
Janthinobacterium sp. Marseille	375286	S	6	0	6	0.00000
Janthinobacterium sp. PLB02	2808899	S	3	3	6	0.00000
Janthinobacterium sp. 17J80-10	2497863	S	1	0	1	0.00000
Janthinobacterium agaricidamnosum	55508	S	15	17	32	0.00002
Janthinobacterium tructae	2590869	S	8	2	10	0.00001
Janthinobacterium lividum	29581	S	6	4	10	0.00001
Janthinobacterium svalbardensis	368607	S	4	1	5	0.00000
Massilia sp. CCM 8941	2765360	S	3	0	3	0.00000
Massilia sp. YMA4	1593482	S	1	0	1	0.00000
Massilia sp. WG5	1707785	S	1	0	1	0.00000
Massilia sp. LPB0304	2769491	S	1	0	1	0.00000
Massilia violaceinigra	2045208	S	2	0	2	0.00000
Massilia armeniaca	2072590	S	2	0	2	0.00000
Massilia albidiflava	321983	S	1	0	1	0.00000
Massilia lutea	321985	S	1	0	1	0.00000
Massilia umbonata	864828	S	1	0	1	0.00000
Massilia oculi	945844	S	1	0	1	0.00000
Collimonas fungivorans	158899	S	5	2	7	0.00001
Collimonas arenae	279058	S	4	1	5	0.00000
Herbaspirillum huttiense	863372	S	5	0	5	0.00000
Herbaspirillum rubrisubalbicans	80842	S	2	0	2	0.00000
Herbaspirillum robiniae	2014887	S	2	0	2	0.00000
Duganella sp. GN2-R2	2728020	S	4	0	4	0.00000
Undibacterium parvum	401471	S	3	0	3	0.00000
Undibacterium sp. KW1	2058624	S	1	0	1	0.00000
Burkholderia stabilis	95485	S	3	0	3	0.00000
Burkholderia stagnalis	1503054	S	2	0	2	0.00000
Burkholderia cenocepacia	95486	S	2	1	3	0.00000
Burkholderia anthina	179879	S	1	0	1	0.00000
Burkholderia latens	488446	S	1	1	2	0.00000
Burkholderia pseudomallei	28450	S	1	2	3	0.00000
Burkholderia sp. BDU8	1385592	S	1	0	1	0.00000
Burkholderia sp. IDO3	1705310	S	1	1	2	0.00000
Burkholderia plantarii	41899	S	1	0	1	0.00000
Cupriavidus necator	106590	S	5	0	5	0.00000
Cupriavidus basilensis	68895	S	4	0	4	0.00000
Cupriavidus gilardii	82541	S	2	2	4	0.00000
Cupriavidus pauculus	82633	S	2	0	2	0.00000
Cupriavidus taiwanensis	164546	S	2	0	2	0.00000
Cupriavidus oxalaticus	96344	S	1	0	1	0.00000
Cupriavidus metallidurans	119219	S	1	0	1	0.00000
Cupriavidus pinatubonensis	248026	S	1	0	1	0.00000
Polynucleobacter difficilis	556054	S	14	0	14	0.00001
Polynucleobacter duraquae	1835254	S	2	0	2	0.00000
Polynucleobacter acidiphobus	556053	S	1	0	1	0.00000
Polynucleobacter asymbioticus	576611	S	1	0	1	0.00000
Polynucleobacter paneuropaeus	2527775	S	1	0	1	0.00000
Ralstonia pickettii	329	S	5	1	6	0.00000
Ralstonia insidiosa	190721	S	5	0	5	0.00000
Ralstonia solanacearum	305	S	4	1	5	0.00000
Ralstonia mannitolilytica	105219	S	1	0	1	0.00000
Paraburkholderia sp. 7MH5	2547399	S	2	0	2	0.00000
Paraburkholderia sp. PGU19	2735434	S	1	0	1	0.00000
Paraburkholderia xenovorans	36873	S	2	1	3	0.00000
Paraburkholderia atlantica	2654982	S	1	0	1	0.00000
Paraburkholderia acidisoli	2571748	S	1	0	1	0.00000
Paraburkholderia terricola	169427	S	1	0	1	0.00000
Paraburkholderia phytofirmans	261302	S	1	0	1	0.00000
Paraburkholderia ginsengisoli	311231	S	1	0	1	0.00000
Pandoraea pnomenusa	93220	S	4	0	4	0.00000
Pandoraea pulmonicola	93221	S	3	0	3	0.00000
Pandoraea vervacti	656178	S	1	0	1	0.00000
Pandoraea faecigallinarum	656179	S	1	0	1	0.00000
Limnobacter sp. SAORIC-580	2732163	S	4	0	4	0.00000
Caballeronia insecticola	758793	S	1	0	1	0.00000
Caballeronia sp. M1242	2814653	S	1	0	1	0.00000
Rhizobacter sp. AJA081-3	2753607	S	15	4	19	0.00001
Rhizobacter gummiphilus	946333	S	3	0	3	0.00000
Aquabacterium olei	1296669	S	17	3	20	0.00002
Paucibacter sp. KCTC 42545	1768242	S	12	1	13	0.00001
Inhella inkyongensis	392593	S	9	1	10	0.00001
Sphaerotilus natans	34103	S	6	1	7	0.00001
Methylibium petroleiphilum	105560	S	5	2	7	0.00001
Thiomonas intermedia	926	S	3	0	3	0.00000
Thiomonas sp. X19	1050370	S	1	0	1	0.00000
Rubrivivax gelatinosus	28068	S	3	0	3	0.00000
Mitsuaria sp. 7	1658665	S	3	0	3	0.00000
Leptothrix cholodnii	34029	S	2	0	2	0.00000
Xylophilus rhododendri	2697032	S	1	0	1	0.00000
Achromobacter xylosoxidans	85698	S	9	3	12	0.00001
Achromobacter deleyi	1353891	S	4	1	5	0.00000
Achromobacter sp. AONIH1	1758194	S	4	0	4	0.00000
Achromobacter spanius	217203	S	2	0	2	0.00000
Achromobacter pestifer	1353889	S	2	0	2	0.00000
Achromobacter denitrificans	32002	S	1	0	1	0.00000
Achromobacter insolitus	217204	S	1	0	1	0.00000
Bordetella hinzii	103855	S	3	0	3	0.00000
Bordetella bronchialis	463025	S	3	0	3	0.00000
Bordetella trematum	123899	S	2	0	2	0.00000
Bordetella bronchiseptica	518	S	1	0	1	0.00000
Bordetella parapertussis	519	S	1	0	1	0.00000
Bordetella holmesii	35814	S	1	0	1	0.00000
Bordetella flabilis	463014	S	1	0	1	0.00000
Bordetella genomosp. 9	1416803	S	1	0	1	0.00000
Alcaligenes faecalis	511	S	1	2	3	0.00000
Advenella mimigardefordensis	302406	S	1	0	1	0.00000
Pusillimonas thiosulfatoxidans	2028345	S	1	0	1	0.00000
Sutterella wadsworthensis	40545	S	1	0	1	0.00000
Azospira restricta	404405	S	2	0	2	0.00000
Azospira sp. I09	1765049	S	2	3	5	0.00000
Azospira oryzae	146939	S	1	2	3	0.00000
Oryzomicrobium terrae	1735038	S	2	0	2	0.00000
Rugosibacter aromaticivorans	1565605	S	2	0	2	0.00000
Aromatoleum petrolei	76116	S	1	0	1	0.00000
Azoarcus sp. DN11	356837	S	2	0	2	0.00000
Azoarcus sp. KH32C	748247	S	2	0	2	0.00000
Azoarcus sp. DD4	2027405	S	2	0	2	0.00000
Azoarcus sp. CIB	198107	S	1	0	1	0.00000
Azoarcus communis	41977	S	1	0	1	0.00000
Thauera humireducens	1134435	S	1	0	1	0.00000
Thauera sp. K11	2005884	S	1	0	1	0.00000
Dechloromonas aromatica	259537	S	2	0	2	0.00000
Dechloromonas sp. HYN0024	2231055	S	1	0	1	0.00000
Dechloromonas sp. TW-R-39-2	2654218	S	1	0	1	0.00000
Fluviibacter phosphoraccumulans	1751046	S	2	0	2	0.00000
Chromobacterium paludis	2605945	S	3	0	3	0.00000
Chromobacterium sp. ATCC 53434	2059672	S	2	0	2	0.00000
Chromobacterium phragmitis	2202141	S	1	0	1	0.00000
Aquaspirillum sp. LM1	1938604	S	1	0	1	0.00000
Microvirgula aerodenitrificans	57480	S	1	0	1	0.00000
Chitinibacter sp. 2T18	2739434	S	1	0	1	0.00000
Vitreoscilla filiformis	63	S	1	0	1	0.00000
Kingella oralis	505	S	1	0	1	0.00000
Chitinolyticbacter meiyuanensis	682798	S	1	0	1	0.00000
Snodgrassella alvi	1196083	S	1	0	1	0.00000
Denitratisoma oestradiolicum	311182	S	3	0	3	0.00000
Denitratisoma sp. DHT3	1981880	S	1	0	1	0.00000
Methylobacillus flagellatus	405	S	1	0	1	0.00000
Methylotenera mobilis	359408	S	1	0	1	0.00000
Candidatus Methylopumilus turicensis	1581680	S	1	0	1	0.00000
Nitrosomonas europaea	915	S	1	0	1	0.00000
Nitrosomonas sp. Is79A3	261292	S	1	0	1	0.00000
Nitrosospira lacus	1288494	S	1	0	1	0.00000
Sulfuricella denitrificans	649841	S	1	0	1	0.00000
Usitatibacter palustris	2732487	S	1	0	1	0.00000
Candidatus Accumulibacter phosphatis	327160	S	2	0	2	0.00000
Casimicrobium huifangae	2591109	S	1	0	1	0.00000
Acinetobacter junii	40215	S	242	25	267	0.00020
Acinetobacter haemolyticus	29430	S	13	2	15	0.00001
Acinetobacter baumannii	470	S	7	18	25	0.00002
Acinetobacter calcoaceticus	471	S	1	0	1	0.00000
Acinetobacter dispersus	70348	S	5	0	5	0.00000
Acinetobacter bereziniae	106648	S	4	0	4	0.00000
Acinetobacter johnsonii	40214	S	2	0	2	0.00000
Acinetobacter indicus	756892	S	2	0	2	0.00000
Acinetobacter ursingii	108980	S	2	0	2	0.00000
Acinetobacter sp. 10FS3-1	2563897	S	1	0	1	0.00000
Acinetobacter sp. SWBY1	2079596	S	1	0	1	0.00000
Acinetobacter schindleri	108981	S	1	0	1	0.00000
Acinetobacter wuhouensis	1879050	S	1	0	1	0.00000
Acinetobacter cumulans	2136182	S	1	0	1	0.00000
Acinetobacter guillouiae	106649	S	1	0	1	0.00000
Acinetobacter venetianus	52133	S	1	0	1	0.00000
Acinetobacter lwoffii	28090	S	1	0	1	0.00000
Moraxella osloensis	34062	S	37	1	38	0.00003
Psychrobacter sp. DAB_AL43B	1028416	S	2	0	2	0.00000
Psychrobacter cryohalolentis	330922	S	1	0	1	0.00000
Pseudomonas sp. CMR12a	658629	S	7	3	10	0.00001
Pseudomonas sp. 15A4	2804761	S	3	0	3	0.00000
Pseudomonas sp. J380	2605424	S	2	1	3	0.00000
Pseudomonas sp. UW4	1207075	S	2	0	2	0.00000
Pseudomonas sp. MPC6	2498848	S	2	0	2	0.00000
Pseudomonas sp. phDV1	253237	S	2	2	4	0.00000
Pseudomonas sp. 31-12	2201356	S	2	0	2	0.00000
Pseudomonas sp. Tri1	2823875	S	1	0	1	0.00000
Pseudomonas sp. R76	1573711	S	1	0	1	0.00000
Pseudomonas sp. MRSN12121	1611770	S	1	0	1	0.00000
Pseudomonas sp. R4-39-08	1173288	S	1	1	2	0.00000
Pseudomonas sp. ABC1	2748080	S	1	0	1	0.00000
Pseudomonas aeruginosa	287	S	16	35	51	0.00004
Pseudomonas mendocina	300	S	2	0	2	0.00000
Pseudomonas alcaligenes	43263	S	2	0	2	0.00000
Pseudomonas citronellolis	53408	S	2	1	3	0.00000
Pseudomonas tolaasii	29442	S	5	1	6	0.00000
Pseudomonas fluorescens	294	S	3	1	4	0.00000
Pseudomonas protegens	380021	S	2	0	2	0.00000
Pseudomonas azotoformans	47878	S	2	1	3	0.00000
Pseudomonas rhodesiae	76760	S	1	0	1	0.00000
Pseudomonas poae	200451	S	1	0	1	0.00000
Pseudomonas brenneri	129817	S	1	0	1	0.00000
Pseudomonas orientalis	76758	S	1	0	1	0.00000
Pseudomonas putida	303	S	9	7	16	0.00001
Pseudomonas fulva	47880	S	6	14	20	0.00002
Pseudomonas syringae	317	S	5	3	8	0.00001
Pseudomonas cichorii	36746	S	2	0	2	0.00000
Pseudomonas asturiensis	1190415	S	2	0	2	0.00000
Pseudomonas stutzeri	316	S	8	0	8	0.00001
Pseudomonas chlororaphis	587753	S	3	0	3	0.00000
Pseudomonas graminis	158627	S	3	0	3	0.00000
Pseudomonas lalkuanensis	2604832	S	2	0	2	0.00000
Pseudomonas versuta	1788301	S	2	0	2	0.00000
Pseudomonas cerasi	1583341	S	2	3	5	0.00000
Pseudomonas entomophila	312306	S	2	0	2	0.00000
Pseudomonas yamanorum	515393	S	2	0	2	0.00000
Pseudomonas lurida	244566	S	2	0	2	0.00000
Pseudomonas cremoricolorata	157783	S	2	0	2	0.00000
Pseudomonas brassicacearum	930166	S	1	1	2	0.00000
Pseudomonas prosekii	1148509	S	1	0	1	0.00000
Pseudomonas antarctica	219572	S	1	0	1	0.00000
Pseudomonas alkylphenolica	237609	S	1	0	1	0.00000
Pseudomonas litoralis	797277	S	1	0	1	0.00000
Pseudomonas oryzae	1392877	S	1	0	1	0.00000
Pseudomonas sihuiensis	1274359	S	1	0	1	0.00000
Pseudomonas allokribbensis	2774460	S	1	0	1	0.00000
Pseudomonas eucalypticola	2599595	S	1	0	1	0.00000
Oblitimonas alkaliphila	1697053	S	3	0	3	0.00000
Azotobacter vinelandii	354	S	1	-1	0	0.00000
Entomomonas sp. F2A	2785331	S	1	0	1	0.00000
Klebsiella pneumoniae	573	S	134	188	322	0.00025
Klebsiella grimontii	2058152	S	7	3	10	0.00001
Klebsiella oxytoca	571	S	1	0	1	0.00000
Salmonella enterica	28901	S	3	4	7	0.00001
Salmonella sp.	599	S	1	37	38	0.00003
Citrobacter farmeri	67824	S	3	0	3	0.00000
Citrobacter freundii	546	S	1	1	2	0.00000
Citrobacter sp. BDA59-3	2781952	S	1	0	1	0.00000
Enterobacter hormaechei	158836	S	2	0	2	0.00000
Enterobacter kobei	208224	S	1	0	1	0.00000
Enterobacter sp. E76	2596949	S	1	0	1	0.00000
Enterobacteriaceae endosymbiont of Plateumaris braccata	2675793	S	1	0	1	0.00000
Enterobacteriaceae endosymbiont of Donacia bicoloricornis	2675772	S	1	0	1	0.00000
Cronobacter dublinensis	413497	S	1	0	1	0.00000
Scandinavium goeteborgense	1851514	S	1	0	1	0.00000
Kluyvera intermedia	61648	S	1	0	1	0.00000
Escherichia fergusonii	564	S	1	0	1	0.00000
Buchnera aphidicola	9	S	5	0	5	0.00000
Pantoea vagans	470934	S	1	1	2	0.00000
Pantoea agglomerans	549	S	1	0	1	0.00000
Pantoea sp. MSR2	2052056	S	1	0	1	0.00000
Erwinia gerundensis	1619313	S	2	0	2	0.00000
Candidatus Erwinia haradaeae	1922217	S	2	0	2	0.00000
Mixta theicola	1458355	S	1	0	1	0.00000
Serratia marcescens	615	S	2	3	5	0.00000
Serratia plymuthica	82996	S	1	0	1	0.00000
Yersinia enterocolitica	630	S	1	0	1	0.00000
Yersinia pseudotuberculosis	633	S	1	0	1	0.00000
Photorhabdus laumondii	2218628	S	2	0	2	0.00000
Pectobacterium punjabense	2108399	S	1	0	1	0.00000
Dickeya zeae	204042	S	1	0	1	0.00000
Limnobaculum parvum	2172103	S	1	0	1	0.00000
Lysobacter enzymogenes	69	S	34	2	36	0.00003
Lysobacter solisilvae	2763317	S	2	0	2	0.00000
Lysobacter antibioticus	84531	S	1	0	1	0.00000
Lysobacter soli	453783	S	1	0	1	0.00000
Lysobacter sp. H21R4	2781021	S	1	0	1	0.00000
Lysobacter oculi	2698682	S	1	0	1	0.00000
Stenotrophomonas maltophilia	40324	S	11	13	24	0.00002
Stenotrophomonas sp. ESTM1D_MKCIP4_1	2072414	S	1	0	1	0.00000
Stenotrophomonas sp. NA06056	2742129	S	2	0	2	0.00000
Xanthomonas campestris	339	S	6	0	6	0.00000
Xanthomonas euvesicatoria	456327	S	5	75	80	0.00006
Xanthomonas oryzae	347	S	2	0	2	0.00000
Xanthomonas translucens	343	S	1	-1	0	0.00000
Xanthomonas citri	346	S	1	0	1	0.00000
Xanthomonas hyacinthi	56455	S	1	0	1	0.00000
Xanthomonas cucurbitae	56453	S	1	0	1	0.00000
Xanthomonas cassavae	56450	S	1	0	1	0.00000
Xanthomonas axonopodis	53413	S	1	0	1	0.00000
Thermomonas carbonis	1463158	S	2	0	2	0.00000
Thermomonas sp. SY21	2202149	S	1	0	1	0.00000
Pseudoxanthomonas mexicana	128785	S	2	0	2	0.00000
Dyella sp. M7H15-1	2501295	S	1	0	1	0.00000
Halomonas sp. JS92-SW72	2306583	S	12	0	12	0.00001
Halomonas sp. YLGW01	2773308	S	2	0	2	0.00000
Halomonas sp. THAF5a	2587844	S	1	0	1	0.00000
Halomonas sp. BC-M4-5	2497861	S	1	0	1	0.00000
Halomonas hydrothermalis	115561	S	2	0	2	0.00000
Halotalea alkalilenta	376489	S	1	0	1	0.00000
Marinomonas arctica	383750	S	1	0	1	0.00000
Marinomonas algicola	2773454	S	1	0	1	0.00000
Marinobacterium sp. LSUCC0821	2668067	S	1	0	1	0.00000
Bacterioplanes sanyensis	1249553	S	1	0	1	0.00000
Alcanivorax pacificus	1306787	S	1	0	1	0.00000
Alcanivorax sp. N3-2A	2014542	S	1	0	1	0.00000
Alteromonas mediterranea	314275	S	2	2	4	0.00000
Marinobacter sp. es.042	1761794	S	2	0	2	0.00000
Marinobacter salarius	1420917	S	1	0	1	0.00000
Salinimonas sediminis	2303538	S	1	0	1	0.00000
Pseudoalteromonas piscicida	43662	S	1	0	1	0.00000
Pseudoalteromonas prydzensis	182141	S	1	0	1	0.00000
Pseudoalteromonas aliena	247523	S	1	0	1	0.00000
Pseudoalteromonas paragorgicola	166934	S	1	0	1	0.00000
Pseudoalteromonas xiamenensis	882626	S	1	0	1	0.00000
Pseudoalteromonas shioyasakiensis	1190813	S	1	0	1	0.00000
Shewanella violacea	60217	S	1	0	1	0.00000
Shewanella denitrificans	192073	S	1	0	1	0.00000
Shewanella piezotolerans	404011	S	1	0	1	0.00000
Shewanella pealeana	70864	S	1	0	1	0.00000
Idiomarina andamanensis	1940690	S	1	0	1	0.00000
Vibrio anguillarum	55601	S	5	0	5	0.00000
Vibrio cincinnatiensis	675	S	2	0	2	0.00000
Vibrio diabolicus	50719	S	2	0	2	0.00000
Vibrio vulnificus	672	S	1	0	1	0.00000
Vibrio furnissii	29494	S	1	0	1	0.00000
Vibrio navarrensis	29495	S	1	0	1	0.00000
Photobacterium profundum	74109	S	1	0	1	0.00000
Aliivibrio fischeri	668	S	1	0	1	0.00000
Legionella israelensis	454	S	1	0	1	0.00000
Legionella fallonii	96230	S	1	0	1	0.00000
Legionella cherrii	28084	S	1	0	1	0.00000
Legionella sainthelensi	28087	S	1	0	1	0.00000
Legionella pneumophila	446	S	1	0	1	0.00000
Fluoribacter dumoffii	463	S	1	-1	0	0.00000
Candidatus Coxiella mudrowiae	2054173	S	2	0	2	0.00000
Coxiella burnetii	777	S	1	0	1	0.00000
Coxiella endosymbiont of Amblyomma sculptum	2487929	S	1	0	1	0.00000
Aquicella siphonis	254247	S	1	0	1	0.00000
Actinobacillus pleuropneumoniae	715	S	2	0	2	0.00000
Actinobacillus succinogenes	67854	S	1	0	1	0.00000
Actinobacillus porcitonsillarum	189834	S	1	0	1	0.00000
Haemophilus influenzae	727	S	2	0	2	0.00000
Glaesserella parasuis	738	S	1	0	1	0.00000
Histophilus somni	731	S	1	0	1	0.00000
Pasteurella skyensis	97481	S	1	0	1	0.00000
Aeromonas sp. CU5	2033033	S	4	0	4	0.00000
Aeromonas hydrophila	644	S	2	1	3	0.00000
Aeromonas veronii	654	S	1	0	1	0.00000
Succinivibrio dextrinosolvens	83771	S	1	0	1	0.00000
Candidatus Thiodictyon syntrophicum	1166950	S	1	0	1	0.00000
Rheinheimera sp. LHK132	2498451	S	1	0	1	0.00000
Acidihalobacter yilgarnenesis	2819280	S	1	0	1	0.00000
Granulosicoccus antarcticus	437505	S	1	0	1	0.00000
Sulfurivermis fontis	1972068	S	1	0	1	0.00000
Woeseia oceani	1548547	S	1	0	1	0.00000
Francisella hispaniensis	622488	S	3	0	3	0.00000
Francisella persica	954	S	1	0	1	0.00000
Methylophaga frappieri	754477	S	1	0	1	0.00000
Thiomicrorhabdus indica	2267253	S	1	0	1	0.00000
Cardiobacterium hominis	2718	S	5	0	5	0.00000
Cellvibrio sp. PSBB006	1987723	S	1	0	1	0.00000
Microbulbifer aggregans	1769779	S	1	0	1	0.00000
Methylomonas methanica	421	S	1	0	1	0.00000
Methylotuvimicrobium buryatense	95641	S	1	0	1	0.00000
endosymbiont of Euscepes postfasciatus	650377	S	1	0	1	0.00000
Salinisphaera sp. LB1	2183911	S	1	0	1	0.00000
Solimonas sp. K1W22B-7	2303331	S	1	0	1	0.00000
Bradyrhizobium sp. CCBAU 051011	858422	S	4	0	4	0.00000
Bradyrhizobium sp. PSBB068	2715960	S	3	2	5	0.00000
Bradyrhizobium sp. CCBAU 51765	1325102	S	3	1	4	0.00000
Bradyrhizobium sp. 6(2017)	1197460	S	2	1	3	0.00000
Bradyrhizobium sp. CCBAU 53340	1325112	S	1	1	2	0.00000
Bradyrhizobium sp. CCBAU 53421	1325120	S	1	0	1	0.00000
Bradyrhizobium sp. CCBAU 53338	1325111	S	1	1	2	0.00000
Bradyrhizobium sp. CCBAU 51753	1325100	S	1	0	1	0.00000
Bradyrhizobium erythrophlei	1437360	S	5	0	5	0.00000
Bradyrhizobium paxllaeri	190148	S	5	0	5	0.00000
Bradyrhizobium icense	1274631	S	3	0	3	0.00000
Bradyrhizobium symbiodeficiens	1404367	S	3	1	4	0.00000
Bradyrhizobium japonicum	375	S	3	3	6	0.00000
Bradyrhizobium canariense	255045	S	2	0	2	0.00000
Bradyrhizobium betae	244734	S	2	1	3	0.00000
Bradyrhizobium cosmicum	1404864	S	2	0	2	0.00000
Bradyrhizobium diazoefficiens	1355477	S	2	3	5	0.00000
Bradyrhizobium arachidis	858423	S	1	0	1	0.00000
Bradyrhizobium genosp. L	83637	S	1	0	1	0.00000
Bradyrhizobium guangdongense	1325090	S	1	1	2	0.00000
Bradyrhizobium guangxiense	1325115	S	1	0	1	0.00000
Bosea sp. RAC05	1842539	S	3	0	3	0.00000
Bosea sp. F3-2	2599640	S	3	0	3	0.00000
Bosea sp. ANAM02	2020412	S	2	0	2	0.00000
Bosea sp. PAMC 26642	1792307	S	1	0	1	0.00000
Bosea sp. Tri-49	1867715	S	1	0	1	0.00000
Rhodopseudomonas palustris	1076	S	7	3	10	0.00001
Tardiphaga robiniae	943830	S	5	0	5	0.00000
Nitrobacter winogradskyi	913	S	2	0	2	0.00000
Afipia carboxidovorans	40137	S	1	-1	0	0.00000
Methylorubrum extorquens	408	S	9	5	14	0.00001
Methylorubrum populi	223967	S	7	1	8	0.00001
Methylobacterium sp. 17Sr1-1	2202826	S	2	0	2	0.00000
Methylobacterium sp. XJLW	739141	S	1	4	5	0.00000
Methylobacterium sp. 17Sr1-43	2202828	S	1	0	1	0.00000
Methylobacterium durans	2202825	S	2	0	2	0.00000
Methylobacterium terrae	2202827	S	2	0	2	0.00000
Methylobacterium mesophilicum	39956	S	1	0	1	0.00000
Methylobacterium nodulans	114616	S	1	0	1	0.00000
Methylobacterium aquaticum	270351	S	1	0	1	0.00000
Methylobacterium indicum	1775910	S	1	0	1	0.00000
Rhizobium sp. TCK	136098	S	1	0	1	0.00000
Rhizobium sp. WL3	2603277	S	1	0	1	0.00000
Rhizobium sp. NXC24	2048897	S	1	0	1	0.00000
Rhizobium leguminosarum	384	S	3	0	3	0.00000
Rhizobium etli	29449	S	2	0	2	0.00000
Rhizobium pusense	648995	S	2	4	6	0.00000
Rhizobium rosettiformans	1368430	S	1	0	1	0.00000
Rhizobium jaguaris	1312183	S	1	0	1	0.00000
Sinorhizobium medicae	110321	S	2	0	2	0.00000
Sinorhizobium fredii	380	S	1	0	1	0.00000
Ensifer adhaerens	106592	S	1	0	1	0.00000
Shinella sp. HZN7	879274	S	2	0	2	0.00000
Shinella sp. PSBB067	2715959	S	1	0	1	0.00000
Kaistia sp. 32K	2795690	S	2	0	2	0.00000
Mesorhizobium sp. M6A.T.Cr.TU.016.01.1.1	2493677	S	1	0	1	0.00000
Mesorhizobium sp. J8	2777475	S	1	0	1	0.00000
Mesorhizobium sp. L-8-3	2744522	S	1	4	5	0.00000
Mesorhizobium sp. N3	675281	S	1	0	1	0.00000
Mesorhizobium sp. Pch-S	2082387	S	1	0	1	0.00000
Mesorhizobium australicum	536018	S	2	2	4	0.00000
Mesorhizobium oceanicum	1670800	S	2	0	2	0.00000
Mesorhizobium opportunistum	593909	S	1	1	2	0.00000
Phyllobacterium zundukense	1867719	S	2	0	2	0.00000
Salaquimonas pukyongi	2712698	S	1	0	1	0.00000
Devosia sp. A16	1736675	S	7	0	7	0.00001
Devosia sp. I507	2083786	S	1	0	1	0.00000
Devosia sp. LEGU1	2774137	S	1	0	1	0.00000
Devosia ginsengisoli	400770	S	1	0	1	0.00000
Hyphomicrobium nitrativorans	1427356	S	2	0	2	0.00000
Hyphomicrobium denitrificans	53399	S	1	0	1	0.00000
Aquabacter sp. L1I39	2820278	S	2	0	2	0.00000
Candidatus Filomicrobium marinum	1608628	S	2	0	2	0.00000
Blastochloris tepida	2233851	S	1	0	1	0.00000
Xanthobacter sp. YN2	2528964	S	4	0	4	0.00000
Starkeya sp. ORNL1	2709380	S	2	0	2	0.00000
Ancylobacter sp. TS-1	1850374	S	1	0	1	0.00000
Bartonella australis	388640	S	2	0	2	0.00000
Bartonella apis	1686310	S	1	0	1	0.00000
Bartonella birtlesii	111504	S	1	0	1	0.00000
Methylocystis rosea	173366	S	2	0	2	0.00000
Methylocystis heyeri	391905	S	1	0	1	0.00000
Pannonibacter phragmitetus	121719	S	2	1	3	0.00000
Pyruvatibacter mobilis	1712261	S	2	0	2	0.00000
Martelella endophytica	1486262	S	1	0	1	0.00000
Aureimonas sp. AU20	1349819	S	1	0	1	0.00000
Sphingomonas sp. CL5.1	2653203	S	4	0	4	0.00000
Sphingomonas sp. Cra20	1327635	S	4	0	4	0.00000
Sphingomonas sp. HMP9	1517554	S	4	0	4	0.00000
Sphingomonas sp. sand1-3	2764186	S	2	0	2	0.00000
Sphingomonas sp. DH-S5	2759526	S	2	0	2	0.00000
Sphingomonas sp. HMP6	1517551	S	2	0	2	0.00000
Sphingomonas sp. AAP5	1523415	S	2	0	2	0.00000
Sphingomonas sp. C8-2	2492837	S	2	1	3	0.00000
Sphingomonas sp. LM7	1938607	S	2	0	2	0.00000
Sphingomonas sp. FARSPH	2219696	S	1	0	1	0.00000
Sphingomonas sp. MK52	2711156	S	1	0	1	0.00000
Sphingomonas sp. C33	2698679	S	1	0	1	0.00000
Sphingomonas sp. XS-10	2599297	S	1	0	1	0.00000
Sphingomonas sp. PAMC26645	2565555	S	1	0	1	0.00000
Sphingomonas sp. LK11	1390395	S	1	0	1	0.00000
Sphingomonas melonis	152682	S	7	6	13	0.00001
Sphingomonas hengshuiensis	1609977	S	5	0	5	0.00000
Sphingomonas insulae	424800	S	4	0	4	0.00000
Sphingomonas panacisoli	1813879	S	4	0	4	0.00000
Sphingomonas paucimobilis	13689	S	3	1	4	0.00000
Sphingomonas alpina	653931	S	3	0	3	0.00000
Sphingomonas wittichii	160791	S	2	0	2	0.00000
Sphingomonas rhizophila	2071607	S	1	0	1	0.00000
Sphingomonas sanxanigenens	397260	S	1	0	1	0.00000
Sphingomonas taxi	1549858	S	1	0	1	0.00000
Sphingopyxis sp. 113P3	292913	S	3	1	4	0.00000
Sphingopyxis sp. EG6	1874061	S	2	0	2	0.00000
Sphingopyxis sp. FD7	1914525	S	2	0	2	0.00000
Sphingopyxis sp. MG	1866325	S	1	4	5	0.00000
Sphingopyxis sp. OPL5	2486273	S	1	0	1	0.00000
Sphingopyxis macrogoltabida	33050	S	6	2	8	0.00001
Sphingopyxis fribergensis	1515612	S	3	1	4	0.00000
Sphingopyxis alaskensis	117207	S	2	0	2	0.00000
Sphingopyxis lindanitolerans	2054227	S	2	1	3	0.00000
Sphingopyxis terrae	33052	S	1	0	1	0.00000
Sphingobium sp. YBL2	484429	S	1	6	7	0.00001
Sphingobium sp. RAC03	1843368	S	1	0	1	0.00000
Sphingobium sp. KCTC 72723	2733867	S	1	0	1	0.00000
Sphingobium yanoikuyae	13690	S	3	5	8	0.00001
Sphingobium herbicidovorans	76947	S	3	2	5	0.00000
Sphingobium cloacae	120107	S	1	2	3	0.00000
Sphingobium hydrophobicum	1673076	S	1	1	2	0.00000
Novosphingobium sp. ABRDHK2	2571749	S	4	2	6	0.00000
Novosphingobium sp. P6W	1609758	S	2	0	2	0.00000
Novosphingobium sp. ES2-1	2780074	S	2	0	2	0.00000
Novosphingobium ginsenosidimutans	1176536	S	2	0	2	0.00000
Sphingorhabdus lacus	392610	S	3	0	3	0.00000
Sphingorhabdus sp. M41	1806885	S	2	0	2	0.00000
Blastomonas fulva	1550728	S	1	2	3	0.00000
Sphingosinithalassobacter sp. CS137	2762748	S	2	0	2	0.00000
Sphingosinithalassobacter sp. zrk23	2711215	S	1	0	1	0.00000
Parasphingopyxis algicola	2026624	S	2	0	2	0.00000
Citromicrobium sp. JL477	1634516	S	1	0	1	0.00000
Tardibacter chloracetimidivorans	1921510	S	1	1	2	0.00000
Novosphingopyxis sp. PB63	2762729	S	1	0	1	0.00000
Porphyrobacter sp. LM 6	1896196	S	2	0	2	0.00000
Porphyrobacter sp. HT-58-2	2023229	S	2	0	2	0.00000
Porphyrobacter sp. CACIAM 03H1	2003315	S	1	0	1	0.00000
Erythrobacter neustonensis	1112	S	2	0	2	0.00000
Erythrobacter sp. KY5	2011159	S	1	0	1	0.00000
Croceicoccus marinus	450378	S	5	1	6	0.00000
Croceicoccus naphthovorans	1348774	S	1	0	1	0.00000
Tsuneonella dongtanensis	692370	S	2	0	2	0.00000
Tsuneonella flava	2055955	S	2	0	2	0.00000
Tsuneonella mangrovi	1982042	S	1	0	1	0.00000
Tsuneonella amylolytica	2338327	S	1	0	1	0.00000
Qipengyuania seohaensis	266951	S	2	0	2	0.00000
Altererythrobacter ishigakiensis	476157	S	1	0	1	0.00000
Sphingosinicella microcystinivorans	335406	S	1	0	1	0.00000
Paracoccus sp. BM15	1529068	S	4	0	4	0.00000
Paracoccus sp. MC1862	2760307	S	2	0	2	0.00000
Paracoccus yeei	147645	S	3	1	4	0.00000
Paracoccus aminophilus	34003	S	1	0	1	0.00000
Paracoccus contaminans	1945662	S	1	0	1	0.00000
Rhodobacter sp. CZR27	2033869	S	3	0	3	0.00000
Rhodobacter blasticus	1075	S	2	0	2	0.00000
Rhodobacter capsulatus	1061	S	1	0	1	0.00000
Sulfitobacter pseudonitzschiae	1402135	S	4	1	5	0.00000
Sulfitobacter sp. THAF37	2587855	S	1	0	1	0.00000
Roseovarius sp. THAF27	2587850	S	2	1	3	0.00000
Roseovarius sp. THAF9	2587847	S	1	0	1	0.00000
Phaeobacter inhibens	221822	S	1	0	1	0.00000
Phaeobacter piscinae	1580596	S	1	1	2	0.00000
Gemmobacter sp. HYN0069	2169400	S	2	0	2	0.00000
Cereibacter sphaeroides	1063	S	2	0	2	0.00000
Tabrizicola piscis	2494374	S	2	0	2	0.00000
Confluentimicrobium sp. EMB200-NS6	1609966	S	2	1	3	0.00000
Rhodovulum sulfidophilum	35806	S	1	0	1	0.00000
Rhodovulum sp. P5	1564506	S	1	0	1	0.00000
Roseobacter denitrificans	2434	S	1	0	1	0.00000
Roseobacter ponti	1891787	S	1	0	1	0.00000
Mameliella alba	561184	S	1	0	1	0.00000
Epibacterium mobile	379347	S	1	0	1	0.00000
Haematobacter massiliensis	195105	S	1	0	1	0.00000
Marivivens sp. JLT3646	1920883	S	1	0	1	0.00000
Pseudorhodobacter turbinis	2500533	S	1	0	1	0.00000
Roseicitreum antarcticum	564137	S	1	0	1	0.00000
Paraoceanicella profunda	2579971	S	1	0	1	0.00000
Brevundimonas sp. LVF1	2774189	S	4	0	4	0.00000
Brevundimonas sp. SGAir0440	2579977	S	3	0	3	0.00000
Brevundimonas sp. GW460-12-10-14-LB2	1827469	S	2	1	3	0.00000
Brevundimonas sp. DS20	1532555	S	1	0	1	0.00000
Brevundimonas sp. 'scallop'	2562582	S	1	0	1	0.00000
Brevundimonas sp. M20	2591463	S	1	0	1	0.00000
Brevundimonas sp. LVF2	2774190	S	1	0	1	0.00000
Brevundimonas sp. GRTSA-9	2800818	S	1	0	1	0.00000
Brevundimonas diminuta	293	S	3	4	7	0.00001
Brevundimonas mediterranea	74329	S	2	0	2	0.00000
Brevundimonas naejangsanensis	588932	S	2	0	2	0.00000
Caulobacter flavus	1679497	S	2	0	2	0.00000
Caulobacter mirabilis	69666	S	1	0	1	0.00000
Caulobacter vibrioides	155892	S	1	0	1	0.00000
Caulobacter rhizosphaerae	2010972	S	1	0	1	0.00000
Caulobacter sp. FWC26	69665	S	1	0	1	0.00000
Caulobacter soli	2708539	S	1	0	1	0.00000
Terricaulis silvestris	2686094	S	1	0	1	0.00000
Azospirillum brasilense	192	S	3	0	3	0.00000
Azospirillum sp. TSH100	652764	S	1	0	1	0.00000
Magnetospirillum sp. XM-1	1663591	S	1	1	2	0.00000
Magnetospirillum magneticum	84159	S	1	0	1	0.00000
Tistrella mobilis	171437	S	2	0	2	0.00000
Lichenicola cladoniae	1484109	S	1	0	1	0.00000
Parasaccharibacter apium	1510841	S	1	0	1	0.00000
Rickettsia endosymbiont of Bemisia tabaci	337479	S	1	0	1	0.00000
Rickettsia sp. Tillamook 23	2761623	S	1	0	1	0.00000
Rickettsia endosymbiont of Ixodes scapularis	444612	S	1	0	1	0.00000
Wolbachia endosymbiont of Dirofilaria (Dirofilaria) immitis	1812115	S	1	0	1	0.00000
Rickettsiales endosymbiont of Stachyamoeba lipophora	2486578	S	1	0	1	0.00000
Hyphobacterium sp. CCMP332	2749086	S	3	0	3	0.00000
Maricaulis maris	74318	S	2	0	2	0.00000
Glycocaulis alkaliphilus	1434191	S	1	0	1	0.00000
Phreatobacter cathodiphilus	1868589	S	2	0	2	0.00000
Micavibrio aeruginosavorus	349221	S	1	0	1	0.00000
Candidatus Pelagibacter sp. FZCC0015	2268451	S	1	0	1	0.00000
Magnetococcus marinus	1124597	S	1	0	1	0.00000
Candidatus Paracaedibacter acanthamoebae	91604	S	1	0	1	0.00000
Sorangium cellulosum	56	S	4	0	4	0.00000
Labilithrix luteola	1391654	S	4	0	4	0.00000
Sandaracinus amylolyticus	927083	S	1	0	1	0.00000
Archangium gephyra	48	S	1	0	1	0.00000
Archangium violaceum	83451	S	1	0	1	0.00000
Stigmatella aurantiaca	41	S	2	0	2	0.00000
Cystobacter fuscus	43	S	1	0	1	0.00000
Vulgatibacter incomptus	1391653	S	1	0	1	0.00000
Anaeromyxobacter dehalogenans	161493	S	1	0	1	0.00000
Geobacter sp. SVR	2495594	S	4	0	4	0.00000
Geobacter bremensis	60035	S	1	0	1	0.00000
Desulfuromonas soudanensis	1603606	S	1	2	3	0.00000
Syntrophotalea carbinolica	19	S	1	0	1	0.00000
Persicimonas caeni	2292766	S	4	1	5	0.00000
Desulfovibrio vulgaris	881	S	1	0	1	0.00000
Desulfovibrio sp. IOR2	2583823	S	1	0	1	0.00000
Desulfococcus oleovorans	181663	S	1	0	1	0.00000
Aliarcobacter cryaerophilus	28198	S	2	0	2	0.00000
Aliarcobacter butzleri	28197	S	1	0	1	0.00000
Aliarcobacter cibarius	255507	S	1	0	1	0.00000
Arcobacter nitrofigilis	28199	S	1	0	1	0.00000
Arcobacter venerupis	1054033	S	1	0	1	0.00000
Arcobacter suis	1278212	S	1	0	1	0.00000
Arcobacter aquimarinus	1315211	S	1	0	1	0.00000
Malaciobacter halophilus	197482	S	1	0	1	0.00000
Malaciobacter molluscorum	1032072	S	1	0	1	0.00000
Halarcobacter ebronensis	1462615	S	2	0	2	0.00000
Pseudoarcobacter acticola	1849015	S	1	0	1	0.00000
Campylobacter fetus	196	S	2	0	2	0.00000
Campylobacter ureolyticus	827	S	2	0	2	0.00000
Campylobacter concisus	199	S	2	0	2	0.00000
Campylobacter sp. RM12175	1660076	S	1	1	2	0.00000
Campylobacter lanienae	75658	S	1	0	1	0.00000
Campylobacter mucosalis	202	S	1	0	1	0.00000
Helicobacter pylori	210	S	2	0	2	0.00000
Candidatus Sulfurimonas baltica	2740404	S	1	0	1	0.00000
Sulfuricurvum kujiense	148813	S	1	0	1	0.00000
Bdellovibrio sp. ZAP7	2231053	S	3	0	3	0.00000
Halobacteriovorax marinus	97084	S	2	0	2	0.00000
Cutibacterium acnes	1747	S	369	25	394	0.00030
Cutibacterium avidum	33010	S	4	0	4	0.00000
Cutibacterium granulosum	33011	S	1	0	1	0.00000
Propionibacterium sp. oral taxon 193	671223	S	18	3	21	0.00002
Tessaracoccus timonensis	2161816	S	2	0	2	0.00000
Tessaracoccus defluvii	1285901	S	1	0	1	0.00000
Tessaracoccus aquimaris	1332264	S	1	0	1	0.00000
Acidipropionibacterium acidipropionici	1748	S	1	2	3	0.00000
Propioniciclava sp. HDW11	2714937	S	2	0	2	0.00000
Pseudopropionibacterium propionicum	1750	S	2	0	2	0.00000
Microlunatus soli	630515	S	1	0	1	0.00000
Nocardioides sp. WS12	2486272	S	2	0	2	0.00000
Nocardioides sp. JS614	196162	S	1	0	1	0.00000
Nocardioides sp. 603	2483798	S	1	1	2	0.00000
Nocardioides sp. S-713	2760089	S	1	1	2	0.00000
Nocardioides mesophilus	433659	S	2	0	2	0.00000
Nocardioides euryhalodurans	2518370	S	1	0	1	0.00000
Nocardioides anomalus	2712223	S	1	0	1	0.00000
Kribbella flavida	182640	S	1	0	1	0.00000
Rhodococcus sp. YL-1	1045808	S	12	58	70	0.00005
Rhodococcus sp. P-2	2795031	S	3	0	3	0.00000
Rhodococcus sp. NJ-530	2490853	S	1	5	6	0.00000
Rhodococcus sp. P1Y	1302308	S	1	0	1	0.00000
Rhodococcus sp. S2-17	1990687	S	1	3	4	0.00000
Rhodococcus sp. BH4	1807790	S	1	6	7	0.00001
Rhodococcus sp. MTM3W5.2	1805827	S	1	0	1	0.00000
Rhodococcus qingshengii	334542	S	18	106	124	0.00010
Rhodococcus erythropolis	1833	S	7	26	33	0.00003
Rhodococcus ruber	1830	S	2	0	2	0.00000
Rhodococcus hoagii	43767	S	1	0	1	0.00000
Nocardia brasiliensis	37326	S	2	0	2	0.00000
Nocardia sp. CS682	1047172	S	1	0	1	0.00000
Nocardia sp. WCH-YHL-001	2755382	S	1	0	1	0.00000
Nocardia otitidiscaviarum	1823	S	1	0	1	0.00000
Nocardia cyriacigeorgica	135487	S	1	0	1	0.00000
Nocardia arthritidis	228602	S	1	0	1	0.00000
Nocardia terpenica	455432	S	1	0	1	0.00000
Nocardia mangyaensis	2213200	S	1	0	1	0.00000
Nocardia yunnanensis	2382165	S	1	0	1	0.00000
Mycobacteroides chelonae	1774	S	19	5	24	0.00002
Mycobacteroides abscessus	36809	S	2	0	2	0.00000
Mycobacteroides saopaulense	1578165	S	1	0	1	0.00000
Mycobacterium gordonae	1778	S	4	1	5	0.00000
Mycobacterium sp. JS623	212767	S	2	0	2	0.00000
Mycobacterium xenopi	1789	S	1	1	2	0.00000
Mycobacterium colombiense	339268	S	1	0	1	0.00000
Mycobacterium dioxanotrophicus	482462	S	1	0	1	0.00000
Mycobacterium riyadhense	486698	S	1	0	1	0.00000
Mycolicibacterium boenickei	146017	S	2	1	3	0.00000
Mycolicibacterium goodii	134601	S	1	0	1	0.00000
Mycolicibacterium phocaicum	319706	S	1	0	1	0.00000
Mycolicibacterium litorale	758802	S	1	0	1	0.00000
Mycolicibacterium mageritense	53462	S	1	0	1	0.00000
Mycolicibacterium aichiense	1799	S	1	0	1	0.00000
Mycolicibacterium helvum	1534349	S	1	0	1	0.00000
Mycolicibacterium fallax	1793	S	1	0	1	0.00000
Mycolicibacterium chitae	1792	S	1	0	1	0.00000
Mycolicibacterium aurum	1791	S	1	0	1	0.00000
Mycolicibacterium phlei	1771	S	1	0	1	0.00000
Mycolicibacillus koreensis	1069220	S	1	0	1	0.00000
Corynebacterium tuberculostearicum	38304	S	10	3	13	0.00001
Corynebacterium kroppenstedtii	161879	S	8	0	8	0.00001
Corynebacterium vitaeruminis	38305	S	3	0	3	0.00000
Corynebacterium kefirresidentii	1979527	S	3	1	4	0.00000
Corynebacterium riegelii	156976	S	3	0	3	0.00000
Corynebacterium lactis	1231000	S	2	0	2	0.00000
Corynebacterium sp. NML98-0116	702967	S	1	0	1	0.00000
Corynebacterium sp. 2019	2675218	S	1	0	1	0.00000
Corynebacterium glucuronolyticum	39791	S	2	0	2	0.00000
Corynebacterium ureicelerivorans	401472	S	2	0	2	0.00000
Corynebacterium pelargi	1471400	S	2	0	2	0.00000
Corynebacterium jeikeium	38289	S	2	3	5	0.00000
Corynebacterium epidermidicanis	1050174	S	1	0	1	0.00000
Corynebacterium terpenotabidum	89154	S	1	0	1	0.00000
Corynebacterium glyciniphilum	1404244	S	1	0	1	0.00000
Corynebacterium simulans	146827	S	1	0	1	0.00000
Corynebacterium imitans	156978	S	1	0	1	0.00000
Corynebacterium aurimucosum	169292	S	1	0	1	0.00000
Corynebacterium diphtheriae	1717	S	1	0	1	0.00000
Tsukamurella paurometabola	2061	S	8	0	8	0.00001
Tsukamurella tyrosinosolvens	57704	S	5	0	5	0.00000
Gordonia sp. JH63	2698900	S	3	1	4	0.00000
Gordonia sp. KTR9	337191	S	1	0	1	0.00000
Gordonia polyisoprenivorans	84595	S	2	0	2	0.00000
Gordonia terrae	2055	S	1	0	1	0.00000
Gordonia rubripertincta	36822	S	1	0	1	0.00000
Gordonia iterans	1004901	S	1	0	1	0.00000
Dietzia sp. oral taxon 368	712270	S	1	2	3	0.00000
Tomitella sp. HY172	2760083	S	2	0	2	0.00000
Microbacterium sp. PM5	2014534	S	14	1	15	0.00001
Microbacterium sp. NY27	2782169	S	3	0	3	0.00000
Microbacterium sp. Nx66	2766784	S	3	1	4	0.00000
Microbacterium sp. LKL04	912630	S	1	0	1	0.00000
Microbacterium sp. Se63.02b	2709304	S	1	0	1	0.00000
Microbacterium sp. HY82	2708079	S	1	0	1	0.00000
Microbacterium sp. 4R-513	2567934	S	1	0	1	0.00000
Microbacterium sp. RG1	2489212	S	1	0	1	0.00000
Microbacterium sp. ABRD_28	2268461	S	1	0	1	0.00000
Microbacterium sp. str. 'China'	2103230	S	1	8	9	0.00001
Microbacterium sp. XT11	367477	S	1	0	1	0.00000
Microbacterium sp. Y-01	2048898	S	1	0	1	0.00000
Microbacterium esteraromaticum	57043	S	4	0	4	0.00000
Microbacterium hominis	162426	S	4	0	4	0.00000
Microbacterium oxydans	82380	S	3	0	3	0.00000
Microbacterium chocolatum	84292	S	3	0	3	0.00000
Microbacterium foliorum	104336	S	3	0	3	0.00000
Microbacterium aurum	36805	S	2	0	2	0.00000
Microbacterium lushaniae	2614639	S	2	0	2	0.00000
Microbacterium pygmaeum	370764	S	2	0	2	0.00000
Microbacterium hydrocarbonoxydans	273678	S	1	0	1	0.00000
Microbacterium oryzae	743009	S	1	0	1	0.00000
Microbacterium sediminis	904291	S	1	0	1	0.00000
Microbacterium schleiferi	69362	S	1	0	1	0.00000
Curtobacterium flaccumfaciens	2035	S	28	1	29	0.00002
Leucobacter sp. CX169	2813744	S	3	2	5	0.00000
Candidatus Aquiluna sp. 15G-AUS-rot	2499157	S	3	0	3	0.00000
Rhodoluna limnophila	232537	S	1	0	1	0.00000
Salinibacterium sp. ZJ70	2708084	S	3	0	3	0.00000
Herbiconiux sp. SALV-R1	2735133	S	2	0	2	0.00000
Rathayibacter rathayi	33887	S	2	0	2	0.00000
Agrococcus jejuensis	399736	S	1	0	1	0.00000
Agrococcus sp. SGAir0287	2070347	S	1	0	1	0.00000
Microterricola viridarii	412690	S	1	0	1	0.00000
Lysinimonas sp. KACC 19322	2592654	S	1	0	1	0.00000
Leifsonia xyli	1575	S	1	0	1	0.00000
Frigoribacterium sp. NBH87	2596916	S	1	0	1	0.00000
Cryobacterium arcticum	670052	S	1	0	1	0.00000
Arthrobacter sp. Rue61a	1118963	S	5	5	10	0.00001
Arthrobacter sp. D5-1	1477518	S	4	1	5	0.00000
Arthrobacter sp. UKPF54-2	2600159	S	1	0	1	0.00000
Arthrobacter sp. KBS0702	2578107	S	1	0	1	0.00000
Arthrobacter sp. YN	2020486	S	1	0	1	0.00000
Arthrobacter sp. NEB 688	904039	S	1	0	1	0.00000
Arthrobacter sp. PM3	2017685	S	1	0	1	0.00000
Arthrobacter dokdonellae	2211210	S	3	0	3	0.00000
Arthrobacter citreus	1670	S	1	0	1	0.00000
Paenarthrobacter sp. YJN-D	2735317	S	17	2	19	0.00001
Micrococcus luteus	1270	S	4	6	10	0.00001
Rothia kristinae	37923	S	4	0	4	0.00000
Rothia dentocariosa	2047	S	2	0	2	0.00000
Rothia amarae	169480	S	1	0	1	0.00000
Kocuria rhizophila	72000	S	4	3	7	0.00001
Pseudarthrobacter phenanthrenivorans	361575	S	2	0	2	0.00000
Sinomonas atrocyanea	37927	S	1	0	1	0.00000
Glutamicibacter halophytocola	1933880	S	1	0	1	0.00000
Psychromicrobium lacuslunae	1618207	S	1	0	1	0.00000
Dermacoccus nishinomiyaensis	1274	S	36	4	40	0.00003
Brevibacterium linens	1703	S	2	2	4	0.00000
Brevibacterium aurantiacum	273384	S	1	0	1	0.00000
Brevibacterium sp. CS2	2575923	S	1	0	1	0.00000
Janibacter limosus	53458	S	1	0	1	0.00000
Janibacter melonis	262209	S	1	0	1	0.00000
Janibacter indicus	857417	S	1	0	1	0.00000
Intrasporangium calvum	53358	S	2	0	2	0.00000
Phycicoccus sp. HDW14	2714941	S	1	0	1	0.00000
Brachybacterium faecium	43669	S	1	0	1	0.00000
Brachybacterium avium	2017485	S	1	0	1	0.00000
Brachybacterium sp. P6-10-X1	1903186	S	1	0	1	0.00000
Serinicoccus profundi	1078471	S	2	0	2	0.00000
Ornithinimicrobium sp. HY006	2508882	S	1	0	1	0.00000
Cellulomonas sp. PSBB021	2003551	S	1	0	1	0.00000
Cellulomonas sp. Y8	2591145	S	1	0	1	0.00000
Miniimonas sp. S16	2171623	S	1	0	1	0.00000
Ruania sp. HY168	2603206	S	1	0	1	0.00000
Luteimicrobium xylanilyticum	1133546	S	1	0	1	0.00000
Sanguibacter keddieii	60920	S	1	0	1	0.00000
Georgenia faecalis	2483799	S	1	0	1	0.00000
Xylanimonas allomyrinae	2509459	S	1	0	1	0.00000
Streptomyces sp. RLB3-17	2594455	S	2	7	9	0.00001
Streptomyces sp. NHF165	2175864	S	1	0	1	0.00000
Streptomyces sp. M56	1495638	S	1	1	2	0.00000
Streptomyces sp. TLI_053	1855352	S	1	0	1	0.00000
Streptomyces sp. SCSIO 3032	1264596	S	1	0	1	0.00000
Streptomyces sp. 769	1262452	S	1	0	1	0.00000
Streptomyces sp. RPA4-2	2721244	S	1	0	1	0.00000
Streptomyces sp. SirexAA-E	862751	S	1	0	1	0.00000
Streptomyces sp. NA04227	2742136	S	1	0	1	0.00000
Streptomyces sp. SN-593	659352	S	1	0	1	0.00000
Streptomyces sp. W1SF4	2305220	S	1	0	1	0.00000
Streptomyces sp. CRXT-Y-14	2768069	S	1	0	1	0.00000
Streptomyces sp. TN58	234612	S	1	0	1	0.00000
Streptomyces sp. ZYC-3	2797636	S	1	0	1	0.00000
Streptomyces glomeroaurantiacus	68210	S	2	0	2	0.00000
Streptomyces buecherae	2763006	S	2	0	2	0.00000
Streptomyces gilvosporeus	553510	S	2	0	2	0.00000
Streptomyces pactum	68249	S	2	0	2	0.00000
Streptomyces griseochromogenes	68214	S	2	0	2	0.00000
Streptomyces globosus	68209	S	2	0	2	0.00000
Streptomyces griseocarneus	51201	S	2	0	2	0.00000
Streptomyces lincolnensis	1915	S	2	0	2	0.00000
Streptomyces venezuelae	54571	S	1	0	1	0.00000
Streptomyces olivaceus	47716	S	1	0	1	0.00000
Streptomyces dengpaensis	2049881	S	1	0	1	0.00000
Streptomyces tirandamycinicus	2174846	S	1	0	1	0.00000
Streptomyces chartreusis	1969	S	1	0	1	0.00000
Streptomyces lydicus	47763	S	1	0	1	0.00000
Streptomyces prasinus	67345	S	1	0	1	0.00000
Streptomyces fodineus	1904616	S	1	0	1	0.00000
Streptomyces ambofaciens	1889	S	1	0	1	0.00000
Streptomyces harbinensis	1176198	S	1	0	1	0.00000
Streptomyces fagopyri	2662397	S	1	0	1	0.00000
Streptomyces niveus	193462	S	1	0	1	0.00000
Streptomyces davaonensis	348043	S	1	0	1	0.00000
Streptomyces lividans	1916	S	1	11	12	0.00001
Streptomyces exfoliatus	1905	S	1	0	1	0.00000
Streptomyces lavendulae	1914	S	1	0	1	0.00000
Streptomyces hygroscopicus	1912	S	1	-1	0	0.00000
Kitasatospora sp. MMS16-BH015	2018025	S	1	0	1	0.00000
Kitasatospora sp. NA04385	2742135	S	1	0	1	0.00000
Kitasatospora setae	2066	S	1	0	1	0.00000
Candidatus Planktophila sulfonica	1884904	S	10	6	16	0.00001
Candidatus Planktophila lacus	1884913	S	1	0	1	0.00000
Amycolatopsis mediterranei	33910	S	2	0	2	0.00000
Amycolatopsis albispora	1804986	S	1	0	1	0.00000
Amycolatopsis sp. BJA-103	1911175	S	1	0	1	0.00000
Saccharopolyspora erythraea	1836	S	1	2	3	0.00000
Saccharopolyspora coralli	2665642	S	1	0	1	0.00000
Pseudonocardia sp. HH130630-07	1690815	S	1	0	1	0.00000
Saccharothrix sp. 6-C	2781735	S	1	0	1	0.00000
Actinosynnema pretiosum	42197	S	1	0	1	0.00000
Alloactinosynnema sp. L-07	1653480	S	1	0	1	0.00000
Micromonospora echinofusca	47858	S	1	1	2	0.00000
Micromonospora inositola	47865	S	1	2	3	0.00000
Actinoplanes teichomyceticus	1867	S	1	0	1	0.00000
Actinoplanes friuliensis	196914	S	1	0	1	0.00000
Actinocatenispora thailandica	227318	S	1	0	1	0.00000
Actinomyces sp. oral taxon 171	706438	S	1	1	2	0.00000
Actinomyces sp. zg-332	2708340	S	1	0	1	0.00000
Actinomyces procaprae	2560010	S	2	1	3	0.00000
Schaalia odontolytica	1660	S	1	0	1	0.00000
Bifidobacterium thermophilum	33905	S	2	0	2	0.00000
Bifidobacterium adolescentis	1680	S	1	0	1	0.00000
Bifidobacterium choerinum	35760	S	1	0	1	0.00000
Actinomadura verrucosospora	46165	S	1	0	1	0.00000
Actinomadura sp. WMMA1423	2591108	S	1	0	1	0.00000
Nocardiopsis gilva	280236	S	1	0	1	0.00000
Candidatus Frankia datiscae	2716812	S	2	0	2	0.00000
Frankia sp. QA3	710111	S	1	0	1	0.00000
Catenulispora acidiphila	304895	S	2	0	2	0.00000
Nakamurella sp. PAMC28650	2762325	S	2	0	2	0.00000
Epidermidibacterium keratini	1891644	S	1	0	1	0.00000
Blastococcus saxobsidens	138336	S	1	0	1	0.00000
Ilumatobacter coccineus	467094	S	1	0	1	0.00000
Baekduia soli	496014	S	1	0	1	0.00000
Conexibacter sp. SYSU D00693	2812560	S	1	0	1	0.00000
Staphylococcus epidermidis	1282	S	20	1	21	0.00002
Staphylococcus cohnii	29382	S	15	3	18	0.00001
Staphylococcus aureus	1280	S	8	12	20	0.00002
Staphylococcus capitis	29388	S	7	0	7	0.00001
Staphylococcus auricularis	29379	S	6	0	6	0.00000
Staphylococcus warneri	1292	S	3	0	3	0.00000
Staphylococcus sp. AntiMn-1	1715860	S	1	3	4	0.00000
Staphylococcus carnosus	1281	S	1	0	1	0.00000
Staphylococcus equorum	246432	S	1	0	1	0.00000
Staphylococcus pasteuri	45972	S	1	0	1	0.00000
Staphylococcus hominis	1290	S	1	0	1	0.00000
Staphylococcus xylosus	1288	S	1	0	1	0.00000
Bacillus cereus	1396	S	5	4	9	0.00001
Bacillus thuringiensis	1428	S	2	1	3	0.00000
Bacillus mycoides	1405	S	1	0	1	0.00000
Bacillus sp. X1(2014)	1565991	S	2	0	2	0.00000
Bacillus sp. M4U3P1	2592382	S	2	0	2	0.00000
Bacillus sp. FJAT-22090	1581038	S	1	0	1	0.00000
Bacillus licheniformis	1402	S	1	4	5	0.00000
Bacillus tequilensis	227866	S	1	0	1	0.00000
Bacillus weihaiensis	1547283	S	1	0	1	0.00000
Bacillus circulans	1397	S	1	0	1	0.00000
Bacillus vini	1476025	S	1	0	1	0.00000
Bacillus cellulosilyticus	1413	S	1	0	1	0.00000
Priestia megaterium	1404	S	23	2	25	0.00002
Caldibacillus thermoamylovorans	35841	S	6	0	6	0.00000
Lysinibacillus sp. 2017	2169540	S	1	2	3	0.00000
Anoxybacillus flavithermus	33934	S	1	0	1	0.00000
Anoxybacillus amylolyticus	294699	S	1	0	1	0.00000
Virgibacillus sp. SK37	403957	S	1	0	1	0.00000
Radiobacillus deserti	2594883	S	1	0	1	0.00000
Salicibibacter sp. NKC21-4	2743001	S	1	0	1	0.00000
Psychrobacillus glaciei	2283160	S	1	0	1	0.00000
Pontibacillus sp. ALD_SL1	2777185	S	1	0	1	0.00000
Paenibacillus lutimineralis	2707005	S	2	0	2	0.00000
Paenibacillus mucilaginosus	61624	S	2	-2	0	0.00000
Paenibacillus lycopersici	2704462	S	1	0	1	0.00000
Paenibacillus beijingensis	1126833	S	1	0	1	0.00000
Paenibacillus psychroresistens	1778678	S	1	0	1	0.00000
Paenibacillus sp. RUD330	2023772	S	1	0	1	0.00000
Paenibacillus borealis	160799	S	1	0	1	0.00000
Brevibacillus sp. JNUCC-41	2778370	S	1	0	1	0.00000
Cohnella sp. LGH	1619153	S	1	0	1	0.00000
Listeria monocytogenes	1639	S	7	241	248	0.00019
Listeria ivanovii	1638	S	1	0	1	0.00000
Planococcus sp. PAMC 21323	1526927	S	1	0	1	0.00000
Sporosarcina pasteurii	1474	S	1	0	1	0.00000
Solibacillus sp. R5-41	2048654	S	1	0	1	0.00000
Paenisporosarcina antarctica	417367	S	1	0	1	0.00000
Kyrpidia spormannii	2055160	S	1	0	1	0.00000
Exiguobacterium mexicanum	340146	S	1	0	1	0.00000
Lactococcus lactis	1358	S	12	4	16	0.00001
Lactococcus garvieae	1363	S	6	3	9	0.00001
Lactococcus cremoris	1359	S	4	1	5	0.00000
Streptococcus oralis	1303	S	3	0	3	0.00000
Streptococcus sp. NPS 308	1902136	S	2	0	2	0.00000
Streptococcus sp. oral taxon 431	712633	S	1	0	1	0.00000
Streptococcus thermophilus	1308	S	3	0	3	0.00000
Streptococcus sanguinis	1305	S	2	0	2	0.00000
Streptococcus pyogenes	1314	S	2	0	2	0.00000
Streptococcus suis	1307	S	1	0	1	0.00000
Streptococcus gordonii	1302	S	1	0	1	0.00000
Streptococcus chenjunshii	2173853	S	1	0	1	0.00000
Streptococcus mitis	28037	S	1	0	1	0.00000
Streptococcus acidominimus	1326	S	1	0	1	0.00000
Streptococcus pneumoniae	1313	S	1	0	1	0.00000
Streptococcus agalactiae	1311	S	1	4	5	0.00000
Lactobacillus crispatus	47770	S	3	1	4	0.00000
Lactobacillus jensenii	109790	S	3	0	3	0.00000
Lactobacillus iners	147802	S	2	0	2	0.00000
Lactobacillus johnsonii	33959	S	1	0	1	0.00000
Limosilactobacillus fermentum	1613	S	8	0	8	0.00001
Paucilactobacillus hokkaidonensis	1193095	S	2	0	2	0.00000
Paucilactobacillus nenjiangensis	1296540	S	2	0	2	0.00000
Leuconostoc pseudomesenteroides	33968	S	2	0	2	0.00000
Leuconostoc mesenteroides	1245	S	1	0	1	0.00000
Lactiplantibacillus plantarum	1590	S	2	0	2	0.00000
Pediococcus pentosaceus	1255	S	1	0	1	0.00000
Loigolactobacillus coryniformis	1610	S	1	0	1	0.00000
Ligilactobacillus murinus	1622	S	1	0	1	0.00000
Enterococcus casseliflavus	37734	S	9	3	12	0.00001
Enterococcus sp. CR-Ec1	2057791	S	2	2	4	0.00000
Enterococcus sp. FDAARGOS_375	2060307	S	2	3	5	0.00000
Enterococcus cecorum	44008	S	3	0	3	0.00000
Enterococcus gilvus	160453	S	3	0	3	0.00000
Enterococcus faecalis	1351	S	2	0	2	0.00000
Aerococcus urinaeequi	51665	S	2	0	2	0.00000
Clostridium botulinum	1491	S	7	1	8	0.00001
Clostridium gasigenes	94869	S	2	0	2	0.00000
Clostridium baratii	1561	S	2	0	2	0.00000
Clostridium sp. DL-VIII	641107	S	1	0	1	0.00000
Clostridium fermenticellae	2068654	S	1	0	1	0.00000
Clostridium estertheticum	238834	S	1	0	1	0.00000
Clostridium carboxidivorans	217159	S	1	0	1	0.00000
Clostridium saccharobutylicum	169679	S	1	0	1	0.00000
Clostridium saccharoperbutylacetonicum	36745	S	1	0	1	0.00000
Clostridium beijerinckii	1520	S	1	0	1	0.00000
Clostridium septicum	1504	S	1	0	1	0.00000
Clostridium perfringens	1502	S	1	0	1	0.00000
Clostridium tetani	1513	S	1	0	1	0.00000
Clostridium pasteurianum	1501	S	1	0	1	0.00000
Roseburia intestinalis	166486	S	1	0	1	0.00000
Roseburia hominis	301301	S	1	0	1	0.00000
Lachnoanaerobaculum umeaense	617123	S	1	0	1	0.00000
Lachnoclostridium phocaeense	1871021	S	1	0	1	0.00000
Faecalibacterium prausnitzii	853	S	1	0	1	0.00000
Flavonifractor plautii	292800	S	1	0	1	0.00000
Acutalibacter muris	1796620	S	1	0	1	0.00000
Thermoclostridium stercorarium	1510	S	1	0	1	0.00000
Pseudoclostridium thermosuccinogenes	84032	S	1	0	1	0.00000
Paraclostridium bifermentans	1490	S	2	0	2	0.00000
Paeniclostridium sordellii	1505	S	1	0	1	0.00000
Clostridioides difficile	1496	S	1	0	1	0.00000
Thermaerobacter sp. PB12/4term	2293838	S	1	0	1	0.00000
Thermaerobacter sp. FW80	2546351	S	1	0	1	0.00000
Aminipila sp. JN-18	2507160	S	1	0	1	0.00000
[Eubacterium] cellulosolvens	29322	S	1	0	1	0.00000
Desulfitobacterium metallireducens	142877	S	1	0	1	0.00000
Desulfofarcimen acetoxidans	58138	S	1	0	1	0.00000
Moorella glycerini	55779	S	1	0	1	0.00000
Veillonella parvula	29466	S	2	0	2	0.00000
Veillonella dispar	39778	S	1	0	1	0.00000
Veillonella nakazawae	2682456	S	1	0	1	0.00000
Acidaminococcus intestini	187327	S	2	0	2	0.00000
Finegoldia magna	1260	S	2	0	2	0.00000
Peptoniphilus harei	54005	S	2	0	2	0.00000
Tissierellia sp. JN-28	2507161	S	1	0	1	0.00000
Nostoc sp. C052	2576902	S	5	1	6	0.00000
Nostoc sp. NIES-4103	2005458	S	4	0	4	0.00000
Nostoc sp. PCC 7524	28072	S	1	0	1	0.00000
Nostoc sp. 'Peltigera membranacea cyanobiont' N6	1261031	S	1	0	1	0.00000
Nostoc sp. 'Lobaria pulmonaria (5183) cyanobiont'	1618022	S	1	0	1	0.00000
Nostoc sp. TCL26-01	2576904	S	1	0	1	0.00000
Nostoc sp. UHCC 0702	2814655	S	1	0	1	0.00000
Nostoc carneum	374162	S	7	18	25	0.00002
Nostoc sphaeroides	446679	S	2	0	2	0.00000
Nostoc linckia	92942	S	1	0	1	0.00000
Nostoc edaphicum	264686	S	1	0	1	0.00000
Anabaena sp. YBS01	2490939	S	1	12	13	0.00001
Cylindrospermum stagnale	142864	S	1	0	1	0.00000
Calothrix sp. NIES-2098	1954171	S	4	0	4	0.00000
Calothrix sp. PCC 7507	99598	S	3	0	3	0.00000
Calothrix parasitica	1973486	S	4	0	4	0.00000
Calothrix brevissima	938406	S	1	0	1	0.00000
Dolichospermum sp. UHCC 0315A	1914871	S	2	18	20	0.00002
Nodularia spumigena	70799	S	1	-1	0	0.00000
Sphaerospermopsis kisseleviana	289435	S	1	0	1	0.00000
Fischerella sp. NIES-4106	2005456	S	2	0	2	0.00000
Scytonema sp. HK-05	1137095	S	1	0	1	0.00000
Oscillatoria nigro-viridis	482564	S	26	1	27	0.00002
Moorea producens	1155739	S	3	0	3	0.00000
Planktothrix agardhii	1160	S	2	3	5	0.00000
Planktothrix rubescens	59512	S	1	0	1	0.00000
Trichodesmium erythraeum	1206	S	1	0	1	0.00000
Cyanobacterium aponinum	379064	S	2	0	2	0.00000
Halothece sp. PCC 7418	65093	S	1	0	1	0.00000
Chondrocystis sp. NIES-4102	2005460	S	1	0	1	0.00000
Synechococcus sp. RS9909	221352	S	1	0	1	0.00000
Synechococcus sp. JA-2-3B'a(2-13)	321332	S	1	0	1	0.00000
Dactylococcopsis salina	292566	S	1	0	1	0.00000
Cyanobium sp. NIES-981	1851505	S	1	0	1	0.00000
Acaryochloris marina	155978	S	4	0	4	0.00000
Synechocystis sp. PCC 6714	1147	S	1	0	1	0.00000
Pseudanabaena sp. ABRG5-3	685565	S	1	0	1	0.00000
Thermus thermophilus	274	S	2	0	2	0.00000
Thermus scotoductus	37636	S	2	0	2	0.00000
Thermus aquaticus	271	S	1	0	1	0.00000
Thermus caldilimi	2483360	S	1	0	1	0.00000
Oceanithermus profundus	187137	S	2	0	2	0.00000
Deinococcus sp. S14-83	2489213	S	1	0	1	0.00000
Deinococcus deserti	310783	S	1	0	1	0.00000
Spiroplasma gladiatoris	2143	S	1	2	3	0.00000
Spiroplasma helicoides	216938	S	1	1	2	0.00000
Mycoplasma yeatsii	51365	S	1	0	1	0.00000
Mycoplasma neurolyticum	2120	S	1	0	1	0.00000
Mycoplasma putrefaciens	2123	S	1	0	1	0.00000
Mycoplasma edwardii	53558	S	1	0	1	0.00000
Acholeplasma brassicae	61635	S	1	0	1	0.00000
Candidatus Promineofilum breve	1806508	S	2	0	2	0.00000
Pelolinea submarina	913107	S	1	0	1	0.00000
Dehalogenimonas lykanthroporepellens	552810	S	1	0	1	0.00000
Flavobacterium sp. MDT1-60	1979344	S	6	1	7	0.00001
Flavobacterium sp. P2-65	2748320	S	3	0	3	0.00000
Flavobacterium sp. CLA17	2724135	S	3	0	3	0.00000
Flavobacterium sp. M31R6	2739062	S	2	0	2	0.00000
Flavobacterium sp. HYN0086	2249356	S	2	0	2	0.00000
Flavobacterium sp. 140616W15	2478552	S	2	0	2	0.00000
Flavobacterium sp. LPB0248	2614441	S	1	0	1	0.00000
Flavobacterium sp. BB8	2816357	S	1	0	1	0.00000
Flavobacterium sp. SLB02	2665645	S	1	0	1	0.00000
Flavobacterium sp. Sr18	935222	S	1	0	1	0.00000
Flavobacterium nackdongense	2547394	S	6	0	6	0.00000
Flavobacterium faecale	1355330	S	6	0	6	0.00000
Flavobacterium psychrophilum	96345	S	5	0	5	0.00000
Flavobacterium johnsoniae	986	S	4	1	5	0.00000
Flavobacterium crocinum	2183896	S	3	0	3	0.00000
Flavobacterium haoranii	683124	S	3	0	3	0.00000
Flavobacterium columnare	996	S	2	1	3	0.00000
Flavobacterium gilvum	1492737	S	2	0	2	0.00000
Flavobacterium kingsejongi	1678728	S	2	0	2	0.00000
Flavobacterium nitrogenifigens	1617283	S	1	0	1	0.00000
Flavobacterium album	2175091	S	1	0	1	0.00000
Flavobacterium magnum	2162713	S	1	0	1	0.00000
Flavobacterium crassostreae	1763534	S	1	0	1	0.00000
Flavobacterium commune	1306519	S	1	0	1	0.00000
Flavobacterium anhuiense	459526	S	1	0	1	0.00000
Flavobacterium branchiophilum	55197	S	1	0	1	0.00000
Polaribacter sp. G4M1	2808900	S	2	2	4	0.00000
Polaribacter sp. SA4-12	1312072	S	1	1	2	0.00000
Polaribacter vadi	1774273	S	1	0	1	0.00000
Capnocytophaga sputigena	1019	S	3	0	3	0.00000
Capnocytophaga canimorsus	28188	S	2	0	2	0.00000
Capnocytophaga cynodegmi	28189	S	1	0	1	0.00000
Myroides odoratimimus	76832	S	3	5	8	0.00001
Myroides profundi	480520	S	1	0	1	0.00000
Myroides phaeus	702745	S	1	0	1	0.00000
Myroides fluvii	2572594	S	1	0	1	0.00000
Psychroflexus torquis	57029	S	2	0	2	0.00000
Psychroflexus sp. ALD_RP9	2777186	S	2	0	2	0.00000
Algibacter alginicilyticus	1736674	S	2	0	2	0.00000
Algibacter sp. L1A34	2686365	S	1	0	1	0.00000
Algibacter sp. L3A6	2686366	S	1	0	1	0.00000
Kordia sp. SMS9	2282170	S	3	0	3	0.00000
Kordia antarctica	1218801	S	1	0	1	0.00000
Winogradskyella sp. PG-2	754409	S	1	0	1	0.00000
Winogradskyella sp. PC-19	754417	S	1	0	1	0.00000
Dokdonia sp. PRO95	1239415	S	2	0	2	0.00000
Nonlabens spongiae	331648	S	1	0	1	0.00000
Nonlabens sp. Hel1_33_55	1336802	S	1	0	1	0.00000
Gramella forsetii	411153	S	1	0	1	0.00000
Gramella salexigens	1913577	S	1	0	1	0.00000
Maribacter cobaltidurans	1178778	S	1	1	2	0.00000
Maribacter sp. MJ134	2496865	S	1	0	1	0.00000
Formosa sp. Hel1_33_131	1336794	S	2	0	2	0.00000
Cellulophaga algicola	59600	S	1	0	1	0.00000
Flagellimonas maritima	1383885	S	1	0	1	0.00000
Zunongwangia profunda	398743	S	1	1	2	0.00000
Tamlana sp. s12	1630406	S	1	0	1	0.00000
Mariniflexile sp. TRM1-10	2027857	S	1	0	1	0.00000
Costertonia aggregata	343403	S	1	0	1	0.00000
Tenacibaculum dicentrarchi	669041	S	1	0	1	0.00000
Aquimarina sp. AD10	1714849	S	1	0	1	0.00000
Salegentibacter salegens	143223	S	1	0	1	0.00000
Changchengzhania lutea	2049305	S	1	0	1	0.00000
Amniculibacterium sp. G2-70	2767188	S	1	2	3	0.00000
Chryseobacterium sp. 3008163	2478663	S	2	0	2	0.00000
Chryseobacterium sp. SNU WT5	2594269	S	2	0	2	0.00000
Chryseobacterium sp. 6424	2039166	S	1	0	1	0.00000
Chryseobacterium sp. NBC 122	2547600	S	1	0	1	0.00000
Chryseobacterium sp. POL2	2713414	S	1	0	1	0.00000
Chryseobacterium indologenes	253	S	2	1	3	0.00000
Chryseobacterium joostei	112234	S	1	0	1	0.00000
Chryseobacterium aureum	2497456	S	1	0	1	0.00000
Chryseobacterium arthrosphaerae	651561	S	1	0	1	0.00000
Chryseobacterium nakagawai	1241982	S	1	2	3	0.00000
Kaistella jeonii	266749	S	5	0	5	0.00000
Kaistella flava (ex Peng et al. 2021)	2038776	S	3	0	3	0.00000
Kaistella antarctica	266748	S	1	0	1	0.00000
Chryseobacterium haifense	421525	S	1	4	5	0.00000
Kaistella carnis	1241979	S	1	0	1	0.00000
Chryseobacterium taklimakanense	536441	S	1	0	1	0.00000
Cloacibacterium normanense	237258	S	12	2	14	0.00001
Elizabethkingia sp. 2-6	2575699	S	1	5	6	0.00000
Empedobacter brevis	247	S	1	0	1	0.00000
Blattabacterium cuenoti	1653831	S	1	1	2	0.00000
Owenweeksia hongkongensis	253245	S	2	0	2	0.00000
Spirosoma sp. KUDC1026	2745947	S	17	1	18	0.00001
Spirosoma sp. KCTC 42546	2520506	S	1	0	1	0.00000
Spirosoma sp. PL0136	2710596	S	1	0	1	0.00000
Spirosoma pollinicola	2057025	S	5	0	5	0.00000
Spirosoma aerolatum	1211326	S	1	0	1	0.00000
Spirosoma endbachense	2666025	S	1	0	1	0.00000
Runella sp. HYN0085	2259595	S	2	0	2	0.00000
Runella sp. SP2	2268026	S	1	0	1	0.00000
Runella slithyformis	106	S	1	0	1	0.00000
Rhodocytophaga rosea	2704465	S	2	0	2	0.00000
Fibrella aestuarina	651143	S	2	0	2	0.00000
Aquirufa nivalisilvae	2516557	S	2	0	2	0.00000
Cytophaga hutchinsonii	985	S	1	0	1	0.00000
Arcticibacterium luteifluviistationis	1784714	S	1	0	1	0.00000
Hymenobacter sp. APR13	1356852	S	4	2	6	0.00000
Hymenobacter sp. S2-20-2	2761579	S	2	0	2	0.00000
Hymenobacter sp. PAMC 26628	1484118	S	1	0	1	0.00000
Hymenobacter sp. BRD67	2675877	S	1	0	1	0.00000
Hymenobacter sp. BRD128	2675878	S	1	0	1	0.00000
Hymenobacter baengnokdamensis	2615203	S	3	0	3	0.00000
Hymenobacter sedentarius	1411621	S	2	0	2	0.00000
Hymenobacter nivis	1850093	S	1	0	1	0.00000
Hymenobacter oligotrophus	2319843	S	1	0	1	0.00000
Hymenobacter jejuensis	2502781	S	1	0	1	0.00000
Adhaeribacter radiodurans	2745197	S	3	0	3	0.00000
Adhaeribacter swui	2086471	S	1	0	1	0.00000
Rufibacter tibetensis	512763	S	1	0	1	0.00000
Cyclobacterium marinum	104	S	1	1	2	0.00000
Cyclobacterium amurskyense	320787	S	1	1	2	0.00000
Belliella baltica	232259	S	2	0	2	0.00000
Flammeovirga pectinis	2494373	S	1	0	1	0.00000
Pedobacter sp. SW-16	2766984	S	16	2	18	0.00001
Pedobacter sp. KBS0701	2578106	S	5	1	6	0.00000
Pedobacter sp. HDW13	2714940	S	4	0	4	0.00000
Pedobacter sp. G11	2482728	S	3	0	3	0.00000
Pedobacter sp. JBR3-12	2789740	S	3	0	3	0.00000
Pedobacter sp. PACM 27299	1727164	S	1	0	1	0.00000
Pedobacter sp. CJ43	2605747	S	1	0	1	0.00000
Pedobacter suwonensis	332999	S	4	0	4	0.00000
Pedobacter roseus	336820	S	4	0	4	0.00000
Pedobacter heparinus	984	S	2	0	2	0.00000
Pedobacter cryoconitis	188932	S	2	0	2	0.00000
Mucilaginibacter xinganensis	1234841	S	2	0	2	0.00000
Mucilaginibacter ginsenosidivorans	398053	S	1	0	1	0.00000
Mucilaginibacter rubeus	2027860	S	1	1	2	0.00000
Sphingobacterium spiritivorum	258	S	1	0	1	0.00000
Sphingobacterium multivorum	28454	S	1	0	1	0.00000
Sphingobacterium daejeonense	371142	S	1	0	1	0.00000
Sphingobacterium hotanense	649196	S	1	0	1	0.00000
Solitalea canadensis	995	S	2	0	2	0.00000
Olivibacter sp. SDN3	2764720	S	1	0	1	0.00000
Phocaeicola vulgatus	821	S	4	1	5	0.00000
Phocaeicola dorei	357276	S	1	0	1	0.00000
Alistipes sp. dk3624	2662363	S	2	0	2	0.00000
Alistipes finegoldii	214856	S	1	0	1	0.00000
Alistipes megaguti	2364787	S	1	0	1	0.00000
Alistipes communis	2585118	S	1	0	1	0.00000
Prevotella intermedia	28131	S	4	0	4	0.00000
Paraprevotella xylaniphila	454155	S	1	0	1	0.00000
Bacteroides thetaiotaomicron	818	S	1	0	1	0.00000
Bacteroides ovatus	28116	S	1	0	1	0.00000
Bacteroides coprosuis	151276	S	1	0	1	0.00000
Bacteroides caecimuris	1796613	S	1	0	1	0.00000
Paludibacter propionicigenes	185300	S	4	0	4	0.00000
Coprobacter sp. 2CBH44	2751153	S	2	0	2	0.00000
Tannerella forsythia	28112	S	1	-1	0	0.00000
Salinivirga cyanobacteriivorans	1307839	S	1	0	1	0.00000
Dysgonomonas sp. HDW5B	2714927	S	1	0	1	0.00000
Tenuifilum thalassicum	2590900	S	1	0	1	0.00000
Labilibaculum antarcticum	1717717	S	2	1	3	0.00000
Paraflavitalea soli	2315862	S	4	1	5	0.00000
Pseudobacter ginsenosidimutans	661488	S	3	1	4	0.00000
Chitinophaga pinensis	79329	S	1	0	1	0.00000
Chitinophaga sp. XS-30	2604421	S	1	0	1	0.00000
Flavihumibacter sp. SB-02	2676868	S	2	0	2	0.00000
Arachidicoccus sp. B3-10	2545455	S	2	0	2	0.00000
Niastella koreensis	354356	S	1	0	1	0.00000
Lacibacter sp. S13-6-6	2760713	S	1	0	1	0.00000
Panacibacter ginsenosidivorans	1813871	S	1	0	1	0.00000
Pseudocnuella soli	2502779	S	1	0	1	0.00000
Chlorobaculum limnaeum	274537	S	1	0	1	0.00000
Urbifossiella limnaea	2528023	S	14	0	14	0.00001
Gemmata obscuriglobus	114	S	3	0	3	0.00000
Gemmata massiliana	1210884	S	3	0	3	0.00000
Frigoriglobus tundricola	2774151	S	3	0	3	0.00000
Limnoglobus roseus	2598579	S	2	0	2	0.00000
Tuwongella immobilis	692036	S	1	0	1	0.00000
Botrimarina mediterranea	2528022	S	3	2	5	0.00000
Lacipirellula limnantheis	2528024	S	1	0	1	0.00000
Aeoliella mucimassa	2527972	S	1	0	1	0.00000
Pirellulimonas nuda	2528009	S	1	0	1	0.00000
Pirellula sp. SH-Sr6A	1632865	S	2	0	2	0.00000
Bremerella volcania	2527984	S	1	0	1	0.00000
Lignipirellula cremea	2528010	S	1	0	1	0.00000
Stieleria maiorica	2795974	S	1	0	1	0.00000
Anatilimnocola aggregata	2528021	S	1	0	1	0.00000
Planctomyces sp. SH-PL14	1632864	S	4	0	4	0.00000
Planctomyces sp. SH-PL62	1636152	S	1	0	1	0.00000
Symmachiella dynata	2527995	S	1	0	1	0.00000
Paludisphaera borealis	1387353	S	1	0	1	0.00000
Humisphaera borealis	2807512	S	4	0	4	0.00000
Verrucomicrobium spinosum	2736	S	2	0	2	0.00000
Verrucomicrobium sp. GAS474	1882831	S	1	0	1	0.00000
Luteolibacter luteus	2728835	S	2	0	2	0.00000
Opitutus sp. GAS368	1882749	S	3	0	3	0.00000
Lacunisphaera limnophila	1838286	S	1	0	1	0.00000
Ereboglobus luteus	1796921	S	1	0	1	0.00000
Candidatus Protochlamydia amoebophila	362787	S	1	2	3	0.00000
Waddlia chondrophila	71667	S	1	0	1	0.00000
Chlamydia felis	83556	S	1	0	1	0.00000
Fusobacterium sp. oral taxon 203	671211	S	1	0	1	0.00000
Fusobacterium pseudoperiodonticum	2663009	S	1	0	1	0.00000
Leptotrichia sp. oral taxon 212	712357	S	1	0	1	0.00000
Sebaldella termitidis	826	S	1	0	1	0.00000
Candidatus Solibacter usitatus	332163	S	1	0	1	0.00000
Paludibaculum fermentans	1473598	S	1	0	1	0.00000
Chloracidobacterium thermophilum	458033	S	1	0	1	0.00000
Luteitalea pratensis	1855912	S	1	0	1	0.00000
Sediminispirochaeta smaragdinae	55206	S	1	0	1	0.00000
Borreliella burgdorferi	139	S	1	0	1	0.00000
Brachyspira hyodysenteriae	159	S	1	0	1	0.00000
Candidatus Nanosynbacter lyticus	2093824	S	1	2	3	0.00000
Defluviitoga tunisiensis	1006576	S	1	0	1	0.00000
Denitrovibrio acetiphilus	118000	S	1	0	1	0.00000
Natrialba magadii	13769	S	2	0	2	0.00000
Halovivax sp. KZCA124	2817025	S	2	0	2	0.00000
Haloterrigena daqingensis	588898	S	1	0	1	0.00000
Natronorubrum aibiense	348826	S	1	0	1	0.00000
Halogeometricum borinquense	60847	S	1	0	1	0.00000
Haloplanus rallus	1816183	S	1	0	1	0.00000
Halorubrum sp. BOL3-1	2497325	S	1	0	1	0.00000
Salinigranum rubrum	755307	S	1	0	1	0.00000
Halorussus sp. ZS-3	2650975	S	1	0	1	0.00000
Methanohalobium evestigatum	2322	S	1	0	1	0.00000
Methanococcus vannielii	2187	S	1	0	1	0.00000
Methanococcus maripaludis	39152	S	1	0	1	0.00000
Methanococcus aeolicus	42879	S	1	0	1	0.00000
Thermococcus guaymasensis	110164	S	1	0	1	0.00000
Thermococcus sibiricus	172049	S	1	0	1	0.00000
Archaeoglobus profundus	84156	S	1	0	1	0.00000
Sulfolobus islandicus	43080	S	1	0	1	0.00000
Candidatus Methanomassiliicoccus intestinalis	1406512	S	1	0	1	0.00000
Flavobacterium phage vB_FspS_filifjonk9-1	2686245	S	11	16	27	0.00002
Flavobacterium phage vB_FspS_mymlan6-1	2686266	S	2	5	7	0.00001
Streptococcus phage SpSL1	1566990	S	2	0	2	0.00000
Flavobacterium phage vB_FspS_snusmum6-1	2686273	S	2	1	3	0.00000
Flavobacterium phage vB_FspS_hattifnatt9-1	2686246	S	1	0	1	0.00000
Staphylococcus phage phiRS7	1403390	S	1	0	1	0.00000
Mycobacterium phage BirdsNest	2686231	S	1	0	1	0.00000
Alphaproteobacteria virus phiJl001	279383	S	1	0	1	0.00000
uncultured crAssphage	1211417	S	2	0	2	0.00000
Cellulophaga phage phi14:2	1327990	S	1	0	1	0.00000
Xanthomonas citri phage CP2	1188795	S	1	0	1	0.00000
Rhodoferax phage P26218	1636270	S	1	0	1	0.00000
Curvibacter virus P26059B	2733926	S	2	0	2	0.00000
Sphingomonas virus Scott	2733954	S	1	0	1	0.00000
Ralstonia virus RSJ5	2733595	S	1	0	1	0.00000
Pseudomonas virus PMW	2560676	S	1	0	1	0.00000
Aeromonas virus 65	260149	S	1	0	1	0.00000
Human betaherpesvirus 7	10372	S	2	0	2	0.00000
Paramecium bursaria Chlorella virus A1	381899	S	6	0	6	0.00000
Acanthocystis turfacea chlorella virus 1	322019	S	1	0	1	0.00000
Yellowstone lake phycodnavirus 2	1586714	S	2	0	2	0.00000
Yellowstone lake phycodnavirus 3	1586715	S	2	0	2	0.00000
Lymantria dispar multiple nucleopolyhedrovirus	10449	S	1	0	1	0.00000
Lambdina fiscellaria nucleopolyhedrovirus	1642929	S	1	0	1	0.00000
