name	taxonomy_id	taxonomy_lvl	kraken_assigned_reads	added_reads	new_est_reads	fraction_total_reads
Klebsiella pneumoniae	573	S	112	168	280	0.0687285223
Cutibacterium acnes	1747	S	228	6	234	0.0574374080
Acinetobacter junii	40215	S	145	19	164	0.0402552774
Xanthomonas euvesicatoria	456327	S	10	151	161	0.0395189003
Micrococcus luteus	1270	S	55	46	101	0.0247913598
Rhodococcus qingshengii	334542	S	15	70	85	0.0208640157
Acidovorax sp. KKS102	358220	S	58	15	73	0.0179185076
Janthinobacterium sp. HH102	1537274	S	28	42	70	0.0171821306
Diaphorobacter sp. HDW4A	2714924	S	51	14	65	0.0159548355
Variovorax boronicumulans	436515	S	35	22	57	0.0139911635
Paenarthrobacter sp. YJN-D	2735317	S	44	4	48	0.0117820324
Acidovorax sp. JMULE5	2518343	S	38	5	43	0.0105547374
Micrococcus sp. KBS0714	1179670	S	5	38	43	0.0105547374
Pedobacter sp. SW-16	2766984	S	30	13	43	0.0105547374
Variovorax paradoxus	34073	S	32	8	40	0.0098183603
Janthinobacterium sp. LM6	1938606	S	28	9	37	0.0090819833
Janthinobacterium agaricidamnosum	55508	S	17	18	35	0.0085910653
Variovorax sp. 38R	2774875	S	16	14	30	0.0073637703
Delftia lacustris	558537	S	7	23	30	0.0073637703
Rhodococcus erythropolis	1833	S	7	20	27	0.0066273932
Janthinobacterium tructae	2590869	S	20	6	26	0.0063819342
Alicycliphilus denitrificans	179636	S	12	12	24	0.0058910162
Acinetobacter baumannii	470	S	6	18	24	0.0058910162
Pseudomonas fluorescens	294	S	20	3	23	0.0056455572
Propionibacterium sp. oral taxon 193	671223	S	22	1	23	0.0056455572
Diaphorobacter sp. JS3051	2792224	S	2	20	22	0.0054000982
Cloacibacterium normanense	237258	S	19	2	21	0.0051546392
Janthinobacterium lividum	29581	S	9	9	18	0.0044182622
Staphylococcus aureus	1280	S	6	12	18	0.0044182622
Janthinobacterium sp. 1_2014MBL_MicDiv	1644131	S	15	2	17	0.0041728031
Lysobacter enzymogenes	69	S	17	0	17	0.0041728031
Spirosoma sp. KUDC1026	2745947	S	17	0	17	0.0041728031
Variovorax sp. SRS16	282217	S	3	13	16	0.0039273441
Acidovorax sp. RAC01	1842533	S	13	3	16	0.0039273441
Acidovorax sp. T1	1858609	S	7	9	16	0.0039273441
Acidovorax carolinensis	553814	S	11	5	16	0.0039273441
Aminobacter sp. MDW-2	2666139	S	5	11	16	0.0039273441
Sphingomonas koreensis	93064	S	7	7	14	0.0034364261
Myroides odoratimimus	76832	S	6	8	14	0.0034364261
Flavobacterium phage vB_FspS_filifjonk9-1	2686245	S	7	7	14	0.0034364261
Variovorax sp. PBL-H6	434009	S	4	9	13	0.0031909671
Variovorax sp. PAMC26660	2762322	S	11	1	12	0.0029455081
Acidovorax sp. 1608163	2478662	S	11	1	12	0.0029455081
Acidovorax sp. JS42	232721	S	1	11	12	0.0029455081
Diaphorobacter aerolatus	1288495	S	9	3	12	0.0029455081
Achromobacter xylosoxidans	85698	S	4	8	12	0.0029455081
Microbacterium sp. PM5	2014534	S	10	2	12	0.0029455081
Staphylococcus cohnii	29382	S	9	3	12	0.0029455081
Ottowia oryzae	2109914	S	11	0	11	0.0027000491
Roseateles depolymerans	76731	S	10	1	11	0.0027000491
Rhodococcus sp. BH4	1807790	S	2	9	11	0.0027000491
Delftia acidovorans	80866	S	5	5	10	0.0024545901
Janthinobacterium sp. PLB02	2808899	S	4	6	10	0.0024545901
Janthinobacterium svalbardensis	368607	S	8	2	10	0.0024545901
Burkholderia pseudomallei	28450	S	3	7	10	0.0024545901
Polynucleobacter difficilis	556054	S	10	0	10	0.0024545901
Paucibacter sp. KCTC 42545	1768242	S	9	1	10	0.0024545901
Sphingomonas melonis	152682	S	2	8	10	0.0024545901
Priestia megaterium	1404	S	8	2	10	0.0024545901
Anabaena sp. WA102	1647413	S	6	4	10	0.0024545901
Variovorax sp. WDL1	207745	S	4	5	9	0.0022091311
Halomonas sp. JS92-SW72	2306583	S	8	1	9	0.0022091311
Methylorubrum populi	223967	S	6	3	9	0.0022091311
Dermacoccus nishinomiyaensis	1274	S	9	0	9	0.0022091311
Staphylococcus epidermidis	1282	S	8	1	9	0.0022091311
Bacillus cereus	1396	S	5	4	9	0.0022091311
Anabaena sp. 90	46234	S	2	7	9	0.0022091311
Burkholderia sp. IDO3	1705310	S	2	6	8	0.0019636721
Mitsuaria sp. 7	1658665	S	7	1	8	0.0019636721
Pseudomonas veronii	76761	S	5	3	8	0.0019636721
Escherichia coli	562	S	3	5	8	0.0019636721
Methylorubrum extorquens	408	S	4	4	8	0.0019636721
Sphingobium yanoikuyae	13690	S	4	4	8	0.0019636721
Microbacterium hominis	162426	S	5	3	8	0.0019636721
Streptomyces lividans	1916	S	1	7	8	0.0019636721
Lactococcus lactis	1358	S	6	2	8	0.0019636721
Variovorax sp. PAMC 28711	1795631	S	7	0	7	0.0017182131
Variovorax sp. RKNM96	2681552	S	6	1	7	0.0017182131
Hydrogenophaga sp. PBC	795665	S	6	1	7	0.0017182131
Comamonas testosteroni	285	S	5	2	7	0.0017182131
Limnohabitans sp. 63ED37-2	1678128	S	7	0	7	0.0017182131
Kinneretia sp. DAIF2	2714952	S	7	0	7	0.0017182131
Curvibacter sp. AEP1-3	1844971	S	7	0	7	0.0017182131
Rubrivivax gelatinosus	28068	S	6	1	7	0.0017182131
Moraxella osloensis	34062	S	7	0	7	0.0017182131
Pseudomonas tolaasii	29442	S	7	0	7	0.0017182131
Haemophilus parainfluenzae	729	S	7	0	7	0.0017182131
Bradyrhizobium sp. CCBAU 51765	1325102	S	5	2	7	0.0017182131
Methylobacterium sp. WL1	2603276	S	6	1	7	0.0017182131
Carnobacterium maltaromaticum	2751	S	7	0	7	0.0017182131
Flavobacterium psychrophilum	96345	S	7	0	7	0.0017182131
Urbifossiella limnaea	2528023	S	7	0	7	0.0017182131
Variovorax sp. HW608	1034889	S	6	0	6	0.0014727541
Variovorax sp. PBL-E5	434014	S	1	5	6	0.0014727541
Acidovorax avenae	80867	S	4	2	6	0.0014727541
Hydrogenophaga sp. PBL-H3	434010	S	4	2	6	0.0014727541
Polaromonas sp. JS666	296591	S	5	1	6	0.0014727541
Ramlibacter tataouinensis	94132	S	6	0	6	0.0014727541
Verminephrobacter eiseniae	364317	S	6	0	6	0.0014727541
Collimonas fungivorans	158899	S	6	0	6	0.0014727541
Pseudomonas aeruginosa	287	S	3	3	6	0.0014727541
Pseudomonas stutzeri	316	S	6	0	6	0.0014727541
Xanthomonas campestris	339	S	6	0	6	0.0014727541
Bradyrhizobium lablabi	722472	S	3	3	6	0.0014727541
Bosea sp. ANAM02	2020412	S	5	1	6	0.0014727541
Methylobacterium aquaticum	270351	S	3	3	6	0.0014727541
Mesorhizobium sp. Pch-S	2082387	S	6	0	6	0.0014727541
Sphingomonas sp. PAMC26645	2565555	S	5	1	6	0.0014727541
Sphingomonas panacisoli	1813879	S	6	0	6	0.0014727541
Sphingobium sp. YG1	2082188	S	4	2	6	0.0014727541
Actinomyces oris	544580	S	4	2	6	0.0014727541
Bacillus velezensis	492670	S	2	4	6	0.0014727541
Cohnella sp. LGH	1619153	S	6	0	6	0.0014727541
Gemmata massiliana	1210884	S	4	2	6	0.0014727541
Flavobacterium phage vB_FspS_tooticki6-1	2686279	S	2	4	6	0.0014727541
Diaphorobacter polyhydroxybutyrativorans	1546149	S	1	4	5	0.0012272950
Hydrogenophaga sp. RAC07	1842537	S	4	1	5	0.0012272950
Hydrogenophaga sp. BPS33	2651974	S	4	1	5	0.0012272950
Hydrogenophaga sp. YM1	2806262	S	4	1	5	0.0012272950
Rhodoferax koreense	1842727	S	4	1	5	0.0012272950
Rhizobacter sp. AJA081-3	2753607	S	5	0	5	0.0012272950
Inhella inkyongensis	392593	S	5	0	5	0.0012272950
Pseudomonas fulva	47880	S	2	3	5	0.0012272950
Pseudoxanthomonas mexicana	128785	S	5	0	5	0.0012272950
Francisella halioticida	549298	S	3	2	5	0.0012272950
Bradyrhizobium betae	244734	S	4	1	5	0.0012272950
Rhizorhabdus dicambivorans	1850238	S	2	3	5	0.0012272950
Roseovarius indicus	540747	S	3	2	5	0.0012272950
Corallococcus coralloides	184914	S	3	2	5	0.0012272950
Rhodococcus sp. NJ-530	2490853	S	1	4	5	0.0012272950
Rhodococcus sp. 008	1723645	S	1	4	5	0.0012272950
Parachlamydia acanthamoebae	83552	S	1	4	5	0.0012272950
Borrelia crocidurae	29520	S	4	1	5	0.0012272950
Acidovorax sp. HDW3	2714923	S	4	0	4	0.0009818360
Acidovorax antarcticus	2743470	S	4	0	4	0.0009818360
Hydrogenophaga pseudoflava	47421	S	4	0	4	0.0009818360
Comamonas kerstersii	225992	S	4	0	4	0.0009818360
Rhodoferax sp. BAB1	2741720	S	4	0	4	0.0009818360
Rhodoferax sediminis	2509614	S	4	0	4	0.0009818360
Polaromonas naphthalenivorans	216465	S	4	0	4	0.0009818360
Schlegelella thermodepolymerans	215580	S	4	0	4	0.0009818360
Burkholderia thailandensis	57975	S	3	1	4	0.0009818360
Burkholderia lata	482957	S	2	2	4	0.0009818360
Cupriavidus metallidurans	119219	S	3	1	4	0.0009818360
Cupriavidus taiwanensis	164546	S	3	1	4	0.0009818360
Aquabacterium olei	1296669	S	4	0	4	0.0009818360
Sulfuritalea hydrogenivorans	748811	S	4	0	4	0.0009818360
Citrobacter freundii	546	S	1	3	4	0.0009818360
Enterobacter cloacae	550	S	1	3	4	0.0009818360
Photorhabdus thracensis	230089	S	4	0	4	0.0009818360
Stenotrophomonas maltophilia	40324	S	3	1	4	0.0009818360
Aggregatibacter sp. 2125159857	2820817	S	4	0	4	0.0009818360
Methylomonas sp. LL1	2785785	S	4	0	4	0.0009818360
Methylobacterium sp. DM1	2067957	S	1	3	4	0.0009818360
Sphingomonas sp. NIC1	1961362	S	2	2	4	0.0009818360
Sphingopyxis sp. PAMC25046	2565556	S	2	2	4	0.0009818360
Blastomonas fulva	1550728	S	3	1	4	0.0009818360
Tabrizicola piscis	2494374	S	4	0	4	0.0009818360
Sorangium cellulosum	56	S	3	1	4	0.0009818360
Hydrogenophilus thermoluteolus	297	S	4	0	4	0.0009818360
Microbacterium sp. 4R-513	2567934	S	4	0	4	0.0009818360
Rhodococcus sp. YL-1	1045808	S	1	3	4	0.0009818360
Corynebacterium tuberculostearicum	38304	S	4	0	4	0.0009818360
Candidatus Planktophila sulfonica	1884904	S	4	0	4	0.0009818360
Synechococcus sp. JA-2-3B'a(2-13)	321332	S	4	0	4	0.0009818360
Oscillatoria nigro-viridis	482564	S	4	0	4	0.0009818360
Thermus scotoductus	37636	S	4	0	4	0.0009818360
Kaistella jeonii	266749	S	4	0	4	0.0009818360
Kaistella flava (ex Peng et al. 2021)	2038776	S	4	0	4	0.0009818360
Pedobacter sp. JBR3-12	2789740	S	4	0	4	0.0009818360
Bacteroides uniformis	820	S	4	0	4	0.0009818360
Frigoriglobus tundricola	2774151	S	3	1	4	0.0009818360
Spirochaeta africana	46355	S	4	0	4	0.0009818360
Variovorax sp. RA8	662548	S	2	1	3	0.0007363770
Acidovorax monticola	1926868	S	3	0	3	0.0007363770
Delftia tsuruhatensis	180282	S	1	2	3	0.0007363770
Comamonas aquatica	225991	S	3	0	3	0.0007363770
Comamonas piscis	1562974	S	3	0	3	0.0007363770
Comamonas sp. NLF-7-7	2597701	S	3	0	3	0.0007363770
Comamonas thiooxydans	363952	S	2	1	3	0.0007363770
Rhodoferax sp. AJA081-3	2752316	S	3	0	3	0.0007363770
Rhodoferax sp. PAMC29310	2822760	S	3	0	3	0.0007363770
Paraburkholderia caribensis	75105	S	2	1	3	0.0007363770
Paraburkholderia phytofirmans	261302	S	2	1	3	0.0007363770
Rhizobacter gummiphilus	946333	S	3	0	3	0.0007363770
Leptothrix cholodnii	34029	S	3	0	3	0.0007363770
Thiomonas intermedia	926	S	3	0	3	0.0007363770
Sphaerotilus natans	34103	S	3	0	3	0.0007363770
Candidatus Accumulibacter phosphatis	327160	S	3	0	3	0.0007363770
Acinetobacter haemolyticus	29430	S	3	0	3	0.0007363770
Pseudomonas synxantha	47883	S	3	0	3	0.0007363770
Pseudomonas sp. OST1909	2777367	S	2	1	3	0.0007363770
Pseudomonas sp. CMR12a	658629	S	2	1	3	0.0007363770
Pseudomonas citronellolis	53408	S	3	0	3	0.0007363770
Salmonella enterica	28901	S	1	2	3	0.0007363770
Serratia marcescens	615	S	3	0	3	0.0007363770
Buchnera aphidicola	9	S	3	0	3	0.0007363770
Spartinivicinus ruber	2683272	S	3	0	3	0.0007363770
Vibrio harveyi	669	S	3	0	3	0.0007363770
Shewanella algae	38313	S	1	2	3	0.0007363770
Halioglobus maricola	2601894	S	3	0	3	0.0007363770
Bradyrhizobium sp. BTAi1	288000	S	3	0	3	0.0007363770
Bradyrhizobium sp. SK17	2057741	S	2	1	3	0.0007363770
Bosea sp. F3-2	2599640	S	3	0	3	0.0007363770
Afipia sp. GAS231	1882747	S	2	1	3	0.0007363770
Methylobacterium brachiatum	269660	S	2	1	3	0.0007363770
Aminobacter sp. MSH1	374606	S	3	0	3	0.0007363770
Rhizobium leguminosarum	384	S	2	1	3	0.0007363770
Rhizobium sp. 007	2785056	S	1	2	3	0.0007363770
Agrobacterium tumefaciens	358	S	2	1	3	0.0007363770
Aquabacter sp. L1I39	2820278	S	3	0	3	0.0007363770
Sphingomonas sp. FARSPH	2219696	S	2	1	3	0.0007363770
Sphingomonas sp. MM-1	745310	S	1	2	3	0.0007363770
Sphingobium sp. TKS	1315974	S	1	2	3	0.0007363770
Sphingobium amiense	135719	S	1	2	3	0.0007363770
Sphingopyxis macrogoltabida	33050	S	2	1	3	0.0007363770
Sphingopyxis fribergensis	1515612	S	2	1	3	0.0007363770
Novosphingobium pentaromativorans	205844	S	2	1	3	0.0007363770
Sphingorhabdus lacus	392610	S	3	0	3	0.0007363770
Caulobacter henricii	69395	S	3	0	3	0.0007363770
Caulobacter vibrioides	155892	S	3	0	3	0.0007363770
Roseomonas sp. 546	2768162	S	1	2	3	0.0007363770
Cutibacterium avidum	33010	S	3	0	3	0.0007363770
Gordonia sp. JH63	2698900	S	2	1	3	0.0007363770
Tsukamurella paurometabola	2061	S	3	0	3	0.0007363770
Tsukamurella tyrosinosolvens	57704	S	3	0	3	0.0007363770
Streptomyces sp. CMB-StM0423	2059884	S	1	2	3	0.0007363770
Staphylococcus hominis	1290	S	3	0	3	0.0007363770
Staphylococcus capitis	29388	S	3	0	3	0.0007363770
Bacillus sp. M4U3P1	2592382	S	3	0	3	0.0007363770
Streptococcus suis	1307	S	2	1	3	0.0007363770
Weissella sp. HDW19	2714949	S	3	0	3	0.0007363770
Clostridium botulinum	1491	S	3	0	3	0.0007363770
Clostridium perfringens	1502	S	3	0	3	0.0007363770
Keratinibaculum paraultunense	1278232	S	3	0	3	0.0007363770
Bulleidia sp. zg-1006	2806552	S	2	1	3	0.0007363770
Nostoc sp. CENA543	1869241	S	3	0	3	0.0007363770
Dolichospermum compactum	136073	S	2	1	3	0.0007363770
Acaryochloris marina	155978	S	3	0	3	0.0007363770
Thermus thermophilus	274	S	3	0	3	0.0007363770
Flavobacterium sp. SLB02	2665645	S	3	0	3	0.0007363770
Flavobacterium nackdongense	2547394	S	3	0	3	0.0007363770
Flavobacterium indicum	312277	S	3	0	3	0.0007363770
Flavobacterium anhuiense	459526	S	2	1	3	0.0007363770
Elizabethkingia anophelis	1117645	S	2	1	3	0.0007363770
Echinicola vietnamensis	390884	S	2	1	3	0.0007363770
Lacibacter sp. S13-6-6	2760713	S	3	0	3	0.0007363770
Verrucomicrobium spinosum	2736	S	3	0	3	0.0007363770
Verrucomicrobium sp. GAS474	1882831	S	3	0	3	0.0007363770
Luteitalea pratensis	1855912	S	3	0	3	0.0007363770
Candidatus Nitrosotenuis cloacae	1603555	S	3	0	3	0.0007363770
Variovorax sp. PBS-H4	434008	S	2	0	2	0.0004909180
Rhodoferax antarcticus	81479	S	2	0	2	0.0004909180
Ottowia sp. 27C	2816950	S	2	0	2	0.0004909180
Serpentinomonas mccroryi	1458426	S	2	0	2	0.0004909180
Melaminivora sp. SC2-9	2109913	S	2	0	2	0.0004909180
Undibacterium sp. KW1	2058624	S	2	0	2	0.0004909180
Undibacterium sp. YM2	2058625	S	2	0	2	0.0004909180
Herbaspirillum seropedicae	964	S	1	1	2	0.0004909180
Polynucleobacter acidiphobus	556053	S	2	0	2	0.0004909180
Ralstonia insidiosa	190721	S	1	1	2	0.0004909180
Bordetella petrii	94624	S	2	0	2	0.0004909180
Bordetella genomosp. 13	463040	S	2	0	2	0.0004909180
Bordetella genomosp. 6	463024	S	1	1	2	0.0004909180
Alcaligenes faecalis	511	S	2	0	2	0.0004909180
Gallionella capsiferriformans	370405	S	2	0	2	0.0004909180
Usitatibacter rugosus	2732067	S	2	0	2	0.0004909180
Nitrosomonas sp. Is79A3	261292	S	2	0	2	0.0004909180
Sulfurimicrobium lacus	2715678	S	2	0	2	0.0004909180
Azospira oryzae	146939	S	2	0	2	0.0004909180
Azospira sp. I09	1765049	S	2	0	2	0.0004909180
Azoarcus sp. M9-3-2	2016596	S	2	0	2	0.0004909180
Laribacter hongkongensis	168471	S	2	0	2	0.0004909180
Acinetobacter guillouiae	106649	S	2	0	2	0.0004909180
Acinetobacter towneri	202956	S	1	1	2	0.0004909180
Pseudomonas multiresinivorans	95301	S	2	0	2	0.0004909180
Pseudomonas putida	303	S	2	0	2	0.0004909180
Pseudomonas kribbensis	1628086	S	2	0	2	0.0004909180
Pseudomonas lurida	244566	S	2	0	2	0.0004909180
Pseudescherichia vulneris	566	S	2	0	2	0.0004909180
Serratia liquefaciens	614	S	2	0	2	0.0004909180
Serratia fonticola	47917	S	2	0	2	0.0004909180
Yersinia sp. KBS0713	1179669	S	1	1	2	0.0004909180
Pantoea sp. PSNIH1	1484158	S	2	0	2	0.0004909180
Lysobacter soli	453783	S	2	0	2	0.0004909180
Lysobacter lycopersici	1324796	S	2	0	2	0.0004909180
Lysobacter maris	1605891	S	2	0	2	0.0004909180
Stenotrophomonas rhizophila	216778	S	2	0	2	0.0004909180
Pseudoxanthomonas spadix	415229	S	2	0	2	0.0004909180
Arenimonas daejeonensis	370777	S	2	0	2	0.0004909180
Dokdonella koreensis	323415	S	2	0	2	0.0004909180
Bacterioplanes sanyensis	1249553	S	2	0	2	0.0004909180
Vibrio anguillarum	55601	S	2	0	2	0.0004909180
Marinobacter sp. JH2	2547598	S	1	1	2	0.0004909180
Methylomicrobium album	39775	S	2	0	2	0.0004909180
Woeseia oceani	1548547	S	2	0	2	0.0004909180
Legionella sp. MW5194	2662448	S	2	0	2	0.0004909180
Legionella sp. TUM19329	2708020	S	2	0	2	0.0004909180
Aeromonas sp. CU5	2033033	S	2	0	2	0.0004909180
Solimonas sp. K1W22B-7	2303331	S	2	0	2	0.0004909180
Bradyrhizobium sp. ORS 285	115808	S	2	0	2	0.0004909180
Bradyrhizobium sp. CCBAU 051011	858422	S	2	0	2	0.0004909180
Bradyrhizobium paxllaeri	190148	S	2	0	2	0.0004909180
Bosea vaviloviae	1526658	S	2	0	2	0.0004909180
Rhodopseudomonas palustris	1076	S	2	0	2	0.0004909180
Variibacter gotjawalensis	1333996	S	2	0	2	0.0004909180
Methylobacterium sp. 17Sr1-43	2202828	S	2	0	2	0.0004909180
Methylobacterium sp. 17Sr1-1	2202826	S	1	1	2	0.0004909180
Mesorhizobium sp. M1B.F.Ca.ET.045.04.1.1	2493673	S	2	0	2	0.0004909180
Mesorhizobium sp. 113-3-9	2744517	S	1	1	2	0.0004909180
Agrobacterium sp. T29	2580515	S	2	0	2	0.0004909180
Sinorhizobium meliloti	382	S	1	1	2	0.0004909180
Sinorhizobium sp. CCBAU 05631	794846	S	1	1	2	0.0004909180
Ensifer adhaerens	106592	S	2	0	2	0.0004909180
Devosia sp. A16	1736675	S	2	0	2	0.0004909180
Labrenzia sp. THAF35	2587854	S	1	1	2	0.0004909180
Chelatococcus sp. CO-6	1702325	S	2	0	2	0.0004909180
Sphingomonas sp. DH-S5	2759526	S	2	0	2	0.0004909180
Sphingomonas sp. Cra20	1327635	S	2	0	2	0.0004909180
Sphingomonas sp. HMP6	1517551	S	2	0	2	0.0004909180
Sphingomonas sp. AAP5	1523415	S	2	0	2	0.0004909180
Sphingomonas alpina	653931	S	2	0	2	0.0004909180
Sphingobium sp. SCG-1	2072936	S	2	0	2	0.0004909180
Sphingobium hydrophobicum	1673076	S	1	1	2	0.0004909180
Sphingopyxis terrae	33052	S	1	1	2	0.0004909180
Novosphingobium sp. Gsoil 351	2675225	S	2	0	2	0.0004909180
Novosphingobium ginsenosidimutans	1176536	S	2	0	2	0.0004909180
Porphyrobacter sp. LM 6	1896196	S	2	0	2	0.0004909180
Porphyrobacter sp. CACIAM 03H1	2003315	S	2	0	2	0.0004909180
Croceicoccus naphthovorans	1348774	S	1	1	2	0.0004909180
Cereibacter sphaeroides	1063	S	2	0	2	0.0004909180
Gemmobacter sp. HYN0069	2169400	S	2	0	2	0.0004909180
Brevundimonas sp. M20	2591463	S	2	0	2	0.0004909180
Brevundimonas sp. LVF1	2774189	S	2	0	2	0.0004909180
Brevundimonas sp. CS1	2813778	S	2	0	2	0.0004909180
Brevundimonas diminuta	293	S	2	0	2	0.0004909180
Brevundimonas naejangsanensis	588932	S	2	0	2	0.0004909180
Caulobacter sp. FWC26	69665	S	2	0	2	0.0004909180
Asticcacaulis excentricus	78587	S	2	0	2	0.0004909180
Magnetospirillum sp. ME-1	1639348	S	1	1	2	0.0004909180
Ehrlichia canis	944	S	2	0	2	0.0004909180
Hyphomonas sp. CACIAM 19H1	1873716	S	2	0	2	0.0004909180
Minicystis rosea	888845	S	2	0	2	0.0004909180
Geobacter bremensis	60035	S	2	0	2	0.0004909180
Desulfonema magnum	45655	S	2	0	2	0.0004909180
Helicobacter pylori	210	S	2	0	2	0.0004909180
Nautilia sp. PV-1	2579250	S	1	1	2	0.0004909180
Rothia mucilaginosa	43675	S	2	0	2	0.0004909180
Glutamicibacter arilaitensis	256701	S	2	0	2	0.0004909180
Glutamicibacter sp. ZJUTW	1155384	S	2	0	2	0.0004909180
Microbacterium sp. 10M-3C3	2483401	S	2	0	2	0.0004909180
Microbacterium sp. No. 7	1714373	S	2	0	2	0.0004909180
Microbacterium sp. JZ31	1906274	S	2	0	2	0.0004909180
Curtobacterium flaccumfaciens	2035	S	2	0	2	0.0004909180
Leifsonia sp. 21MFCrub1.1	1798223	S	1	1	2	0.0004909180
Frigoribacterium sp. NBH87	2596916	S	2	0	2	0.0004909180
Dermacoccus sp. PAMC28757	2762331	S	2	0	2	0.0004909180
Brevibacterium sp. CS2	2575923	S	2	0	2	0.0004909180
Xylanimonas cellulosilytica	186189	S	2	0	2	0.0004909180
Microlunatus sp. Gsoil 973	2672569	S	2	0	2	0.0004909180
Acidipropionibacterium acidipropionici	1748	S	2	0	2	0.0004909180
Rhodococcus ruber	1830	S	2	0	2	0.0004909180
Rhodococcus hoagii	43767	S	2	0	2	0.0004909180
Mycobacterium sp. YC-RL4	1682113	S	1	1	2	0.0004909180
Mycobacterium gallinarum	39689	S	2	0	2	0.0004909180
Mycolicibacterium mucogenicum	56689	S	2	0	2	0.0004909180
Corynebacterium stationis	1705	S	2	0	2	0.0004909180
Corynebacterium lactis	1231000	S	2	0	2	0.0004909180
Corynebacterium kefirresidentii	1979527	S	2	0	2	0.0004909180
Gordonia iterans	1004901	S	2	0	2	0.0004909180
Streptomyces broussonetiae	2686304	S	2	0	2	0.0004909180
Streptomyces venezuelae	54571	S	2	0	2	0.0004909180
Streptomyces lavendulae	1914	S	2	0	2	0.0004909180
Streptacidiphilus sp. PB12-B1b	2705012	S	2	0	2	0.0004909180
Pseudonocardia sp. AL041005-10	445576	S	1	1	2	0.0004909180
Micromonospora aurantiaca	47850	S	1	1	2	0.0004909180
Plantactinospora sp. BB1	2071627	S	2	0	2	0.0004909180
Bifidobacterium longum	216816	S	2	0	2	0.0004909180
Jatrophihabitans sp. GAS493	1907575	S	2	0	2	0.0004909180
Actinomarinicola tropica	2789776	S	2	0	2	0.0004909180
Staphylococcus haemolyticus	1283	S	2	0	2	0.0004909180
Amphibacillus xylanus	1449	S	2	0	2	0.0004909180
Lysinibacillus fusiformis	28031	S	1	1	2	0.0004909180
Streptococcus sp. oral taxon 061	712623	S	2	0	2	0.0004909180
Streptococcus gordonii	1302	S	2	0	2	0.0004909180
Streptococcus troglodytae	1111760	S	2	0	2	0.0004909180
Limosilactobacillus fermentum	1613	S	2	0	2	0.0004909180
Companilactobacillus futsaii	938155	S	1	1	2	0.0004909180
Latilactobacillus graminis	60519	S	1	1	2	0.0004909180
Dolosigranulum pigrum	29394	S	2	0	2	0.0004909180
Enterococcus cecorum	44008	S	2	0	2	0.0004909180
Aerococcus urinaeequi	51665	S	2	0	2	0.0004909180
Clostridium taeniosporum	394958	S	2	0	2	0.0004909180
Clostridium pasteurianum	1501	S	2	0	2	0.0004909180
Clostridium sporogenes	1509	S	1	1	2	0.0004909180
Paeniclostridium sordellii	1505	S	2	0	2	0.0004909180
Filifactor alocis	143361	S	1	1	2	0.0004909180
Murdochiella vaginalis	1852373	S	1	1	2	0.0004909180
Nostoc linckia	92942	S	2	0	2	0.0004909180
Nostoc carneum	374162	S	1	1	2	0.0004909180
Calothrix sp. 336/3	1337936	S	2	0	2	0.0004909180
Calothrix brevissima	938406	S	2	0	2	0.0004909180
Cyanobacterium aponinum	379064	S	1	1	2	0.0004909180
Thermus parvatiensis	456163	S	2	0	2	0.0004909180
Candidatus Promineofilum breve	1806508	S	2	0	2	0.0004909180
Flavobacterium johnsoniae	986	S	2	0	2	0.0004909180
Flavobacterium faecale	1355330	S	2	0	2	0.0004909180
Polaribacter sp. SA4-12	1312072	S	2	0	2	0.0004909180
Polaribacter sp. ALD11	2058137	S	2	0	2	0.0004909180
Polaribacter haliotis	1888915	S	2	0	2	0.0004909180
Lacinutrix sp. Bg11-31	2057808	S	2	0	2	0.0004909180
Tenacibaculum sp. DSM 106434	2358479	S	2	0	2	0.0004909180
Olleya sp. Bg11-27	2058135	S	1	1	2	0.0004909180
Chryseobacterium sp. 6424	2039166	S	2	0	2	0.0004909180
Kaistella antarctica	266748	S	2	0	2	0.0004909180
Epilithonimonas vandammei	2487072	S	1	1	2	0.0004909180
Pedobacter sp. PACM 27299	1727164	S	2	0	2	0.0004909180
Pedobacter sp. G11	2482728	S	2	0	2	0.0004909180
Pedobacter sp. HDW13	2714940	S	2	0	2	0.0004909180
Mucilaginibacter ginkgonis	2682091	S	2	0	2	0.0004909180
Hymenobacter sp. PAMC 26554	1484116	S	2	0	2	0.0004909180
Hymenobacter sp. NBH84	2596915	S	2	0	2	0.0004909180
Bacteroides sp. HF-162	2785531	S	2	0	2	0.0004909180
Bacteroides zoogleoformans	28119	S	2	0	2	0.0004909180
Alistipes onderdonkii	328813	S	2	0	2	0.0004909180
Arachidicoccus sp. B3-10	2545455	S	2	0	2	0.0004909180
Filimonas lacunae	477680	S	2	0	2	0.0004909180
Panacibacter ginsenosidivorans	1813871	S	2	0	2	0.0004909180
Tuwongella immobilis	692036	S	2	0	2	0.0004909180
Limnoglobus roseus	2598579	S	2	0	2	0.0004909180
Lacipirellula limnantheis	2528024	S	1	1	2	0.0004909180
Singulisphaera acidiphila	466153	S	1	1	2	0.0004909180
Paludisphaera borealis	1387353	S	1	1	2	0.0004909180
Luteolibacter luteus	2728835	S	2	0	2	0.0004909180
Roseimicrobium sp. ORNL1	2711231	S	2	0	2	0.0004909180
Ereboglobus luteus	1796921	S	2	0	2	0.0004909180
Granulicella tundricola	940615	S	2	0	2	0.0004909180
Acidianus brierleyi	41673	S	1	1	2	0.0004909180
Curvibacter virus P26059B	2733926	S	2	0	2	0.0004909180
Variovorax sp. PAMC28562	2762323	S	1	0	1	0.0002454590
Diaphorobacter sp. HDW4B	2714925	S	1	0	1	0.0002454590
Diaphorobacter ruginosibacter	1715720	S	1	0	1	0.0002454590
Hydrogenophaga sp. NH-16	2184519	S	1	0	1	0.0002454590
Hydrogenophaga sp. BA0156	2716225	S	1	0	1	0.0002454590
Rhodoferax saidenbachensis	1484693	S	1	0	1	0.0002454590
Ottowia sp. oral taxon 894	1658672	S	1	0	1	0.0002454590
Limnohabitans sp. 103DPR2	1678129	S	1	0	1	0.0002454590
Pulveribacter suum	2116657	S	1	0	1	0.0002454590
Simplicispira suum	2109915	S	1	0	1	0.0002454590
Janthinobacterium sp. B9-8	1236179	S	1	0	1	0.0002454590
Collimonas arenae	279058	S	1	0	1	0.0002454590
Collimonas pratensis	279113	S	1	0	1	0.0002454590
Massilia sp. YMA4	1593482	S	1	0	1	0.0002454590
Massilia sp. NR 4-1	1678028	S	1	0	1	0.0002454590
Massilia sp. CCM 8941	2765360	S	1	0	1	0.0002454590
Massilia umbonata	864828	S	1	0	1	0.0002454590
Massilia flava	871742	S	1	0	1	0.0002454590
Massilia violaceinigra	2045208	S	1	0	1	0.0002454590
Duganella sp. AF9R3	2728021	S	1	0	1	0.0002454590
Noviherbaspirillum sp. UKPF54	2601898	S	1	0	1	0.0002454590
Burkholderia sp. CCGE1003	640512	S	1	0	1	0.0002454590
Burkholderia gladioli	28095	S	1	0	1	0.0002454590
Polynucleobacter asymbioticus	576611	S	1	0	1	0.0002454590
Paraburkholderia sp. SOS3	1926494	S	1	0	1	0.0002454590
Paraburkholderia sp. PGU19	2735434	S	1	0	1	0.0002454590
Paraburkholderia graminis	60548	S	1	0	1	0.0002454590
Paraburkholderia acidiphila	2571747	S	1	0	1	0.0002454590
Paraburkholderia aromaticivorans	2026199	S	1	0	1	0.0002454590
Paraburkholderia phenoliruptrix	252970	S	1	0	1	0.0002454590
Cupriavidus basilensis	68895	S	1	0	1	0.0002454590
Cupriavidus pauculus	82633	S	1	0	1	0.0002454590
Cupriavidus neocaledonicus	1040979	S	1	0	1	0.0002454590
Pandoraea fibrosis	1891094	S	1	0	1	0.0002454590
Limnobacter sp. SAORIC-580	2732163	S	1	0	1	0.0002454590
Chitinimonas arctica	2594795	S	1	0	1	0.0002454590
Ephemeroptericola cinctiostellae	2268024	S	1	0	1	0.0002454590
Xylophilus rhododendri	2697032	S	1	0	1	0.0002454590
Achromobacter sp. AONIH1	1758194	S	1	0	1	0.0002454590
Achromobacter sp. MFA1 R4	1881016	S	1	0	1	0.0002454590
Bordetella hinzii	103855	S	1	0	1	0.0002454590
Bordetella trematum	123899	S	1	0	1	0.0002454590
Bordetella flabilis	463014	S	1	0	1	0.0002454590
Bordetella genomosp. 9	1416803	S	1	0	1	0.0002454590
Bordetella sp. N	1746199	S	1	0	1	0.0002454590
Castellaniella defragrans	75697	S	1	0	1	0.0002454590
Methyloversatilis sp. RAC08	1842540	S	1	0	1	0.0002454590
Methylophilus medardicus	2588534	S	1	0	1	0.0002454590
Methylotenera versatilis	1055487	S	1	0	1	0.0002454590
Candidatus Methylopumilus turicensis	1581680	S	1	0	1	0.0002454590
Candidatus Nitrotoga sp. AM1P	2559597	S	1	0	1	0.0002454590
Ferriphaselus amnicola	1188319	S	1	0	1	0.0002454590
Usitatibacter palustris	2732487	S	1	0	1	0.0002454590
Thiobacillus denitrificans	36861	S	1	0	1	0.0002454590
Aromatoleum aromaticum	551760	S	1	0	1	0.0002454590
Oryzomicrobium terrae	1735038	S	1	0	1	0.0002454590
Rugosibacter aromaticivorans	1565605	S	1	0	1	0.0002454590
Azoarcus sp. CIB	198107	S	1	0	1	0.0002454590
Azoarcus communis	41977	S	1	0	1	0.0002454590
Azoarcus pumilus	2067960	S	1	0	1	0.0002454590
Thauera humireducens	1134435	S	1	0	1	0.0002454590
Thauera sp. K11	2005884	S	1	0	1	0.0002454590
Vogesella sp. LIG4	1192162	S	1	0	1	0.0002454590
Vitreoscilla filiformis	63	S	1	0	1	0.0002454590
Neisseria animalis	492	S	1	0	1	0.0002454590
Casimicrobium huifangae	2591109	S	1	0	1	0.0002454590
Acinetobacter nosocomialis	106654	S	1	0	1	0.0002454590
Acinetobacter sp. WCHA45	2004644	S	1	0	1	0.0002454590
Acinetobacter sp. TTH0-4	1646498	S	1	0	1	0.0002454590
Acinetobacter tandoii	202954	S	1	0	1	0.0002454590
Acinetobacter indicus	756892	S	1	0	1	0.0002454590
Acinetobacter lwoffii	28090	S	1	0	1	0.0002454590
Acinetobacter ursingii	108980	S	1	0	1	0.0002454590
Moraxella catarrhalis	480	S	1	0	1	0.0002454590
Psychrobacter arcticus	334543	S	1	0	1	0.0002454590
Pseudomonas cedrina	651740	S	1	0	1	0.0002454590
Pseudomonas protegens	380021	S	1	0	1	0.0002454590
Pseudomonas mandelii	75612	S	1	0	1	0.0002454590
Pseudomonas sp. J380	2605424	S	1	0	1	0.0002454590
Pseudomonas sp. ADAK13	2730847	S	1	0	1	0.0002454590
Pseudomonas sp. R4-39-08	1173288	S	1	0	1	0.0002454590
Pseudomonas sp. DG56-2	2320270	S	1	0	1	0.0002454590
Pseudomonas sp. UW4	1207075	S	1	0	1	0.0002454590
Pseudomonas sp. URMO17WK12:I11	1283291	S	1	0	1	0.0002454590
Pseudomonas sp. CC6-YY-74	1930532	S	1	0	1	0.0002454590
Pseudomonas sp. RtIB026	2749999	S	1	0	1	0.0002454590
Pseudomonas sp. 14181154	2662033	S	1	0	1	0.0002454590
Pseudomonas alcaligenes	43263	S	1	0	1	0.0002454590
Pseudomonas furukawaii	1149133	S	1	0	1	0.0002454590
Pseudomonas palleroniana	191390	S	1	0	1	0.0002454590
Pseudomonas chlororaphis	587753	S	1	0	1	0.0002454590
Klebsiella quasipneumoniae	1463165	S	1	0	1	0.0002454590
Citrobacter rodentium	67825	S	1	0	1	0.0002454590
Escherichia fergusonii	564	S	1	0	1	0.0002454590
Phytobacter ursingii	1972431	S	1	0	1	0.0002454590
Cronobacter sakazakii	28141	S	1	0	1	0.0002454590
Candidatus Ishikawaella capsulata	168169	S	1	0	1	0.0002454590
Blochmannia endosymbiont of Polyrhachis (Hedomyrma) turneri	1505596	S	1	0	1	0.0002454590
Serratia proteamaculans	28151	S	1	0	1	0.0002454590
Serratia rubidaea	61652	S	1	0	1	0.0002454590
Yersinia pseudotuberculosis	633	S	1	0	1	0.0002454590
Ewingella americana	41202	S	1	0	1	0.0002454590
Proteus vulgaris	585	S	1	0	1	0.0002454590
Xenorhabdus bovienii	40576	S	1	0	1	0.0002454590
Hafnia alvei	569	S	1	0	1	0.0002454590
Lysobacter capsici	435897	S	1	0	1	0.0002454590
Xanthomonas sp. GW	2724121	S	1	0	1	0.0002454590
Xanthomonas oryzae	347	S	1	0	1	0.0002454590
Xanthomonas arboricola	56448	S	1	0	1	0.0002454590
Xanthomonas hortorum	56454	S	1	0	1	0.0002454590
Xanthomonas vasicola	56459	S	1	0	1	0.0002454590
Stenotrophomonas sp. Pemsol	2040586	S	1	0	1	0.0002454590
Stenotrophomonas sp. 364	2691571	S	1	0	1	0.0002454590
Luteimonas sp. JM171	1896164	S	1	0	1	0.0002454590
Dyella japonica	231455	S	1	0	1	0.0002454590
Halomonas sp. YLGW01	2773308	S	1	0	1	0.0002454590
Halomonas sp. THAF12	2587849	S	1	0	1	0.0002454590
Halomonas sp. THAF5a	2587844	S	1	0	1	0.0002454590
Halomonas piezotolerans	2609667	S	1	0	1	0.0002454590
Halomonas hydrothermalis	115561	S	1	0	1	0.0002454590
Candidatus Portiera aleyrodidarum	91844	S	1	0	1	0.0002454590
Halotalea alkalilenta	376489	S	1	0	1	0.0002454590
Thalassolituus oleivorans	187493	S	1	0	1	0.0002454590
Haemophilus influenzae	727	S	1	0	1	0.0002454590
Pasteurella multocida	747	S	1	0	1	0.0002454590
Mannheimia varigena	85404	S	1	0	1	0.0002454590
Actinobacillus pleuropneumoniae	715	S	1	0	1	0.0002454590
Vibrio alginolyticus	663	S	1	0	1	0.0002454590
Vibrio owensii	696485	S	1	0	1	0.0002454590
Vibrio spartinae	1918945	S	1	0	1	0.0002454590
Vibrio tritonius	1435069	S	1	0	1	0.0002454590
Photobacterium damselae	38293	S	1	0	1	0.0002454590
Glaciecola nitratireducens	300231	S	1	0	1	0.0002454590
Pseudoalteromonas aliena	247523	S	1	0	1	0.0002454590
Pseudoalteromonas prydzensis	182141	S	1	0	1	0.0002454590
Colwellia sp. MT41	58049	S	1	0	1	0.0002454590
Thiomicrorhabdus aquaedulcis	2211106	S	1	0	1	0.0002454590
Thiothrix sp.	1032	S	1	0	1	0.0002454590
Methylomonas sp. LW13	107637	S	1	0	1	0.0002454590
Rheinheimera sp. F8	1763998	S	1	0	1	0.0002454590
Rheinheimera sp. LHK132	2498451	S	1	0	1	0.0002454590
Thioflavicoccus mobilis	80679	S	1	0	1	0.0002454590
Thioalkalivibrio nitratireducens	186931	S	1	0	1	0.0002454590
Thiohalobacter sp. COW1	2795687	S	1	0	1	0.0002454590
Legionella hackeliae	449	S	1	0	1	0.0002454590
Candidatus Coxiella mudrowiae	2054173	S	1	0	1	0.0002454590
Candidatus Nardonella dryophthoridicola	1971485	S	1	0	1	0.0002454590
endosymbiont of unidentified scaly snail isolate Monju	1248727	S	1	0	1	0.0002454590
Immundisolibacter cernigliae	1810504	S	1	0	1	0.0002454590
Bradyrhizobium sp. 6(2017)	1197460	S	1	0	1	0.0002454590
Bradyrhizobium sp. CCBAU 51753	1325100	S	1	0	1	0.0002454590
Bradyrhizobium sp. CCBAU 53340	1325112	S	1	0	1	0.0002454590
Bradyrhizobium genosp. B	83627	S	1	0	1	0.0002454590
Bradyrhizobium canariense	255045	S	1	0	1	0.0002454590
Bradyrhizobium arachidis	858423	S	1	0	1	0.0002454590
Bradyrhizobium cosmicum	1404864	S	1	0	1	0.0002454590
Bradyrhizobium amphicarpaeae	1404768	S	1	0	1	0.0002454590
Bradyrhizobium diazoefficiens	1355477	S	1	0	1	0.0002454590
Bradyrhizobium zhanjiangense	1325107	S	1	0	1	0.0002454590
Bosea sp. RAC05	1842539	S	1	0	1	0.0002454590
Bosea sp. AS-1	2015316	S	1	0	1	0.0002454590
Tardiphaga robiniae	943830	S	1	0	1	0.0002454590
Nitrobacter hamburgensis	912	S	1	0	1	0.0002454590
Methylobacterium mesophilicum	39956	S	1	0	1	0.0002454590
Methylobacterium nodulans	114616	S	1	0	1	0.0002454590
Methylobacterium durans	2202825	S	1	0	1	0.0002454590
Mesorhizobium sp. M8A.F.Ca.ET.057.01.1.1	2493679	S	1	0	1	0.0002454590
Mesorhizobium sp. 8	2584466	S	1	0	1	0.0002454590
Mesorhizobium sp. INR15	2654248	S	1	0	1	0.0002454590
Mesorhizobium sp. 131-2-1	2744518	S	1	0	1	0.0002454590
Mesorhizobium sp. DCY119	2108445	S	1	0	1	0.0002454590
Mesorhizobium loti	381	S	1	0	1	0.0002454590
Phyllobacterium zundukense	1867719	S	1	0	1	0.0002454590
Neorhizobium sp. NCHU2750	1825976	S	1	0	1	0.0002454590
Devosia sp. I507	2083786	S	1	0	1	0.0002454590
Hyphomicrobium denitrificans	53399	S	1	0	1	0.0002454590
Hyphomicrobium sp. MC1	717785	S	1	0	1	0.0002454590
Rhodoplanes sp. Z2-YC6860	674703	S	1	0	1	0.0002454590
Pelagibacterium halotolerans	531813	S	1	0	1	0.0002454590
Labrenzia sp. THAF82	2587861	S	1	0	1	0.0002454590
Stappia sp. ES.058	1881061	S	1	0	1	0.0002454590
Pannonibacter phragmitetus	121719	S	1	0	1	0.0002454590
Candidatus Hodgkinia cicadicola	573658	S	1	0	1	0.0002454590
Hartmannibacter diazotrophicus	1482074	S	1	0	1	0.0002454590
Pseudorhodoplanes sinuspersici	1235591	S	1	0	1	0.0002454590
Methylocystis rosea	173366	S	1	0	1	0.0002454590
Methylocystis bryophila	655015	S	1	0	1	0.0002454590
Aureimonas sp. LMG 31693	2758041	S	1	0	1	0.0002454590
Xanthobacter sp. YN2	2528964	S	1	0	1	0.0002454590
Breoghania sp. L-A4	2304600	S	1	0	1	0.0002454590
Pyruvatibacter mobilis	1712261	S	1	0	1	0.0002454590
Sphingomonas sp. HDW15C	2714944	S	1	0	1	0.0002454590
Sphingomonas sp. LM7	1938607	S	1	0	1	0.0002454590
Sphingomonas sanxanigenens	397260	S	1	0	1	0.0002454590
Sphingomonas daechungensis	1176646	S	1	0	1	0.0002454590
Sphingomonas rhizophila	2071607	S	1	0	1	0.0002454590
Sphingobium sp. RAC03	1843368	S	1	0	1	0.0002454590
Sphingobium sp. KCTC 72723	2733867	S	1	0	1	0.0002454590
Sphingopyxis sp. QXT-31	1357916	S	1	0	1	0.0002454590
Sphingopyxis lindanitolerans	2054227	S	1	0	1	0.0002454590
Novosphingobium sp. PP1Y	702113	S	1	0	1	0.0002454590
Novosphingobium sp. P6W	1609758	S	1	0	1	0.0002454590
Novosphingobium resinovorum	158500	S	1	0	1	0.0002454590
Sphingorhabdus sp. YGSMI21	2077182	S	1	0	1	0.0002454590
Sphingorhabdus sp. SMR4y	2584094	S	1	0	1	0.0002454590
Citromicrobium sp. JL477	1634516	S	1	0	1	0.0002454590
Porphyrobacter sp. YT40	2547601	S	1	0	1	0.0002454590
Erythrobacter aureus	2182384	S	1	0	1	0.0002454590
Altererythrobacter sp. B11	2060312	S	1	0	1	0.0002454590
Altererythrobacter sp. TH136	2067415	S	1	0	1	0.0002454590
Qipengyuania flava	192812	S	1	0	1	0.0002454590
Sphingosinicella microcystinivorans	335406	S	1	0	1	0.0002454590
Paracoccus aminophilus	34003	S	1	0	1	0.0002454590
Paracoccus jeotgali	2065379	S	1	0	1	0.0002454590
Paracoccus sanguinis	1545044	S	1	0	1	0.0002454590
Paracoccus sp. Arc7-R13	2500532	S	1	0	1	0.0002454590
Salipiger pacificus	311180	S	1	0	1	0.0002454590
Salipiger profundus	1229727	S	1	0	1	0.0002454590
Rhodobacter blasticus	1075	S	1	0	1	0.0002454590
Pseudopuniceibacterium antarcticum	2613965	S	1	0	1	0.0002454590
Celeribacter indicus	1208324	S	1	0	1	0.0002454590
Maribius sp. THAF1	2587842	S	1	0	1	0.0002454590
Thalassobius gelatinovorus	53501	S	1	0	1	0.0002454590
Phaeobacter porticola	1844006	S	1	0	1	0.0002454590
Tateyamaria omphalii	299262	S	1	0	1	0.0002454590
Octadecabacter arcticus	53946	S	1	0	1	0.0002454590
Rhodobaca barguzinensis	441209	S	1	0	1	0.0002454590
Rhodovulum sulfidophilum	35806	S	1	0	1	0.0002454590
Brevundimonas sp. LM2	1938605	S	1	0	1	0.0002454590
Brevundimonas sp. AJA228-03	2752515	S	1	0	1	0.0002454590
Brevundimonas sp. GRTSA-9	2800818	S	1	0	1	0.0002454590
Brevundimonas vesicularis	41276	S	1	0	1	0.0002454590
Brevundimonas mediterranea	74329	S	1	0	1	0.0002454590
Phenylobacterium zucineum	284016	S	1	0	1	0.0002454590
Roseococcus sp. NIBR12	2771361	S	1	0	1	0.0002454590
Magnetospirillum gryphiswaldense	55518	S	1	0	1	0.0002454590
Azospirillum brasilense	192	S	1	0	1	0.0002454590
Azospirillum lipoferum	193	S	1	0	1	0.0002454590
Skermanella sp. TT6	2775420	S	1	0	1	0.0002454590
Wolbachia endosymbiont of Ctenocephalides felis wCfeT	2732593	S	1	0	1	0.0002454590
Wolbachia endosymbiont of Dipetalonema caudispina	1812112	S	1	0	1	0.0002454590
Wolbachia endosymbiont of Cruorifilaria tuberocauda	1812111	S	1	0	1	0.0002454590
Anaplasma platys	949	S	1	0	1	0.0002454590
Rickettsia typhi	785	S	1	0	1	0.0002454590
Rickettsia bellii	33990	S	1	0	1	0.0002454590
Hyphomonas sp. KY3	2016196	S	1	0	1	0.0002454590
Candidatus Pelagibacter sp. IMCC9063	1002672	S	1	0	1	0.0002454590
Candidatus Fonsibacter ubiquis	1925548	S	1	0	1	0.0002454590
Candidatus Nucleicultrix amoebiphila	1509244	S	1	0	1	0.0002454590
Marinicauda algicola	2029849	S	1	0	1	0.0002454590
Sandaracinus amylolyticus	927083	S	1	0	1	0.0002454590
Archangium violaceum	83451	S	1	0	1	0.0002454590
Anaeromyxobacter dehalogenans	161493	S	1	0	1	0.0002454590
Geobacter sp. M18	443143	S	1	0	1	0.0002454590
Desulfatibacillum aliphaticivorans	218208	S	1	0	1	0.0002454590
Desulfovibrio marinus	370038	S	1	0	1	0.0002454590
Desulfomicrobium baculatum	899	S	1	0	1	0.0002454590
Desulfobacca acetoxidans	60893	S	1	0	1	0.0002454590
Persicimonas caeni	2292766	S	1	0	1	0.0002454590
Aliarcobacter cryaerophilus	28198	S	1	0	1	0.0002454590
Aliarcobacter skirrowii	28200	S	1	0	1	0.0002454590
Aliarcobacter thereius	544718	S	1	0	1	0.0002454590
Halarcobacter ebronensis	1462615	S	1	0	1	0.0002454590
Poseidonibacter lekithochrous	1904463	S	1	0	1	0.0002454590
Campylobacter sp. RM16704	1500960	S	1	0	1	0.0002454590
Campylobacter lanienae	75658	S	1	0	1	0.0002454590
Bacteriovorax stolpii	960	S	1	0	1	0.0002454590
Arthrobacter sp. FB24	290399	S	1	0	1	0.0002454590
Arthrobacter sp. YN	2020486	S	1	0	1	0.0002454590
Arthrobacter sp. PAMC 25486	1494608	S	1	0	1	0.0002454590
Arthrobacter sp. D5-1	1477518	S	1	0	1	0.0002454590
Arthrobacter sp. QXT-31	1357915	S	1	0	1	0.0002454590
Arthrobacter sp. NEB 688	904039	S	1	0	1	0.0002454590
Arthrobacter dokdonellae	2211210	S	1	0	1	0.0002454590
Rothia dentocariosa	2047	S	1	0	1	0.0002454590
Rothia aeria	172042	S	1	0	1	0.0002454590
Kocuria rosea	1275	S	1	0	1	0.0002454590
Pseudarthrobacter sp. NIBRBAC000502771	2590774	S	1	0	1	0.0002454590
Microbacterium sp. LKL04	912630	S	1	0	1	0.0002454590
Microbacterium sp. Y-01	2048898	S	1	0	1	0.0002454590
Microbacterium lushaniae	2614639	S	1	0	1	0.0002454590
Microbacterium schleiferi	69362	S	1	0	1	0.0002454590
Microbacterium wangchenii	2541726	S	1	0	1	0.0002454590
Microbacterium protaetiae	2509458	S	1	0	1	0.0002454590
Microbacterium oleivorans	273677	S	1	0	1	0.0002454590
Microbacterium lemovicicum	1072463	S	1	0	1	0.0002454590
Microbacterium testaceum	2033	S	1	0	1	0.0002454590
Microbacterium amylolyticum	936337	S	1	0	1	0.0002454590
Microbacterium oryzae	743009	S	1	0	1	0.0002454590
Curtobacterium sp. MR_MD2014	1561023	S	1	0	1	0.0002454590
Curtobacterium sp. 24E2	2804758	S	1	0	1	0.0002454590
Leifsonia shinshuensis	150026	S	1	0	1	0.0002454590
Agromyces aureus	453304	S	1	0	1	0.0002454590
Agromyces sp. HY052	2585717	S	1	0	1	0.0002454590
Leucobacter triazinivorans	1784719	S	1	0	1	0.0002454590
Leucobacter muris	1935379	S	1	0	1	0.0002454590
Microterricola viridarii	412690	S	1	0	1	0.0002454590
Agreia sp. COWG	2773266	S	1	0	1	0.0002454590
Plantibacter flavus	150123	S	1	0	1	0.0002454590
Brevibacterium linens	1703	S	1	0	1	0.0002454590
Xylanimonas allomyrinae	2509459	S	1	0	1	0.0002454590
Cellulomonas sp. H30R-01	2704467	S	1	0	1	0.0002454590
Oerskovia sp. KBS0722	1179673	S	1	0	1	0.0002454590
Brachybacterium ginsengisoli	1331682	S	1	0	1	0.0002454590
Brachybacterium vulturis	2017484	S	1	0	1	0.0002454590
Janibacter limosus	53458	S	1	0	1	0.0002454590
Ornithinimicrobium sp. HY006	2508882	S	1	0	1	0.0002454590
Luteimicrobium xylanilyticum	1133546	S	1	0	1	0.0002454590
Cutibacterium granulosum	33011	S	1	0	1	0.0002454590
Tessaracoccus defluvii	1285901	S	1	0	1	0.0002454590
Brevilactibacter sp. MC1595	2819349	S	1	0	1	0.0002454590
Nocardioides sp. S5	2017486	S	1	0	1	0.0002454590
Nocardioides sp. WS12	2486272	S	1	0	1	0.0002454590
Nocardioides marinisabuli	419476	S	1	0	1	0.0002454590
Nocardioides mesophilus	433659	S	1	0	1	0.0002454590
Nocardioides humi	449461	S	1	0	1	0.0002454590
Nocardioides anomalus	2712223	S	1	0	1	0.0002454590
Nocardia farcinica	37329	S	1	0	1	0.0002454590
Nocardia nova	37330	S	1	0	1	0.0002454590
Nocardia arthritidis	228602	S	1	0	1	0.0002454590
Nocardia sp. CS682	1047172	S	1	0	1	0.0002454590
Mycobacterium sp. JS623	212767	S	1	0	1	0.0002454590
Mycobacterium gordonae	1778	S	1	0	1	0.0002454590
Mycobacterium shigaense	722731	S	1	0	1	0.0002454590
Mycobacterium conspicuum	44010	S	1	0	1	0.0002454590
Mycobacterium marseillense	701042	S	1	0	1	0.0002454590
Mycolicibacterium sp. Z-34	2736649	S	1	0	1	0.0002454590
Mycolicibacterium madagascariense	212765	S	1	0	1	0.0002454590
Mycolicibacterium doricum	126673	S	1	0	1	0.0002454590
Mycolicibacterium mageritense	53462	S	1	0	1	0.0002454590
Mycolicibacterium chubuense	1800	S	1	0	1	0.0002454590
Mycolicibacterium thermoresistibile	1797	S	1	0	1	0.0002454590
Mycolicibacter hiberniae	29314	S	1	0	1	0.0002454590
Corynebacterium sphenisci	191493	S	1	0	1	0.0002454590
Corynebacterium sp. zg-917	2763010	S	1	0	1	0.0002454590
Corynebacterium amycolatum	43765	S	1	0	1	0.0002454590
Corynebacterium variabile	1727	S	1	0	1	0.0002454590
Corynebacterium liangguodongii	2079535	S	1	0	1	0.0002454590
Corynebacterium maris	575200	S	1	0	1	0.0002454590
Corynebacterium macginleyi	38290	S	1	0	1	0.0002454590
Gordonia polyisoprenivorans	84595	S	1	0	1	0.0002454590
Dietzia timorensis	499555	S	1	0	1	0.0002454590
Streptomyces sp. P3	2135430	S	1	0	1	0.0002454590
Streptomyces sp. SAT1	1849967	S	1	0	1	0.0002454590
Streptomyces sp. SN-593	659352	S	1	0	1	0.0002454590
Streptomyces sp. QMT-12	2717324	S	1	0	1	0.0002454590
Streptomyces sp. CRXT-G-22	2768066	S	1	0	1	0.0002454590
Streptomyces sp. SCSIO 3032	1264596	S	1	0	1	0.0002454590
Streptomyces lincolnensis	1915	S	1	0	1	0.0002454590
Streptomyces noursei	1971	S	1	0	1	0.0002454590
Streptomyces nitrosporeus	28894	S	1	0	1	0.0002454590
Streptomyces viridosporus	67581	S	1	0	1	0.0002454590
Streptomyces capitiformicae	2014920	S	1	0	1	0.0002454590
Streptomyces rapamycinicus	1226757	S	1	0	1	0.0002454590
Streptomyces nojiriensis	66374	S	1	0	1	0.0002454590
Streptomyces platensis	58346	S	1	0	1	0.0002454590
Streptomyces aquilus	2548456	S	1	0	1	0.0002454590
Streptomyces xinghaiensis	1038928	S	1	0	1	0.0002454590
Streptomyces cacaoi	1898	S	1	0	1	0.0002454590
Streptomyces griseus	1911	S	1	0	1	0.0002454590
Kitasatospora albolonga	68173	S	1	0	1	0.0002454590
Amycolatopsis sp. Hca4	2742131	S	1	0	1	0.0002454590
Amycolatopsis sp. FDAARGOS 1241	2778070	S	1	0	1	0.0002454590
Amycolatopsis methanolica	1814	S	1	0	1	0.0002454590
Pseudonocardia sp. CGMCC 4.1532	2761535	S	1	0	1	0.0002454590
Kibdelosporangium phytohabitans	860235	S	1	0	1	0.0002454590
Saccharothrix syringae	103733	S	1	0	1	0.0002454590
Prauserella marina	530584	S	1	0	1	0.0002454590
Micromonospora terminaliae	1914461	S	1	0	1	0.0002454590
Micromonospora coxensis	356852	S	1	0	1	0.0002454590
Micromonospora narathiwatensis	299146	S	1	0	1	0.0002454590
Actinoplanes teichomyceticus	1867	S	1	0	1	0.0002454590
Bifidobacterium bifidum	1681	S	1	0	1	0.0002454590
Bifidobacterium pullorum	78448	S	1	0	1	0.0002454590
Gardnerella leopoldii	2792978	S	1	0	1	0.0002454590
Candidatus Planktophila versatilis	1884905	S	1	0	1	0.0002454590
Candidatus Planktophila lacus	1884913	S	1	0	1	0.0002454590
Streptosporangium roseum	2001	S	1	0	1	0.0002454590
Streptosporangium sp. 'caverna'	2202249	S	1	0	1	0.0002454590
Actinomadura verrucosospora	46165	S	1	0	1	0.0002454590
Actinomadura sp. WMMA1423	2591108	S	1	0	1	0.0002454590
Frankia inefficax	298654	S	1	0	1	0.0002454590
Candidatus Frankia datiscae	2716812	S	1	0	1	0.0002454590
Jiangella alkaliphila	419479	S	1	0	1	0.0002454590
Rubrobacter radiotolerans	42256	S	1	0	1	0.0002454590
Rubrobacter xylanophilus	49319	S	1	0	1	0.0002454590
Conexibacter woesei	191495	S	1	0	1	0.0002454590
Staphylococcus condimenti	70255	S	1	0	1	0.0002454590
Staphylococcus muscae	1294	S	1	0	1	0.0002454590
Staphylococcus saccharolyticus	33028	S	1	0	1	0.0002454590
Staphylococcus saprophyticus	29385	S	1	0	1	0.0002454590
Bacillus vini	1476025	S	1	0	1	0.0002454590
Weizmannia coagulans	1398	S	1	0	1	0.0002454590
Mesobacillus jeotgali	129985	S	1	0	1	0.0002454590
Cytobacillus kochii	859143	S	1	0	1	0.0002454590
Fictibacillus arsenicus	255247	S	1	0	1	0.0002454590
Anaerobacillus isosaccharinicus	1532552	S	1	0	1	0.0002454590
Virgibacillus necropolis	163877	S	1	0	1	0.0002454590
Paenibacillus beijingensis	1126833	S	1	0	1	0.0002454590
Planococcus faecalis	1598147	S	1	0	1	0.0002454590
Planococcus sp. PAMC 21323	1526927	S	1	0	1	0.0002454590
Listeria monocytogenes	1639	S	1	0	1	0.0002454590
Streptococcus sp. 1643	2576376	S	1	0	1	0.0002454590
Streptococcus oralis	1303	S	1	0	1	0.0002454590
Streptococcus equinus	1335	S	1	0	1	0.0002454590
Lactococcus cremoris	1359	S	1	0	1	0.0002454590
Lactobacillus jensenii	109790	S	1	0	1	0.0002454590
Schleiferilactobacillus harbinensis	304207	S	1	0	1	0.0002454590
Jeotgalibaca porci	1868793	S	1	0	1	0.0002454590
Enterococcus faecalis	1351	S	1	0	1	0.0002454590
Enterococcus hirae	1354	S	1	0	1	0.0002454590
Enterococcus mundtii	53346	S	1	0	1	0.0002454590
Enterococcus rotai	118060	S	1	0	1	0.0002454590
Aerococcus viridans	1377	S	1	0	1	0.0002454590
Clostridium tyrobutyricum	1519	S	1	0	1	0.0002454590
Clostridium baratii	1561	S	1	0	1	0.0002454590
Clostridium scatologenes	1548	S	1	0	1	0.0002454590
Geosporobacter ferrireducens	1424294	S	1	0	1	0.0002454590
Paraclostridium bifermentans	1490	S	1	0	1	0.0002454590
Clostridioides difficile	1496	S	1	0	1	0.0002454590
Acetivibrio saccincola	1677857	S	1	0	1	0.0002454590
Flavonifractor plautii	292800	S	1	0	1	0.0002454590
Ruminiclostridium herbifermentans	2488810	S	1	0	1	0.0002454590
Eubacterium callanderi	53442	S	1	0	1	0.0002454590
Aminipila butyrica	433296	S	1	0	1	0.0002454590
Thermodesulfobium acidiphilum	1794699	S	1	0	1	0.0002454590
Mahella australiensis	252966	S	1	0	1	0.0002454590
Tissierellia sp. JN-28	2507161	S	1	0	1	0.0002454590
Veillonella parvula	29466	S	1	0	1	0.0002454590
Nostoc sp. PCC 7524	28072	S	1	0	1	0.0002454590
Nostoc sp. C052	2576902	S	1	0	1	0.0002454590
Calothrix sp. NIES-2098	1954171	S	1	0	1	0.0002454590
Brasilonema sennae	1397703	S	1	0	1	0.0002454590
Rivularia sp. PCC 7116	373994	S	1	0	1	0.0002454590
Synechococcus sp. A15-44	1050646	S	1	0	1	0.0002454590
Synechococcus sp. PCC 6312	195253	S	1	0	1	0.0002454590
Synechococcus sp. PCC 73109	374982	S	1	0	1	0.0002454590
Dactylococcopsis salina	292566	S	1	0	1	0.0002454590
Pseudanabaena sp. ABRG5-3	685565	S	1	0	1	0.0002454590
Oscillatoria acuminata	118323	S	1	0	1	0.0002454590
Moorea producens	1155739	S	1	0	1	0.0002454590
Gloeomargarita lithophora	1188228	S	1	0	1	0.0002454590
Deinococcus actinosclerus	1768108	S	1	0	1	0.0002454590
Deinococcus deserti	310783	S	1	0	1	0.0002454590
Deinococcus swuensis	1182571	S	1	0	1	0.0002454590
Deinococcus radiodurans	1299	S	1	0	1	0.0002454590
Mycoplasma mobile	2118	S	1	0	1	0.0002454590
Mycoplasma canis	29555	S	1	0	1	0.0002454590
Spiroplasma melliferum	2134	S	1	0	1	0.0002454590
Spiroplasma tabanidicola	324079	S	1	0	1	0.0002454590
Spiroplasma chrysopicola	216933	S	1	0	1	0.0002454590
Candidatus Phytoplasma mali	37692	S	1	0	1	0.0002454590
Flavobacterium sp. Sr18	935222	S	1	0	1	0.0002454590
Flavobacterium sp. MDT1-60	1979344	S	1	0	1	0.0002454590
Flavobacterium sp. M31R6	2739062	S	1	0	1	0.0002454590
Flavobacterium sp. CLA17	2724135	S	1	0	1	0.0002454590
Flavobacterium columnare	996	S	1	0	1	0.0002454590
Flavobacterium crocinum	2183896	S	1	0	1	0.0002454590
Flavobacterium album	2175091	S	1	0	1	0.0002454590
Flavobacterium crassostreae	1763534	S	1	0	1	0.0002454590
Flavobacterium nitrogenifigens	1617283	S	1	0	1	0.0002454590
Flavobacterium gilvum	1492737	S	1	0	1	0.0002454590
Flavobacterium commune	1306519	S	1	0	1	0.0002454590
Polaribacter sp. L12M9	2738844	S	1	0	1	0.0002454590
Polaribacter sejongensis	985043	S	1	0	1	0.0002454590
Polaribacter vadi	1774273	S	1	0	1	0.0002454590
Myroides odoratus	256	S	1	0	1	0.0002454590
Myroides profundi	480520	S	1	0	1	0.0002454590
Capnocytophaga cynodegmi	28189	S	1	0	1	0.0002454590
Capnocytophaga endodontalis	2708117	S	1	0	1	0.0002454590
Lacinutrix sp. 5H-3-7-4	983544	S	1	0	1	0.0002454590
Nonlabens sp. Hel1_33_55	1336802	S	1	0	1	0.0002454590
Nonlabens sp. MB-3u-79	2058134	S	1	0	1	0.0002454590
Formosa sp. Hel3_A1_48	1336795	S	1	0	1	0.0002454590
Aquimarina sp. BL5	1714860	S	1	0	1	0.0002454590
Winogradskyella helgolandensis	2697010	S	1	0	1	0.0002454590
Muriicola sp. MMS17-SY002	2507538	S	1	0	1	0.0002454590
Siansivirga zeaxanthinifaciens	762954	S	1	0	1	0.0002454590
Psychroflexus sp. ALD_RP9	2777186	S	1	0	1	0.0002454590
Urechidicola croceus	1850246	S	1	0	1	0.0002454590
Chryseobacterium sp. G0186	2487064	S	1	0	1	0.0002454590
Chryseobacterium sp. SNU WT5	2594269	S	1	0	1	0.0002454590
Chryseobacterium sp. POL2	2713414	S	1	0	1	0.0002454590
Chryseobacterium sp. NEB161	2724619	S	1	0	1	0.0002454590
Chryseobacterium indologenes	253	S	1	0	1	0.0002454590
Chryseobacterium arthrosphaerae	651561	S	1	0	1	0.0002454590
Chryseobacterium shandongense	1493872	S	1	0	1	0.0002454590
Chryseobacterium balustinum	246	S	1	0	1	0.0002454590
Elizabethkingia sp. JS20170427COW	2583851	S	1	0	1	0.0002454590
Ornithobacterium rhinotracheale	28251	S	1	0	1	0.0002454590
Cruoricaptor ignavus	1118202	S	1	0	1	0.0002454590
Croceimicrobium hydrocarbonivorans	2761580	S	1	0	1	0.0002454590
Pedobacter suwonensis	332999	S	1	0	1	0.0002454590
Pedobacter steynii	430522	S	1	0	1	0.0002454590
Mucilaginibacter ginsenosidivorans	398053	S	1	0	1	0.0002454590
Mucilaginibacter gotjawali	1550579	S	1	0	1	0.0002454590
Sphingobacterium mizutaii	1010	S	1	0	1	0.0002454590
Sphingobacterium sp. dk4302	2662364	S	1	0	1	0.0002454590
Spirosoma montaniterrae	1178516	S	1	0	1	0.0002454590
Spirosoma aerolatum	1211326	S	1	0	1	0.0002454590
Spirosoma pollinicola	2057025	S	1	0	1	0.0002454590
Runella slithyformis	106	S	1	0	1	0.0002454590
Hymenobacter jejuensis	2502781	S	1	0	1	0.0002454590
Hymenobacter busanensis	2607656	S	1	0	1	0.0002454590
Adhaeribacter swui	2086471	S	1	0	1	0.0002454590
Belliella baltica	232259	S	1	0	1	0.0002454590
Flammeovirga sp. MY04	1191459	S	1	0	1	0.0002454590
Bacteroides sp. CBA7301	2715212	S	1	0	1	0.0002454590
Bacteroides fragilis	817	S	1	0	1	0.0002454590
Prevotella copri	165179	S	1	0	1	0.0002454590
Prevotella jejuni	1177574	S	1	0	1	0.0002454590
Phocaeicola vulgatus	821	S	1	0	1	0.0002454590
Muribaculum gordoncarteri	2530390	S	1	0	1	0.0002454590
Coprobacter sp. 2CBH44	2751153	S	1	0	1	0.0002454590
Tenuifilum thalassicum	2590900	S	1	0	1	0.0002454590
Labilibaculum antarcticum	1717717	S	1	0	1	0.0002454590
Arachidicoccus sp. BS20	1850526	S	1	0	1	0.0002454590
Arachidicoccus ginsenosidivorans	496057	S	1	0	1	0.0002454590
Chitinophaga sp. 1310	2725416	S	1	0	1	0.0002454590
Flavihumibacter sp. SB-02	2676868	S	1	0	1	0.0002454590
Pseudobacter ginsenosidimutans	661488	S	1	0	1	0.0002454590
Salinibacter ruber	146919	S	1	0	1	0.0002454590
Gemmatirosa kalamazoonesis	861299	S	1	0	1	0.0002454590
Gemmata obscuriglobus	114	S	1	0	1	0.0002454590
Pirellula staleyi	125	S	1	0	1	0.0002454590
Bremerella volcania	2527984	S	1	0	1	0.0002454590
Lignipirellula cremea	2528010	S	1	0	1	0.0002454590
Stieleria neptunia	2527979	S	1	0	1	0.0002454590
Anatilimnocola aggregata	2528021	S	1	0	1	0.0002454590
Botrimarina mediterranea	2528022	S	1	0	1	0.0002454590
Tautonia plasticadhaerens	2527974	S	1	0	1	0.0002454590
Gimesia alba	2527973	S	1	0	1	0.0002454590
Gimesia chilikensis	2605989	S	1	0	1	0.0002454590
Alienimonas californiensis	2527989	S	1	0	1	0.0002454590
Symmachiella dynata	2527995	S	1	0	1	0.0002454590
Sedimentisphaera cyanobacteriorum	1940790	S	1	0	1	0.0002454590
Opitutus terrae	107709	S	1	0	1	0.0002454590
Methylacidiphilum kamchatkense	431057	S	1	0	1	0.0002454590
Treponema primitia	88058	S	1	0	1	0.0002454590
Treponema ruminis	744515	S	1	0	1	0.0002454590
Sediminispirochaeta smaragdinae	55206	S	1	0	1	0.0002454590
Borreliella burgdorferi	139	S	1	0	1	0.0002454590
Acidisarcina polymorpha	2211140	S	1	0	1	0.0002454590
Candidatus Solibacter usitatus	332163	S	1	0	1	0.0002454590
Desulfurobacterium thermolithotrophum	64160	S	1	0	1	0.0002454590
Nitrospira sp. KM1	1936990	S	1	0	1	0.0002454590
Leptotrichia trevisanii	109328	S	1	0	1	0.0002454590
Desulfurispirillum indicum	936456	S	1	0	1	0.0002454590
Thermodesulfobacterium geofontis	1295609	S	1	0	1	0.0002454590
Jonquetella anthropi	428712	S	1	0	1	0.0002454590
Nitrosopumilus ureiphilus	1470067	S	1	0	1	0.0002454590
Candidatus Nitrosocosmicus hydrocola	1826872	S	1	0	1	0.0002454590
Sulfolobus sp. A20	1891280	S	1	0	1	0.0002454590
Pyrobaculum calidifontis	181486	S	1	0	1	0.0002454590
Fervidicoccus fontis	683846	S	1	0	1	0.0002454590
Methanosarcina barkeri	2208	S	1	0	1	0.0002454590
Methanomethylovorans hollandica	101192	S	1	0	1	0.0002454590
Methanosalsum zhilinae	39669	S	1	0	1	0.0002454590
Haloprofundus sp. MHR1	2572921	S	1	0	1	0.0002454590
Methanococcus maripaludis	39152	S	1	0	1	0.0002454590
Methanobacterium lacus	877455	S	1	0	1	0.0002454590
Flavobacterium phage vB_FspS_hattifnatt9-1	2686246	S	1	0	1	0.0002454590
Synechococcus phage S-CBS3	753085	S	1	0	1	0.0002454590
Propionibacterium virus PHL070N00	1982279	S	1	0	1	0.0002454590
Propionibacterium virus PA6	1982269	S	1	0	1	0.0002454590
Salmonella phage TS13	2500149	S	1	0	1	0.0002454590
Synechococcus virus ST4	2734145	S	1	0	1	0.0002454590
Acinetobacter phage Acj61	760732	S	1	0	1	0.0002454590
Human betaherpesvirus 5	10359	S	1	0	1	0.0002454590
Adoxophyes orana nucleopolyhedrovirus	542343	S	1	0	1	0.0002454590
Pandoravirus macleodensis	2107707	S	1	0	1	0.0002454590
Paenibacillus mucilaginosus	61624	S	1	-1	0	0.0000000000
Nodularia spumigena	70799	S	1	-1	0	0.0000000000
Leptospira biflexa	172	S	1	-1	0	0.0000000000
